"Ar";"Regionkod";"Kon";"Ar_lan";"Antal_KKN";"Antal_ovrig";"Antal_total";"Andel_KKN";"Andel_KKN_prc"
2007;"0114";"Män";0;238;7230;7468;0,031869309051955;3,19
2007;"0114";"Kvinnor";0;254;6221;6475;0,0392277992277992;3,92
2007;"0115";"Män";0;96;3295;3391;0,0283102329696255;2,83
2007;"0115";"Kvinnor";0;94;3359;3453;0,0272227048942948;2,72
2007;"0117";"Män";0;157;3890;4047;0,0387941685198913;3,88
2007;"0117";"Kvinnor";0;217;4246;4463;0,0486220031369034;4,86
2007;"0120";"Män";0;187;4328;4515;0,0414174972314507;4,14
2007;"0120";"Kvinnor";0;224;4413;4637;0,0483070951045935;4,83
2007;"0123";"Män";0;250;11817;12067;0,0207176597331565;2,07
2007;"0123";"Kvinnor";0;437;8651;9088;0,0480853873239437;4,81
2007;"0125";"Män";0;116;2824;2940;0,0394557823129252;3,95
2007;"0125";"Kvinnor";0;137;3047;3184;0,0430276381909548;4,3
2007;"0126";"Män";0;403;18111;18514;0,0217673112239386;2,18
2007;"0126";"Kvinnor";0;423;19792;20215;0,0209250556517438;2,09
2007;"0127";"Män";0;502;10645;11147;0,0450345384408361;4,5
2007;"0127";"Kvinnor";0;495;8429;8924;0,0554683998207082;5,55
2007;"0128";"Män";0;32;967;999;0,032032032032032;3,2
2007;"0128";"Kvinnor";0;32;1293;1325;0,0241509433962264;2,42
2007;"0136";"Män";0;201;12039;12240;0,016421568627451;1,64
2007;"0136";"Kvinnor";0;297;9670;9967;0,0297983345038627;2,98
2007;"0138";"Män";0;171;4616;4787;0,0357217463964905;3,57
2007;"0138";"Kvinnor";0;172;4160;4332;0,0397045244690674;3,97
2007;"0139";"Män";0;54;3733;3787;0,014259308159493;1,43
2007;"0139";"Kvinnor";0;38;2820;2858;0,013296011196641;1,33
2007;"0140";"Män";0;7;1112;1119;0,00625558534405719;0,63
2007;"0140";"Kvinnor";0;13;856;869;0,0149597238204833;1,5
2007;"0160";"Män";0;426;10497;10923;0,0390002746498215;3,9
2007;"0160";"Kvinnor";0;716;9943;10659;0,0671732807955718;6,72
2007;"0162";"Män";0;206;6004;6210;0,0331723027375201;3,32
2007;"0162";"Kvinnor";0;301;9216;9517;0,0316276137438268;3,16
2007;"0163";"Män";0;412;11644;12056;0,0341738553417386;3,42
2007;"0163";"Kvinnor";0;577;9843;10420;0,0553742802303263;5,54
2007;"0180";"Män";0;29345;251187;280532;0,104604822266266;10,46
2007;"0180";"Kvinnor";0;31821;227827;259648;0,122554381316244;12,26
2007;"0181";"Män";0;514;23494;24008;0,0214095301566145;2,14
2007;"0181";"Kvinnor";0;583;19295;19878;0,0293289063286045;2,93
2007;"0182";"Män";0;848;14290;15138;0,0560179680274805;5,6
2007;"0182";"Kvinnor";0;1088;12891;13979;0,0778310322626797;7,78
2007;"0183";"Män";0;410;9890;10300;0,0398058252427184;3,98
2007;"0183";"Kvinnor";0;292;7649;7941;0,0367711875078705;3,68
2007;"0184";"Män";0;1560;33043;34603;0,0450827962893391;4,51
2007;"0184";"Kvinnor";0;1509;32128;33637;0,0448613134346107;4,49
2007;"0186";"Män";0;618;4737;5355;0,115406162464986;11,54
2007;"0186";"Kvinnor";0;554;5307;5861;0,0945231189216857;9,45
2007;"0187";"Män";0;61;1015;1076;0,0566914498141264;5,67
2007;"0187";"Kvinnor";0;69;1236;1305;0,0528735632183908;5,29
2007;"0188";"Män";0;274;9191;9465;0,0289487585842578;2,89
2007;"0188";"Kvinnor";0;359;9246;9605;0,0373763664757939;3,74
2007;"0191";"Män";0;252;14073;14325;0,0175916230366492;1,76
2007;"0191";"Kvinnor";0;262;10778;11040;0,023731884057971;2,37
2007;"0192";"Män";0;63;3061;3124;0,0201664532650448;2,02
2007;"0192";"Kvinnor";0;109;3240;3349;0,0325470289638698;3,25
2007;"0305";"Män";0;43;2136;2179;0,0197338228545204;1,97
2007;"0305";"Kvinnor";0;78;2062;2140;0,0364485981308411;3,64
2007;"0319";"Män";0;29;1353;1382;0,0209840810419682;2,1
2007;"0319";"Kvinnor";0;32;989;1021;0,0313418217433888;3,13
2007;"0330";"Män";0;31;1433;1464;0,0211748633879781;2,12
2007;"0330";"Kvinnor";0;43;1500;1543;0,0278677900194426;2,79
2007;"0331";"Män";0;169;1775;1944;0,0869341563786008;8,69
2007;"0331";"Kvinnor";0;177;1690;1867;0,094804499196572;9,48
2007;"0360";"Män";0;52;3534;3586;0,0145008365867262;1,45
2007;"0360";"Kvinnor";0;50;2722;2772;0,018037518037518;1,8
2007;"0380";"Män";0;1880;39743;41623;0,0451673353674651;4,52
2007;"0380";"Kvinnor";0;2258;41147;43405;0,0520216564911877;5,2
2007;"0381";"Män";0;107;6834;6941;0,0154156461604956;1,54
2007;"0381";"Kvinnor";0;197;6741;6938;0,0283943499567599;2,84
2007;"0382";"Män";0;29;4718;4747;0,00610912155045292;0,61
2007;"0382";"Kvinnor";0;49;3615;3664;0,0133733624454148;1,34
2007;"0428";"Män";0;58;1523;1581;0,036685641998735;3,67
2007;"0428";"Kvinnor";0;92;1199;1291;0,0712625871417506;7,13
2007;"0461";"Män";0;34;1065;1099;0,0309372156505914;3,09
2007;"0461";"Kvinnor";0;53;1382;1435;0,0369337979094077;3,69
2007;"0480";"Män";0;287;9966;10253;0,0279918072759192;2,8
2007;"0480";"Kvinnor";0;367;10035;10402;0,0352816766006537;3,53
2007;"0481";"Män";0;25;3419;3444;0,00725900116144019;0,73
2007;"0481";"Kvinnor";0;26;1798;1824;0,0142543859649123;1,43
2007;"0482";"Män";0;47;2943;2990;0,0157190635451505;1,57
2007;"0482";"Kvinnor";0;67;2540;2607;0,0257000383582662;2,57
2007;"0483";"Män";0;442;6288;6730;0,0656760772659733;6,57
2007;"0483";"Kvinnor";0;289;5715;6004;0,0481345769487009;4,81
2007;"0484";"Män";0;619;19995;20614;0,0300281362181042;3
2007;"0484";"Kvinnor";0;840;18105;18945;0,0443388756927949;4,43
2007;"0486";"Män";0;151;4831;4982;0,030309112806102;3,03
2007;"0486";"Kvinnor";0;157;4594;4751;0,0330456745948221;3,3
2007;"0488";"Män";0;93;1572;1665;0,0558558558558559;5,59
2007;"0488";"Kvinnor";0;107;1624;1731;0,0618139803581745;6,18
2007;"0509";"Män";0;70;821;891;0,0785634118967452;7,86
2007;"0509";"Kvinnor";0;46;759;805;0,0571428571428571;5,71
2007;"0512";"Män";0;3;671;674;0,00445103857566766;0,45
2007;"0512";"Kvinnor";0;6;477;483;0,0124223602484472;1,24
2007;"0513";"Män";0;39;1669;1708;0,0228337236533958;2,28
2007;"0513";"Kvinnor";0;42;1525;1567;0,02680280791321;2,68
2007;"0560";"Män";0;3;1108;1111;0,0027002700270027;0,27
2007;"0560";"Kvinnor";0;7;612;619;0,0113085621970921;1,13
2007;"0561";"Män";0;65;1755;1820;0,0357142857142857;3,57
2007;"0561";"Kvinnor";0;50;1481;1531;0,0326583932070542;3,27
2007;"0562";"Män";0;35;5468;5503;0,00636016718153734;0,64
2007;"0562";"Kvinnor";0;64;3257;3321;0,0192713038241494;1,93
2007;"0563";"Män";0;17;1652;1669;0,0101857399640503;1,02
2007;"0563";"Kvinnor";0;35;1150;1185;0,029535864978903;2,95
2007;"0580";"Män";0;967;35062;36029;0,0268394904105026;2,68
2007;"0580";"Kvinnor";0;1166;31237;32403;0,0359843224392803;3,6
2007;"0581";"Män";0;1025;28115;29140;0,035175017158545;3,52
2007;"0581";"Kvinnor";0;1152;25537;26689;0,0431638502753944;4,32
2007;"0582";"Män";0;62;1925;1987;0,031202818319074;3,12
2007;"0582";"Kvinnor";0;69;1746;1815;0,0380165289256198;3,8
2007;"0583";"Män";0;270;8164;8434;0,0320132795826417;3,2
2007;"0583";"Kvinnor";0;265;6982;7247;0,0365668552504485;3,66
2007;"0584";"Män";0;60;1601;1661;0,0361228175797712;3,61
2007;"0584";"Kvinnor";0;79;1298;1377;0,0573710965867829;5,74
2007;"0586";"Män";0;147;5745;5892;0,024949083503055;2,49
2007;"0586";"Kvinnor";0;159;3857;4016;0,0395916334661355;3,96
2007;"0604";"Män";0;11;1340;1351;0,00814211695040711;0,81
2007;"0604";"Kvinnor";0;16;1086;1102;0,014519056261343;1,45
2007;"0617";"Män";0;24;3435;3459;0,00693842150910668;0,69
2007;"0617";"Kvinnor";0;37;2425;2462;0,0150284321689683;1,5
2007;"0642";"Män";0;22;1297;1319;0,0166793025018954;1,67
2007;"0642";"Kvinnor";0;37;1113;1150;0,0321739130434783;3,22
2007;"0643";"Män";0;48;1842;1890;0,0253968253968254;2,54
2007;"0643";"Kvinnor";0;32;1511;1543;0,0207388204795852;2,07
2007;"0662";"Män";0;112;8151;8263;0,0135543991286458;1,36
2007;"0662";"Kvinnor";0;187;6251;6438;0,0290462876669773;2,9
2007;"0665";"Män";0;33;3164;3197;0,0103221770409759;1,03
2007;"0665";"Kvinnor";0;37;2291;2328;0,015893470790378;1,59
2007;"0680";"Män";0;1169;31105;32274;0,036221106773254;3,62
2007;"0680";"Kvinnor";0;1349;27059;28408;0,0474866234863419;4,75
2007;"0682";"Män";0;280;6893;7173;0,0390352711557228;3,9
2007;"0682";"Kvinnor";0;237;5194;5431;0,0436383723071258;4,36
2007;"0683";"Män";0;262;8603;8865;0,0295544275239707;2,96
2007;"0683";"Kvinnor";0;410;7703;8113;0,0505361765068409;5,05
2007;"0684";"Män";0;22;2379;2401;0,00916284881299459;0,92
2007;"0684";"Kvinnor";0;34;1788;1822;0,0186608122941822;1,87
2007;"0685";"Män";0;81;6906;6987;0,0115929583512237;1,16
2007;"0685";"Kvinnor";0;132;5162;5294;0,0249338874197204;2,49
2007;"0686";"Män";0;83;4338;4421;0,0187740330242027;1,88
2007;"0686";"Kvinnor";0;124;4135;4259;0,029114815684433;2,91
2007;"0687";"Män";0;116;4211;4327;0,0268084122948925;2,68
2007;"0687";"Kvinnor";0;136;3494;3630;0,037465564738292;3,75
2007;"0760";"Män";0;21;2815;2836;0,00740479548660085;0,74
2007;"0760";"Kvinnor";0;17;2034;2051;0,00828863968795709;0,83
2007;"0761";"Män";0;42;1427;1469;0,0285908781484003;2,86
2007;"0761";"Kvinnor";0;87;1298;1385;0,0628158844765343;6,28
2007;"0763";"Män";0;41;2910;2951;0,0138935953913927;1,39
2007;"0763";"Kvinnor";0;51;2370;2421;0,0210656753407683;2,11
2007;"0764";"Män";0;47;4150;4197;0,0111984751012628;1,12
2007;"0764";"Kvinnor";0;63;3085;3148;0,020012706480305;2
2007;"0765";"Män";0;690;4415;5105;0,135161606268364;13,52
2007;"0765";"Kvinnor";0;738;3565;4303;0,171508250058099;17,15
2007;"0767";"Män";0;45;2959;3004;0,0149800266311585;1,5
2007;"0767";"Kvinnor";0;45;1970;2015;0,0223325062034739;2,23
2007;"0780";"Män";0;797;20469;21266;0,0374776638766105;3,75
2007;"0780";"Kvinnor";0;891;18114;19005;0,0468823993685872;4,69
2007;"0781";"Män";0;529;6896;7425;0,0712457912457913;7,12
2007;"0781";"Kvinnor";0;384;5612;5996;0,0640426951300867;6,4
2007;"0821";"Män";0;14;873;887;0,0157835400225479;1,58
2007;"0821";"Kvinnor";0;8;918;926;0,00863930885529158;0,86
2007;"0834";"Män";0;10;1597;1607;0,00622277535780958;0,62
2007;"0834";"Kvinnor";0;15;1034;1049;0,0142993326978074;1,43
2007;"0840";"Män";0;48;2043;2091;0,0229555236728838;2,3
2007;"0840";"Kvinnor";0;99;1813;1912;0,0517782426778243;5,18
2007;"0860";"Män";0;57;2817;2874;0,0198329853862213;1,98
2007;"0860";"Kvinnor";0;60;2345;2405;0,0249480249480249;2,49
2007;"0861";"Män";0;22;2543;2565;0,00857699805068226;0,86
2007;"0861";"Kvinnor";0;39;1979;2018;0,0193260654112983;1,93
2007;"0862";"Män";0;29;2734;2763;0,0104958378574014;1,05
2007;"0862";"Kvinnor";0;40;1708;1748;0,022883295194508;2,29
2007;"0880";"Män";0;619;14231;14850;0,0416835016835017;4,17
2007;"0880";"Kvinnor";0;770;13863;14633;0,0526207886284426;5,26
2007;"0881";"Män";0;37;4583;4620;0,00800865800865801;0,8
2007;"0881";"Kvinnor";0;99;3580;3679;0,0269094862734439;2,69
2007;"0882";"Män";0;69;7798;7867;0,00877081479598322;0,88
2007;"0882";"Kvinnor";0;177;5904;6081;0,0291070547607301;2,91
2007;"0883";"Män";0;159;7144;7303;0,0217718745720937;2,18
2007;"0883";"Kvinnor";0;183;6913;7096;0,0257891770011274;2,58
2007;"0884";"Män";0;238;3892;4130;0,0576271186440678;5,76
2007;"0884";"Kvinnor";0;290;2941;3231;0,0897554936552151;8,98
2007;"0885";"Män";0;65;1769;1834;0,0354416575790622;3,54
2007;"0885";"Kvinnor";0;86;1782;1868;0,0460385438972163;4,6
2007;"0980";"Män";0;477;11598;12075;0,0395031055900621;3,95
2007;"0980";"Kvinnor";0;560;11360;11920;0,0469798657718121;4,7
2007;"1060";"Män";0;67;4584;4651;0,0144055041926467;1,44
2007;"1060";"Kvinnor";0;86;2503;2589;0,0332174584781769;3,32
2007;"1080";"Män";0;505;14564;15069;0,0335125091246931;3,35
2007;"1080";"Kvinnor";0;505;12749;13254;0,0381017051456164;3,81
2007;"1081";"Män";0;96;6742;6838;0,0140391927464171;1,4
2007;"1081";"Kvinnor";0;149;4825;4974;0,0299557700040209;3
2007;"1082";"Män";0;178;5577;5755;0,0309296264118158;3,09
2007;"1082";"Kvinnor";0;267;5629;5896;0,0452849389416554;4,53
2007;"1083";"Män";0;77;3151;3228;0,0238537794299876;2,39
2007;"1083";"Kvinnor";0;114;2513;2627;0,0433955081842406;4,34
2007;"1214";"Män";0;20;1663;1683;0,011883541295306;1,19
2007;"1214";"Kvinnor";0;28;1630;1658;0,0168878166465621;1,69
2007;"1230";"Män";0;82;2712;2794;0,0293486041517538;2,93
2007;"1230";"Kvinnor";0;63;2149;2212;0,0284810126582278;2,85
2007;"1231";"Män";0;102;4504;4606;0,0221450282240556;2,21
2007;"1231";"Kvinnor";0;225;2868;3093;0,07274490785645;7,27
2007;"1233";"Män";0;276;3137;3413;0,0808672721945503;8,09
2007;"1233";"Kvinnor";0;205;3480;3685;0,0556309362279511;5,56
2007;"1256";"Män";0;40;2695;2735;0,0146252285191956;1,46
2007;"1256";"Kvinnor";0;70;2102;2172;0,0322283609576427;3,22
2007;"1257";"Män";0;20;2057;2077;0,00962927298988926;0,96
2007;"1257";"Kvinnor";0;23;1872;1895;0,0121372031662269;1,21
2007;"1260";"Män";0;11;2677;2688;0,0040922619047619;0,41
2007;"1260";"Kvinnor";0;21;2032;2053;0,0102289332683877;1,02
2007;"1261";"Män";0;86;3463;3549;0,0242321780783319;2,42
2007;"1261";"Kvinnor";0;235;3183;3418;0,0687536571094207;6,88
2007;"1262";"Män";0;77;2056;2133;0,0360993905297703;3,61
2007;"1262";"Kvinnor";0;92;2137;2229;0,041274113952445;4,13
2007;"1263";"Män";0;87;3176;3263;0,026662580447441;2,67
2007;"1263";"Kvinnor";0;126;2378;2504;0,0503194888178914;5,03
2007;"1264";"Män";0;61;1670;1731;0,0352397458116696;3,52
2007;"1264";"Kvinnor";0;86;1744;1830;0,0469945355191257;4,7
2007;"1265";"Män";0;60;2882;2942;0,0203942895989123;2,04
2007;"1265";"Kvinnor";0;90;2318;2408;0,037375415282392;3,74
2007;"1266";"Män";0;38;2076;2114;0,0179754020813623;1,8
2007;"1266";"Kvinnor";0;62;2029;2091;0,0296508847441416;2,97
2007;"1267";"Män";0;40;1839;1879;0,0212879191059074;2,13
2007;"1267";"Kvinnor";0;67;2240;2307;0,0290420459471175;2,9
2007;"1270";"Män";0;56;2295;2351;0,0238196512122501;2,38
2007;"1270";"Kvinnor";0;84;1797;1881;0,0446570972886762;4,47
2007;"1272";"Män";0;28;2825;2853;0,00981423063441991;0,98
2007;"1272";"Kvinnor";0;31;1927;1958;0,015832482124617;1,58
2007;"1273";"Män";0;39;2190;2229;0,0174966352624495;1,75
2007;"1273";"Kvinnor";0;46;1829;1875;0,0245333333333333;2,45
2007;"1275";"Män";0;12;1915;1927;0,00622729631551635;0,62
2007;"1275";"Kvinnor";0;12;1217;1229;0,00976403580146461;0,98
2007;"1276";"Män";0;109;2954;3063;0,0355860267711394;3,56
2007;"1276";"Kvinnor";0;84;2361;2445;0,0343558282208589;3,44
2007;"1277";"Män";0;83;2805;2888;0,0287396121883657;2,87
2007;"1277";"Kvinnor";0;129;2469;2598;0,0496535796766744;4,97
2007;"1278";"Män";0;105;3204;3309;0,0317316409791478;3,17
2007;"1278";"Kvinnor";0;191;2529;2720;0,0702205882352941;7,02
2007;"1280";"Män";0;5030;70054;75084;0,0669916360343082;6,7
2007;"1280";"Kvinnor";0;4979;61424;66403;0,0749815520383115;7,5
2007;"1281";"Män";0;1097;29505;30602;0,0358473302398536;3,58
2007;"1281";"Kvinnor";0;1392;28780;30172;0,0461354898581466;4,61
2007;"1282";"Män";0;340;7331;7671;0,0443227740842133;4,43
2007;"1282";"Kvinnor";0;311;6120;6431;0,0483595086300731;4,84
2007;"1283";"Män";0;1915;29746;31661;0,0604845077540191;6,05
2007;"1283";"Kvinnor";0;2154;26891;29045;0,0741607849888105;7,42
2007;"1284";"Män";0;110;3292;3402;0,0323339212228101;3,23
2007;"1284";"Kvinnor";0;141;3343;3484;0,0404707233065442;4,05
2007;"1285";"Män";0;140;5307;5447;0,0257022214062787;2,57
2007;"1285";"Kvinnor";0;153;4742;4895;0,0312563840653728;3,13
2007;"1286";"Män";0;215;5025;5240;0,041030534351145;4,1
2007;"1286";"Kvinnor";0;295;5361;5656;0,0521570014144272;5,22
2007;"1287";"Män";0;115;6463;6578;0,0174825174825175;1,75
2007;"1287";"Kvinnor";0;233;6094;6327;0,0368262999841947;3,68
2007;"1290";"Män";0;506;16059;16565;0,0305463326290371;3,05
2007;"1290";"Kvinnor";0;681;16459;17140;0,0397316219369895;3,97
2007;"1291";"Män";0;110;3062;3172;0,0346784363177806;3,47
2007;"1291";"Kvinnor";0;156;3100;3256;0,0479115479115479;4,79
2007;"1292";"Män";0;204;6970;7174;0,028436018957346;2,84
2007;"1292";"Kvinnor";0;341;7671;8012;0,0425611582626061;4,26
2007;"1293";"Män";0;316;10638;10954;0,0288479094394742;2,88
2007;"1293";"Kvinnor";0;317;9075;9392;0,033752129471891;3,38
2007;"1315";"Män";0;38;2670;2708;0,0140324963072378;1,4
2007;"1315";"Kvinnor";0;56;1987;2043;0,0274106705824767;2,74
2007;"1380";"Män";0;892;20640;21532;0,0414267137284042;4,14
2007;"1380";"Kvinnor";0;1125;18669;19794;0,0568354046680812;5,68
2007;"1381";"Män";0;209;3983;4192;0,0498568702290076;4,99
2007;"1381";"Kvinnor";0;155;3461;3616;0,0428650442477876;4,29
2007;"1382";"Män";0;478;8534;9012;0,053040390590324;5,3
2007;"1382";"Kvinnor";0;1055;6781;7836;0,134635017866258;13,46
2007;"1383";"Män";0;442;12627;13069;0,0338204912388094;3,38
2007;"1383";"Kvinnor";0;716;10814;11530;0,0620988725065048;6,21
2007;"1384";"Män";0;636;8882;9518;0,066820760664005;6,68
2007;"1384";"Kvinnor";0;824;10070;10894;0,075637965852763;7,56
2007;"1401";"Män";0;306;5935;6241;0,0490306040698606;4,9
2007;"1401";"Kvinnor";0;284;5390;5674;0,050052872752908;5,01
2007;"1402";"Män";0;183;5042;5225;0,0350239234449761;3,5
2007;"1402";"Kvinnor";0;268;4506;4774;0,0561374109761207;5,61
2007;"1407";"Män";0;21;1184;1205;0,0174273858921162;1,74
2007;"1407";"Kvinnor";0;42;1410;1452;0,0289256198347107;2,89
2007;"1415";"Män";0;91;5988;6079;0,0149695673630531;1,5
2007;"1415";"Kvinnor";0;231;3890;4121;0,0560543557388983;5,61
2007;"1419";"Män";0;42;1956;1998;0,021021021021021;2,1
2007;"1419";"Kvinnor";0;60;2158;2218;0,0270513976555455;2,71
2007;"1421";"Män";0;23;2666;2689;0,00855336556340647;0,86
2007;"1421";"Kvinnor";0;43;2167;2210;0,0194570135746606;1,95
2007;"1427";"Män";0;19;1881;1900;0,01;1
2007;"1427";"Kvinnor";0;38;1746;1784;0,0213004484304933;2,13
2007;"1430";"Män";0;80;1736;1816;0,0440528634361234;4,41
2007;"1430";"Kvinnor";0;60;1614;1674;0,03584229390681;3,58
2007;"1435";"Män";0;87;2525;2612;0,0333078101071975;3,33
2007;"1435";"Kvinnor";0;165;1933;2098;0,0786463298379409;7,86
2007;"1438";"Män";0;36;950;986;0,0365111561866126;3,65
2007;"1438";"Kvinnor";0;17;762;779;0,0218228498074454;2,18
2007;"1439";"Män";0;5;1004;1009;0,00495540138751239;0,5
2007;"1439";"Kvinnor";0;8;1012;1020;0,00784313725490196;0,78
2007;"1440";"Män";0;61;2996;3057;0,0199542034674518;2
2007;"1440";"Kvinnor";0;57;3151;3208;0,0177680798004988;1,78
2007;"1441";"Män";0;146;3655;3801;0,0384109444882926;3,84
2007;"1441";"Kvinnor";0;191;4350;4541;0,0420612199955957;4,21
2007;"1442";"Män";0;51;2587;2638;0,0193328278999242;1,93
2007;"1442";"Kvinnor";0;54;2009;2063;0,0261754726127;2,62
2007;"1443";"Män";0;33;1256;1289;0,0256012412723041;2,56
2007;"1443";"Kvinnor";0;35;943;978;0,0357873210633947;3,58
2007;"1444";"Män";0;4;710;714;0,00560224089635854;0,56
2007;"1444";"Kvinnor";0;14;766;780;0,0179487179487179;1,79
2007;"1445";"Män";0;51;990;1041;0,0489913544668588;4,9
2007;"1445";"Kvinnor";0;60;764;824;0,0728155339805825;7,28
2007;"1446";"Män";0;26;1451;1477;0,017603249830738;1,76
2007;"1446";"Kvinnor";0;18;1189;1207;0,0149130074565037;1,49
2007;"1447";"Män";0;5;1036;1041;0,0048030739673391;0,48
2007;"1447";"Kvinnor";0;9;783;792;0,0113636363636364;1,14
2007;"1452";"Män";0;106;3522;3628;0,0292171995589857;2,92
2007;"1452";"Kvinnor";0;150;2033;2183;0,0687127805771874;6,87
2007;"1460";"Män";0;39;1943;1982;0,0196770938446014;1,97
2007;"1460";"Kvinnor";0;76;1746;1822;0,0417124039517014;4,17
2007;"1461";"Män";0;20;1599;1619;0,0123533045089561;1,24
2007;"1461";"Kvinnor";0;44;1414;1458;0,0301783264746228;3,02
2007;"1462";"Män";0;21;1887;1908;0,0110062893081761;1,1
2007;"1462";"Kvinnor";0;20;1873;1893;0,0105652403592182;1,06
2007;"1463";"Män";0;463;5132;5595;0,0827524575513852;8,28
2007;"1463";"Kvinnor";0;410;5143;5553;0,0738339636232667;7,38
2007;"1465";"Män";0;357;1779;2136;0,167134831460674;16,71
2007;"1465";"Kvinnor";0;196;1686;1882;0,104144527098831;10,41
2007;"1466";"Män";0;17;2198;2215;0,00767494356659142;0,77
2007;"1466";"Kvinnor";0;18;1653;1671;0,0107719928186715;1,08
2007;"1470";"Män";0;74;4808;4882;0,0151577222449816;1,52
2007;"1470";"Kvinnor";0;77;2880;2957;0,0260399053094352;2,6
2007;"1471";"Män";0;74;3482;3556;0,0208098987626547;2,08
2007;"1471";"Kvinnor";0;46;2562;2608;0,0176380368098159;1,76
2007;"1472";"Män";0;28;2069;2097;0,0133524082021936;1,34
2007;"1472";"Kvinnor";0;36;1801;1837;0,0195971692977681;1,96
2007;"1473";"Män";0;19;1732;1751;0,010850942318675;1,09
2007;"1473";"Kvinnor";0;29;1396;1425;0,0203508771929825;2,04
2007;"1480";"Män";0;7625;149093;156718;0,0486542707283146;4,87
2007;"1480";"Kvinnor";0;8899;126189;135088;0,0658755774013976;6,59
2007;"1481";"Män";0;661;15278;15939;0,041470606687998;4,15
2007;"1481";"Kvinnor";0;939;14751;15690;0,0598470363288719;5,98
2007;"1482";"Män";0;203;6866;7069;0,0287169330881313;2,87
2007;"1482";"Kvinnor";0;197;6664;6861;0,0287130155953943;2,87
2007;"1484";"Män";0;59;3110;3169;0,0186178605238245;1,86
2007;"1484";"Kvinnor";0;72;2400;2472;0,029126213592233;2,91
2007;"1485";"Män";0;410;10507;10917;0,0375561051570944;3,76
2007;"1485";"Kvinnor";0;655;10840;11495;0,056981296215746;5,7
2007;"1486";"Män";0;105;2476;2581;0,0406819062378923;4,07
2007;"1486";"Kvinnor";0;198;2703;2901;0,0682523267838676;6,83
2007;"1487";"Män";0;164;6464;6628;0,0247435123717562;2,47
2007;"1487";"Kvinnor";0;203;6346;6549;0,030997098793709;3,1
2007;"1488";"Män";0;223;16119;16342;0,0136458205849957;1,36
2007;"1488";"Kvinnor";0;464;12275;12739;0,036423581128817;3,64
2007;"1489";"Män";0;234;5955;6189;0,0378090159961222;3,78
2007;"1489";"Kvinnor";0;336;6686;7022;0,0478496154941612;4,78
2007;"1490";"Män";0;2217;21307;23524;0,0942441761605169;9,42
2007;"1490";"Kvinnor";0;2630;21116;23746;0,110755495662427;11,08
2007;"1491";"Män";0;273;4016;4289;0,0636512007460947;6,37
2007;"1491";"Kvinnor";0;398;3369;3767;0,105654366870188;10,57
2007;"1492";"Män";0;73;2430;2503;0,0291650019976029;2,92
2007;"1492";"Kvinnor";0;85;2109;2194;0,0387420237010027;3,87
2007;"1493";"Män";0;66;4798;4864;0,0135690789473684;1,36
2007;"1493";"Kvinnor";0;118;4373;4491;0,0262747717657537;2,63
2007;"1494";"Män";0;204;8595;8799;0,0231844527787249;2,32
2007;"1494";"Kvinnor";0;291;6976;7267;0,0400440346773084;4
2007;"1495";"Män";0;135;4186;4321;0,0312427678778061;3,12
2007;"1495";"Kvinnor";0;170;3864;4034;0,0421417947446703;4,21
2007;"1496";"Män";0;316;15659;15975;0,0197809076682316;1,98
2007;"1496";"Kvinnor";0;453;12401;12854;0,0352419480317411;3,52
2007;"1497";"Män";0;24;1385;1409;0,0170333569907736;1,7
2007;"1497";"Kvinnor";0;46;1325;1371;0,0335521517140773;3,36
2007;"1498";"Män";0;35;2584;2619;0,0133638793432608;1,34
2007;"1498";"Kvinnor";0;53;1985;2038;0,0260058881256133;2,6
2007;"1499";"Män";0;212;6303;6515;0,0325402916346892;3,25
2007;"1499";"Kvinnor";0;203;5416;5619;0,0361274248086848;3,61
2007;"1715";"Män";0;28;1667;1695;0,0165191740412979;1,65
2007;"1715";"Kvinnor";0;33;1363;1396;0,0236389684813754;2,36
2007;"1730";"Män";0;10;1454;1464;0,00683060109289617;0,68
2007;"1730";"Kvinnor";0;98;1519;1617;0,0606060606060606;6,06
2007;"1737";"Män";0;34;2420;2454;0,0138549307253464;1,39
2007;"1737";"Kvinnor";0;52;2368;2420;0,0214876033057851;2,15
2007;"1760";"Män";0;1;688;689;0,00145137880986938;0,15
2007;"1760";"Kvinnor";0;5;511;516;0,00968992248062015;0,97
2007;"1761";"Män";0;15;2136;2151;0,00697350069735007;0,7
2007;"1761";"Kvinnor";0;20;1774;1794;0,0111482720178372;1,11
2007;"1762";"Män";0;25;817;842;0,0296912114014252;2,97
2007;"1762";"Kvinnor";0;27;598;625;0,0432;4,32
2007;"1763";"Män";0;19;1198;1217;0,0156121610517666;1,56
2007;"1763";"Kvinnor";0;27;1344;1371;0,0196936542669584;1,97
2007;"1764";"Män";0;9;1852;1861;0,00483610961848469;0,48
2007;"1764";"Kvinnor";0;11;1326;1337;0,00822737471952132;0,82
2007;"1765";"Män";0;29;1829;1858;0,0156081808396125;1,56
2007;"1765";"Kvinnor";0;121;1786;1907;0,0634504457262716;6,35
2007;"1766";"Män";0;142;2665;2807;0,0505878161738511;5,06
2007;"1766";"Kvinnor";0;95;2164;2259;0,0420540061974325;4,21
2007;"1780";"Män";0;938;22229;23167;0,0404886260629343;4,05
2007;"1780";"Kvinnor";0;1162;20382;21544;0,0539361307092462;5,39
2007;"1781";"Män";0;60;4909;4969;0,0120748641577782;1,21
2007;"1781";"Kvinnor";0;123;3512;3635;0,033837689133425;3,38
2007;"1782";"Män";0;25;1975;2000;0,0125;1,25
2007;"1782";"Kvinnor";0;32;1821;1853;0,0172692930383162;1,73
2007;"1783";"Män";0;20;2573;2593;0,00771307365985345;0,77
2007;"1783";"Kvinnor";0;49;1927;1976;0,0247975708502024;2,48
2007;"1784";"Män";0;106;5856;5962;0,0177792687017779;1,78
2007;"1784";"Kvinnor";0;182;4671;4853;0,0375025757263548;3,75
2007;"1785";"Män";0;45;3279;3324;0,0135379061371841;1,35
2007;"1785";"Kvinnor";0;68;2341;2409;0,0282274802822748;2,82
2007;"1814";"Män";0;14;762;776;0,0180412371134021;1,8
2007;"1814";"Kvinnor";0;9;760;769;0,011703511053316;1,17
2007;"1860";"Män";0;19;1512;1531;0,0124101894186806;1,24
2007;"1860";"Kvinnor";0;16;1017;1033;0,0154888673765731;1,55
2007;"1861";"Män";0;82;4154;4236;0,0193578847969783;1,94
2007;"1861";"Kvinnor";0;70;2815;2885;0,024263431542461;2,43
2007;"1862";"Män";0;15;1577;1592;0,00942211055276382;0,94
2007;"1862";"Kvinnor";0;25;1215;1240;0,0201612903225806;2,02
2007;"1863";"Män";0;12;1468;1480;0,00810810810810811;0,81
2007;"1863";"Kvinnor";0;24;1099;1123;0,0213713268032057;2,14
2007;"1864";"Män";0;7;812;819;0,00854700854700855;0,85
2007;"1864";"Kvinnor";0;19;752;771;0,0246433203631647;2,46
2007;"1880";"Män";0;1428;31763;33191;0,0430237112470248;4,3
2007;"1880";"Kvinnor";0;1608;29965;31573;0,0509295917397777;5,09
2007;"1881";"Män";0;112;3412;3524;0,0317820658342792;3,18
2007;"1881";"Kvinnor";0;113;3149;3262;0,0346413243408952;3,46
2007;"1882";"Män";0;26;1805;1831;0,014199890770071;1,42
2007;"1882";"Kvinnor";0;40;1568;1608;0,0248756218905473;2,49
2007;"1883";"Män";0;157;7642;7799;0,0201307859982049;2,01
2007;"1883";"Kvinnor";0;229;6493;6722;0,034067241892294;3,41
2007;"1884";"Män";0;37;1554;1591;0,0232558139534884;2,33
2007;"1884";"Kvinnor";0;75;1430;1505;0,0498338870431894;4,98
2007;"1885";"Män";0;109;4849;4958;0,0219846712384026;2,2
2007;"1885";"Kvinnor";0;107;4465;4572;0,0234033245844269;2,34
2007;"1904";"Män";0;12;729;741;0,0161943319838057;1,62
2007;"1904";"Kvinnor";0;9;662;671;0,0134128166915052;1,34
2007;"1907";"Män";0;11;1771;1782;0,00617283950617284;0,62
2007;"1907";"Kvinnor";0;25;1321;1346;0,0185735512630015;1,86
2007;"1960";"Män";0;5;1653;1658;0,00301568154402895;0,3
2007;"1960";"Kvinnor";0;15;1340;1355;0,011070110701107;1,11
2007;"1961";"Män";0;32;2958;2990;0,0107023411371237;1,07
2007;"1961";"Kvinnor";0;43;2442;2485;0,0173038229376258;1,73
2007;"1962";"Män";0;24;843;867;0,027681660899654;2,77
2007;"1962";"Kvinnor";0;23;688;711;0,0323488045007032;3,23
2007;"1980";"Män";0;1249;31190;32439;0,0385030364684485;3,85
2007;"1980";"Kvinnor";0;1453;27732;29185;0,0497858488949803;4,98
2007;"1981";"Män";0;102;3641;3743;0,0272508682874699;2,73
2007;"1981";"Kvinnor";0;125;3599;3724;0,0335660580021482;3,36
2007;"1982";"Män";0;29;3523;3552;0,00816441441441441;0,82
2007;"1982";"Kvinnor";0;71;2590;2661;0,0266816986095453;2,67
2007;"1983";"Män";0;66;6376;6442;0,0102452654455138;1,02
2007;"1983";"Kvinnor";0;161;4840;5001;0,0321935612877425;3,22
2007;"1984";"Män";0;29;2769;2798;0,0103645461043603;1,04
2007;"1984";"Kvinnor";0;50;2238;2288;0,0218531468531469;2,19
2007;"2021";"Män";0;15;1316;1331;0,0112697220135237;1,13
2007;"2021";"Kvinnor";0;25;1149;1174;0,0212947189097104;2,13
2007;"2023";"Män";0;82;2741;2823;0,0290471130003542;2,9
2007;"2023";"Kvinnor";0;75;2439;2514;0,0298329355608592;2,98
2007;"2026";"Män";0;15;1292;1307;0,0114766641162969;1,15
2007;"2026";"Kvinnor";0;20;1219;1239;0,0161420500403551;1,61
2007;"2029";"Män";0;103;3099;3202;0,0321673953778888;3,22
2007;"2029";"Kvinnor";0;123;2695;2818;0,0436479772888573;4,36
2007;"2031";"Män";0;57;1588;1645;0,0346504559270517;3,47
2007;"2031";"Kvinnor";0;92;1611;1703;0,0540223135642983;5,4
2007;"2034";"Män";0;34;876;910;0,0373626373626374;3,74
2007;"2034";"Kvinnor";0;31;918;949;0,0326659641728135;3,27
2007;"2039";"Män";0;12;1412;1424;0,00842696629213483;0,84
2007;"2039";"Kvinnor";0;23;1269;1292;0,0178018575851393;1,78
2007;"2061";"Män";0;40;1882;1922;0,0208116545265349;2,08
2007;"2061";"Kvinnor";0;31;1249;1280;0,02421875;2,42
2007;"2062";"Män";0;100;5268;5368;0,018628912071535;1,86
2007;"2062";"Kvinnor";0;169;4441;4610;0,0366594360086768;3,67
2007;"2080";"Män";0;791;11611;12402;0,0637800354781487;6,38
2007;"2080";"Kvinnor";0;674;12421;13095;0,0514700267277587;5,15
2007;"2081";"Män";0;279;13661;13940;0,0200143472022956;2
2007;"2081";"Kvinnor";0;417;9631;10048;0,041500796178344;4,15
2007;"2082";"Män";0;13;1418;1431;0,00908455625436757;0,91
2007;"2082";"Kvinnor";0;25;1564;1589;0,0157331655129012;1,57
2007;"2083";"Män";0;85;3288;3373;0,0252001185887934;2,52
2007;"2083";"Kvinnor";0;83;2811;2894;0,0286800276434001;2,87
2007;"2084";"Män";0;100;5475;5575;0,0179372197309417;1,79
2007;"2084";"Kvinnor";0;122;4147;4269;0,0285781213398922;2,86
2007;"2085";"Män";0;63;6052;6115;0,0103025347506132;1,03
2007;"2085";"Kvinnor";0;121;5139;5260;0,0230038022813688;2,3
2007;"2101";"Män";0;10;849;859;0,0116414435389988;1,16
2007;"2101";"Kvinnor";0;19;838;857;0,0221703617269545;2,22
2007;"2104";"Män";0;100;2300;2400;0,0416666666666667;4,17
2007;"2104";"Kvinnor";0;140;1717;1857;0,0753904146472806;7,54
2007;"2121";"Män";0;26;3034;3060;0,00849673202614379;0,85
2007;"2121";"Kvinnor";0;44;2009;2053;0,0214320506575743;2,14
2007;"2132";"Män";0;17;1459;1476;0,0115176151761518;1,15
2007;"2132";"Kvinnor";0;16;1187;1203;0,0133000831255195;1,33
2007;"2161";"Män";0;143;3989;4132;0,0346079380445305;3,46
2007;"2161";"Kvinnor";0;180;3280;3460;0,0520231213872832;5,2
2007;"2180";"Män";0;682;20820;21502;0,0317179797228165;3,17
2007;"2180";"Kvinnor";0;930;18372;19302;0,0481815355921666;4,82
2007;"2181";"Män";0;97;10073;10170;0,00953785644051131;0,95
2007;"2181";"Kvinnor";0;163;7539;7702;0,0211633341989094;2,12
2007;"2182";"Män";0;125;4816;4941;0,0252985225662821;2,53
2007;"2182";"Kvinnor";0;184;4267;4451;0,0413390249382161;4,13
2007;"2183";"Män";0;173;5077;5250;0,032952380952381;3,3
2007;"2183";"Kvinnor";0;167;5035;5202;0,0321030372933487;3,21
2007;"2184";"Män";0;248;7981;8229;0,0301373192368453;3,01
2007;"2184";"Kvinnor";0;306;7040;7346;0,0416553226245576;4,17
2007;"2260";"Män";0;76;2251;2327;0,0326600773528148;3,27
2007;"2260";"Kvinnor";0;93;1859;1952;0,0476434426229508;4,76
2007;"2262";"Män";0;48;2888;2936;0,0163487738419619;1,63
2007;"2262";"Kvinnor";0;46;1992;2038;0,0225711481844946;2,26
2007;"2280";"Män";0;293;4717;5010;0,0584830339321357;5,85
2007;"2280";"Kvinnor";0;360;4527;4887;0,0736648250460405;7,37
2007;"2281";"Män";0;715;23471;24186;0,0295625568510709;2,96
2007;"2281";"Kvinnor";0;949;21076;22025;0,0430874006810443;4,31
2007;"2282";"Män";0;46;3984;4030;0,0114143920595534;1,14
2007;"2282";"Kvinnor";0;69;3286;3355;0,0205663189269747;2,06
2007;"2283";"Män";0;128;3789;3917;0,0326780699514935;3,27
2007;"2283";"Kvinnor";0;182;3888;4070;0,0447174447174447;4,47
2007;"2284";"Män";0;271;13043;13314;0,0203545140453658;2,04
2007;"2284";"Kvinnor";0;415;10424;10839;0,0382876649137374;3,83
2007;"2303";"Män";0;5;1238;1243;0,00402252614641995;0,4
2007;"2303";"Kvinnor";0;8;1060;1068;0,00749063670411985;0,75
2007;"2305";"Män";0;10;1072;1082;0,00924214417744917;0,92
2007;"2305";"Kvinnor";0;16;1090;1106;0,0144665461121157;1,45
2007;"2309";"Män";0;28;2263;2291;0,0122217372326495;1,22
2007;"2309";"Kvinnor";0;21;2117;2138;0,009822263797942;0,98
2007;"2313";"Män";0;26;2481;2507;0,0103709613083367;1,04
2007;"2313";"Kvinnor";0;37;2187;2224;0,016636690647482;1,66
2007;"2321";"Män";0;95;2399;2494;0,0380914194065758;3,81
2007;"2321";"Kvinnor";0;115;2191;2306;0,0498699045967042;4,99
2007;"2326";"Män";0;20;1456;1476;0,013550135501355;1,36
2007;"2326";"Kvinnor";0;11;1182;1193;0,00922045264040235;0,92
2007;"2361";"Män";0;30;2388;2418;0,0124069478908189;1,24
2007;"2361";"Kvinnor";0;46;2132;2178;0,0211202938475666;2,11
2007;"2380";"Män";0;708;14460;15168;0,0466772151898734;4,67
2007;"2380";"Kvinnor";0;690;14197;14887;0,0463491636998724;4,63
2007;"2401";"Män";0;8;1087;1095;0,00730593607305936;0,73
2007;"2401";"Kvinnor";0;12;941;953;0,012591815320042;1,26
2007;"2403";"Män";0;0;307;307;0;0
2007;"2403";"Kvinnor";0;4;317;321;0,0124610591900312;1,25
2007;"2404";"Män";0;15;1169;1184;0,0126689189189189;1,27
2007;"2404";"Kvinnor";0;27;867;894;0,0302013422818792;3,02
2007;"2409";"Män";0;9;1126;1135;0,0079295154185022;0,79
2007;"2409";"Kvinnor";0;15;1104;1119;0,0134048257372654;1,34
2007;"2417";"Män";0;13;932;945;0,0137566137566138;1,38
2007;"2417";"Kvinnor";0;36;787;823;0,0437424058323208;4,37
2007;"2418";"Män";0;3;750;753;0,00398406374501992;0,4
2007;"2418";"Kvinnor";0;17;584;601;0,0282861896838602;2,83
2007;"2421";"Män";0;17;1283;1300;0,0130769230769231;1,31
2007;"2421";"Kvinnor";0;19;1136;1155;0,0164502164502165;1,65
2007;"2422";"Män";0;4;571;575;0,00695652173913044;0,7
2007;"2422";"Kvinnor";0;7;491;498;0,0140562248995984;1,41
2007;"2425";"Män";0;3;624;627;0,00478468899521531;0,48
2007;"2425";"Kvinnor";0;7;511;518;0,0135135135135135;1,35
2007;"2460";"Män";0;10;1318;1328;0,00753012048192771;0,75
2007;"2460";"Kvinnor";0;11;1118;1129;0,00974313551815766;0,97
2007;"2462";"Män";0;23;1209;1232;0,0186688311688312;1,87
2007;"2462";"Kvinnor";0;29;1162;1191;0,0243492863140218;2,43
2007;"2463";"Män";0;1;516;517;0,00193423597678917;0,19
2007;"2463";"Kvinnor";0;8;497;505;0,0158415841584158;1,58
2007;"2480";"Män";0;977;27675;28652;0,0340988412676253;3,41
2007;"2480";"Kvinnor";0;1069;25271;26340;0,040584662110858;4,06
2007;"2481";"Män";0;65;2894;2959;0,0219668807029402;2,2
2007;"2481";"Kvinnor";0;68;2563;2631;0,0258456860509312;2,58
2007;"2482";"Män";0;404;16536;16940;0,0238488783943329;2,38
2007;"2482";"Kvinnor";0;512;12954;13466;0,0380216842417941;3,8
2007;"2505";"Män";0;14;1343;1357;0,0103168754605748;1,03
2007;"2505";"Kvinnor";0;32;1231;1263;0,0253365003958828;2,53
2007;"2506";"Män";0;22;690;712;0,0308988764044944;3,09
2007;"2506";"Kvinnor";0;43;577;620;0,0693548387096774;6,94
2007;"2510";"Män";0;23;1106;1129;0,0203720106288751;2,04
2007;"2510";"Kvinnor";0;50;880;930;0,0537634408602151;5,38
2007;"2513";"Män";0;23;764;787;0,0292249047013977;2,92
2007;"2513";"Kvinnor";0;40;623;663;0,0603318250377074;6,03
2007;"2514";"Män";0;40;3510;3550;0,0112676056338028;1,13
2007;"2514";"Kvinnor";0;46;3194;3240;0,0141975308641975;1,42
2007;"2518";"Män";0;11;773;784;0,014030612244898;1,4
2007;"2518";"Kvinnor";0;16;735;751;0,0213049267643142;2,13
2007;"2521";"Män";0;34;1024;1058;0,0321361058601134;3,21
2007;"2521";"Kvinnor";0;25;1007;1032;0,0242248062015504;2,42
2007;"2523";"Män";0;64;4665;4729;0,013533516599704;1,35
2007;"2523";"Kvinnor";0;79;3421;3500;0,0225714285714286;2,26
2007;"2560";"Män";0;6;1430;1436;0,00417827298050139;0,42
2007;"2560";"Kvinnor";0;27;1347;1374;0,0196506550218341;1,97
2007;"2580";"Män";0;737;19367;20104;0,0366593712693991;3,67
2007;"2580";"Kvinnor";0;941;15942;16883;0,0557365397145057;5,57
2007;"2581";"Män";0;196;8305;8501;0,0230561110457593;2,31
2007;"2581";"Kvinnor";0;276;7174;7450;0,0370469798657718;3,7
2007;"2582";"Män";0;49;5087;5136;0,0095404984423676;0,95
2007;"2582";"Kvinnor";0;72;4273;4345;0,0165707710011507;1,66
2007;"2583";"Män";0;27;1589;1616;0,0167079207920792;1,67
2007;"2583";"Kvinnor";0;53;1646;1699;0,0311948204826368;3,12
2007;"2584";"Män";0;138;6338;6476;0,0213094502779494;2,13
2007;"2584";"Kvinnor";0;266;4867;5133;0,0518215468536918;5,18
2007;"9999";"Män";0;1548;130104;131652;0,0117582718074925;1,18
2007;"9999";"Kvinnor";0;1483;155490;156973;0,00944748459926229;0,94
2008;"0114";"Män";0;195;7028;7223;0,0269970926207947;2,7
2008;"0114";"Kvinnor";0;261;6166;6427;0,0406099268710129;4,06
2008;"0115";"Män";0;91;3331;3422;0,0265926358854471;2,66
2008;"0115";"Kvinnor";0;102;3399;3501;0,0291345329905741;2,91
2008;"0117";"Män";0;151;3981;4132;0,0365440464666021;3,65
2008;"0117";"Kvinnor";0;209;4260;4469;0,0467666144551354;4,68
2008;"0120";"Män";0;194;4531;4725;0,0410582010582011;4,11
2008;"0120";"Kvinnor";0;223;4415;4638;0,0480810694264769;4,81
2008;"0123";"Män";0;282;11799;12081;0,023342438539856;2,33
2008;"0123";"Kvinnor";0;453;8591;9044;0,0500884564352057;5,01
2008;"0125";"Män";0;132;3293;3425;0,0385401459854015;3,85
2008;"0125";"Kvinnor";0;144;3087;3231;0,0445682451253482;4,46
2008;"0126";"Män";0;411;18681;19092;0,0215273412947832;2,15
2008;"0126";"Kvinnor";0;499;20171;20670;0,024141267537494;2,41
2008;"0127";"Män";0;457;10980;11437;0,0399580309521728;4
2008;"0127";"Kvinnor";0;477;8448;8925;0,0534453781512605;5,34
2008;"0128";"Män";0;35;1031;1066;0,0328330206378987;3,28
2008;"0128";"Kvinnor";0;36;1299;1335;0,0269662921348315;2,7
2008;"0136";"Män";0;193;12118;12311;0,015677036796361;1,57
2008;"0136";"Kvinnor";0;321;9436;9757;0,032899456800246;3,29
2008;"0138";"Män";0;184;4639;4823;0,0381505287165665;3,82
2008;"0138";"Kvinnor";0;178;4320;4498;0,0395731436193864;3,96
2008;"0139";"Män";0;64;4235;4299;0,0148871830658293;1,49
2008;"0139";"Kvinnor";0;54;2896;2950;0,0183050847457627;1,83
2008;"0140";"Män";0;12;1168;1180;0,0101694915254237;1,02
2008;"0140";"Kvinnor";0;15;869;884;0,0169683257918552;1,7
2008;"0160";"Män";0;446;10787;11233;0,0397044422683166;3,97
2008;"0160";"Kvinnor";0;749;9854;10603;0,0706403847967556;7,06
2008;"0162";"Män";0;200;5973;6173;0,0323991576219018;3,24
2008;"0162";"Kvinnor";0;300;9397;9697;0,0309374033206146;3,09
2008;"0163";"Män";0;371;11881;12252;0,0302807704864512;3,03
2008;"0163";"Kvinnor";0;469;10128;10597;0,0442578088138152;4,43
2008;"0180";"Män";0;29757;257774;287531;0,103491449617606;10,35
2008;"0180";"Kvinnor";0;32600;232991;265591;0,122745123140468;12,27
2008;"0181";"Män";0;565;23867;24432;0,0231254092992796;2,31
2008;"0181";"Kvinnor";0;594;19456;20050;0,0296259351620948;2,96
2008;"0182";"Män";0;908;14532;15440;0,0588082901554404;5,88
2008;"0182";"Kvinnor";0;1179;13166;14345;0,0821889159986058;8,22
2008;"0183";"Män";0;335;10260;10595;0,0316186880604059;3,16
2008;"0183";"Kvinnor";0;245;8175;8420;0,0290973871733967;2,91
2008;"0184";"Män";0;1573;33732;35305;0,0445545956663362;4,46
2008;"0184";"Kvinnor";0;1498;32573;34071;0,0439670100672126;4,4
2008;"0186";"Män";0;622;4811;5433;0,114485551260814;11,45
2008;"0186";"Kvinnor";0;547;5356;5903;0,0926647467389463;9,27
2008;"0187";"Män";0;63;993;1056;0,0596590909090909;5,97
2008;"0187";"Kvinnor";0;81;1243;1324;0,061178247734139;6,12
2008;"0188";"Män";0;263;9156;9419;0,0279222847436034;2,79
2008;"0188";"Kvinnor";0;312;9138;9450;0,033015873015873;3,3
2008;"0191";"Män";0;205;14627;14832;0,0138214670981661;1,38
2008;"0191";"Kvinnor";0;250;11108;11358;0,0220109174150379;2,2
2008;"0192";"Män";0;64;3009;3073;0,0208265538561666;2,08
2008;"0192";"Kvinnor";0;108;3084;3192;0,0338345864661654;3,38
2008;"0305";"Män";0;45;2131;2176;0,0206801470588235;2,07
2008;"0305";"Kvinnor";0;84;2117;2201;0,0381644706951386;3,82
2008;"0319";"Män";0;33;1274;1307;0,0252486610558531;2,52
2008;"0319";"Kvinnor";0;30;989;1019;0,0294406280667321;2,94
2008;"0330";"Män";0;26;1451;1477;0,017603249830738;1,76
2008;"0330";"Kvinnor";0;45;1530;1575;0,0285714285714286;2,86
2008;"0331";"Män";0;141;1733;1874;0,0752401280683031;7,52
2008;"0331";"Kvinnor";0;174;1623;1797;0,0968280467445743;9,68
2008;"0360";"Män";0;50;3628;3678;0,0135943447525829;1,36
2008;"0360";"Kvinnor";0;58;2724;2782;0,0208483105679367;2,08
2008;"0380";"Män";0;1884;38226;40110;0,0469708302169035;4,7
2008;"0380";"Kvinnor";0;2234;41472;43706;0,0511142634878506;5,11
2008;"0381";"Män";0;108;6816;6924;0,0155979202772964;1,56
2008;"0381";"Kvinnor";0;187;6206;6393;0,0292507430001564;2,93
2008;"0382";"Män";0;33;4761;4794;0,00688360450563204;0,69
2008;"0382";"Kvinnor";0;54;3620;3674;0,0146978769733261;1,47
2008;"0428";"Män";0;62;1573;1635;0,0379204892966361;3,79
2008;"0428";"Kvinnor";0;120;1213;1333;0,0900225056264066;9
2008;"0461";"Män";0;32;1037;1069;0,0299345182413471;2,99
2008;"0461";"Kvinnor";0;52;1367;1419;0,036645525017618;3,66
2008;"0480";"Män";0;274;9960;10234;0,0267735000977135;2,68
2008;"0480";"Kvinnor";0;373;9945;10318;0,0361504167474317;3,62
2008;"0481";"Män";0;29;3419;3448;0,00841067285382831;0,84
2008;"0481";"Kvinnor";0;26;1809;1835;0,0141689373297003;1,42
2008;"0482";"Män";0;48;2839;2887;0,0166262556286803;1,66
2008;"0482";"Kvinnor";0;60;2524;2584;0,0232198142414861;2,32
2008;"0483";"Män";0;444;6289;6733;0,0659438586068617;6,59
2008;"0483";"Kvinnor";0;273;5639;5912;0,0461772665764547;4,62
2008;"0484";"Män";0;705;19932;20637;0,0341619421427533;3,42
2008;"0484";"Kvinnor";0;978;17986;18964;0,0515713984391479;5,16
2008;"0486";"Män";0;149;4955;5104;0,029192789968652;2,92
2008;"0486";"Kvinnor";0;159;4657;4816;0,033014950166113;3,3
2008;"0488";"Män";0;106;1552;1658;0,0639324487334137;6,39
2008;"0488";"Kvinnor";0;118;1586;1704;0,0692488262910798;6,92
2008;"0509";"Män";0;55;808;863;0,0637311703360371;6,37
2008;"0509";"Kvinnor";0;31;757;788;0,0393401015228426;3,93
2008;"0512";"Män";0;3;687;690;0,00434782608695652;0,43
2008;"0512";"Kvinnor";0;7;465;472;0,0148305084745763;1,48
2008;"0513";"Män";0;31;1643;1674;0,0185185185185185;1,85
2008;"0513";"Kvinnor";0;31;1529;1560;0,0198717948717949;1,99
2008;"0560";"Män";0;3;1105;1108;0,00270758122743682;0,27
2008;"0560";"Kvinnor";0;7;602;609;0,0114942528735632;1,15
2008;"0561";"Män";0;57;1768;1825;0,0312328767123288;3,12
2008;"0561";"Kvinnor";0;48;1415;1463;0,0328092959671907;3,28
2008;"0562";"Män";0;39;5524;5563;0,00701060578824375;0,7
2008;"0562";"Kvinnor";0;68;3173;3241;0,0209811786485653;2,1
2008;"0563";"Män";0;16;1581;1597;0,0100187852222918;1
2008;"0563";"Kvinnor";0;35;1083;1118;0,0313059033989267;3,13
2008;"0580";"Män";0;985;35628;36613;0,0269030125911561;2,69
2008;"0580";"Kvinnor";0;1210;31482;32692;0,0370121130551817;3,7
2008;"0581";"Män";0;1045;28328;29373;0,0355768903414701;3,56
2008;"0581";"Kvinnor";0;1221;25544;26765;0,045619278909023;4,56
2008;"0582";"Män";0;46;2016;2062;0,0223084384093113;2,23
2008;"0582";"Kvinnor";0;73;1781;1854;0,0393743257820928;3,94
2008;"0583";"Män";0;267;7719;7986;0,0334335086401202;3,34
2008;"0583";"Kvinnor";0;250;6901;7151;0,034960145434205;3,5
2008;"0584";"Män";0;51;1595;1646;0,0309842041312272;3,1
2008;"0584";"Kvinnor";0;71;1270;1341;0,0529455630126771;5,29
2008;"0586";"Män";0;172;5846;6018;0,0285809238949817;2,86
2008;"0586";"Kvinnor";0;175;3863;4038;0,0433382862803368;4,33
2008;"0604";"Män";0;14;1363;1377;0,0101670297748729;1,02
2008;"0604";"Kvinnor";0;17;1044;1061;0,0160226201696513;1,6
2008;"0617";"Män";0;40;3393;3433;0,0116516166618118;1,17
2008;"0617";"Kvinnor";0;52;2353;2405;0,0216216216216216;2,16
2008;"0642";"Män";0;24;1268;1292;0,0185758513931889;1,86
2008;"0642";"Kvinnor";0;32;1085;1117;0,0286481647269472;2,86
2008;"0643";"Män";0;46;1861;1907;0,0241216570529628;2,41
2008;"0643";"Kvinnor";0;36;1518;1554;0,0231660231660232;2,32
2008;"0662";"Män";0;110;8286;8396;0,0131014768937589;1,31
2008;"0662";"Kvinnor";0;186;6214;6400;0,0290625;2,91
2008;"0665";"Män";0;26;3057;3083;0,00843334414531301;0,84
2008;"0665";"Kvinnor";0;32;2270;2302;0,0139009556907037;1,39
2008;"0680";"Män";0;1162;31394;32556;0,0356923454969898;3,57
2008;"0680";"Kvinnor";0;1334;27351;28685;0,0465051420603103;4,65
2008;"0682";"Män";0;272;6811;7083;0,0384018071438656;3,84
2008;"0682";"Kvinnor";0;238;5154;5392;0,0441394658753709;4,41
2008;"0683";"Män";0;250;8624;8874;0,0281721884155961;2,82
2008;"0683";"Kvinnor";0;403;7832;8235;0,0489374620522161;4,89
2008;"0684";"Män";0;29;2464;2493;0,0116325711993582;1,16
2008;"0684";"Kvinnor";0;31;1659;1690;0,0183431952662722;1,83
2008;"0685";"Män";0;85;6698;6783;0,012531328320802;1,25
2008;"0685";"Kvinnor";0;148;5094;5242;0,0282334986646318;2,82
2008;"0686";"Män";0;80;4302;4382;0,0182565038795071;1,83
2008;"0686";"Kvinnor";0;120;4148;4268;0,028116213683224;2,81
2008;"0687";"Män";0;120;4233;4353;0,0275671950379049;2,76
2008;"0687";"Kvinnor";0;134;3562;3696;0,0362554112554113;3,63
2008;"0760";"Män";0;21;2817;2838;0,00739957716701903;0,74
2008;"0760";"Kvinnor";0;20;1997;2017;0,00991571641051066;0,99
2008;"0761";"Män";0;36;1439;1475;0,0244067796610169;2,44
2008;"0761";"Kvinnor";0;80;1291;1371;0,0583515681983953;5,84
2008;"0763";"Män";0;41;3009;3050;0,0134426229508197;1,34
2008;"0763";"Kvinnor";0;53;2411;2464;0,0215097402597403;2,15
2008;"0764";"Män";0;48;4272;4320;0,0111111111111111;1,11
2008;"0764";"Kvinnor";0;54;3117;3171;0,0170293282876064;1,7
2008;"0765";"Män";0;665;4513;5178;0,128427964465044;12,84
2008;"0765";"Kvinnor";0;724;3670;4394;0,164770141101502;16,48
2008;"0767";"Män";0;46;2855;2901;0,0158566011720097;1,59
2008;"0767";"Kvinnor";0;44;1959;2003;0,0219670494258612;2,2
2008;"0780";"Män";0;809;20413;21222;0,0381208180190368;3,81
2008;"0780";"Kvinnor";0;921;18339;19260;0,0478193146417445;4,78
2008;"0781";"Män";0;520;7004;7524;0,0691121743753323;6,91
2008;"0781";"Kvinnor";0;416;5571;5987;0,0694838817437782;6,95
2008;"0821";"Män";0;15;882;897;0,0167224080267559;1,67
2008;"0821";"Kvinnor";0;10;903;913;0,0109529025191676;1,1
2008;"0834";"Män";0;9;1557;1566;0,00574712643678161;0,57
2008;"0834";"Kvinnor";0;19;1028;1047;0,0181470869149952;1,81
2008;"0840";"Män";0;52;2038;2090;0,0248803827751196;2,49
2008;"0840";"Kvinnor";0;101;1789;1890;0,0534391534391534;5,34
2008;"0860";"Män";0;51;2752;2803;0,018194791295041;1,82
2008;"0860";"Kvinnor";0;50;2265;2315;0,0215982721382289;2,16
2008;"0861";"Män";0;23;2440;2463;0,00933820544051969;0,93
2008;"0861";"Kvinnor";0;36;1933;1969;0,0182833925850686;1,83
2008;"0862";"Män";0;31;2759;2790;0,0111111111111111;1,11
2008;"0862";"Kvinnor";0;36;1733;1769;0,0203504804974562;2,04
2008;"0880";"Män";0;671;14256;14927;0,0449521002210759;4,5
2008;"0880";"Kvinnor";0;799;13709;14508;0,0550730631375793;5,51
2008;"0881";"Män";0;47;4498;4545;0,0103410341034103;1,03
2008;"0881";"Kvinnor";0;88;3427;3515;0,0250355618776671;2,5
2008;"0882";"Män";0;71;7750;7821;0,00907812300217363;0,91
2008;"0882";"Kvinnor";0;164;5812;5976;0,0274431057563588;2,74
2008;"0883";"Män";0;149;7279;7428;0,0200592353257943;2,01
2008;"0883";"Kvinnor";0;175;6919;7094;0,0246687341415281;2,47
2008;"0884";"Män";0;251;3876;4127;0,0608189968500121;6,08
2008;"0884";"Kvinnor";0;276;2917;3193;0,0864390854995302;8,64
2008;"0885";"Män";0;67;1729;1796;0,0373051224944321;3,73
2008;"0885";"Kvinnor";0;85;1619;1704;0,0498826291079812;4,99
2008;"0980";"Män";0;482;11654;12136;0,0397165458141068;3,97
2008;"0980";"Kvinnor";0;543;11290;11833;0,0458886165807488;4,59
2008;"1060";"Män";0;64;4295;4359;0,0146822665749025;1,47
2008;"1060";"Kvinnor";0;86;2350;2436;0,035303776683087;3,53
2008;"1080";"Män";0;466;14502;14968;0,0311330839123463;3,11
2008;"1080";"Kvinnor";0;528;12763;13291;0,0397261304642239;3,97
2008;"1081";"Män";0;106;6567;6673;0,0158849093361307;1,59
2008;"1081";"Kvinnor";0;185;4645;4830;0,0383022774327122;3,83
2008;"1082";"Män";0;166;5460;5626;0,0295058656238891;2,95
2008;"1082";"Kvinnor";0;264;5372;5636;0,0468417317246274;4,68
2008;"1083";"Män";0;89;3107;3196;0,0278473091364205;2,78
2008;"1083";"Kvinnor";0;106;2461;2567;0,041293338527464;4,13
2008;"1214";"Män";0;19;1603;1622;0,0117139334155364;1,17
2008;"1214";"Kvinnor";0;34;1592;1626;0,020910209102091;2,09
2008;"1230";"Män";0;79;2866;2945;0,0268251273344652;2,68
2008;"1230";"Kvinnor";0;55;2236;2291;0,0240069838498472;2,4
2008;"1231";"Män";0;122;4425;4547;0,0268308775016494;2,68
2008;"1231";"Kvinnor";0;224;2778;3002;0,0746169220519654;7,46
2008;"1233";"Män";0;294;3177;3471;0,0847018150388937;8,47
2008;"1233";"Kvinnor";0;228;3557;3785;0,0602377807133421;6,02
2008;"1256";"Män";0;40;2552;2592;0,0154320987654321;1,54
2008;"1256";"Kvinnor";0;61;1888;1949;0,0312981015905593;3,13
2008;"1257";"Män";0;19;2035;2054;0,00925024342745862;0,93
2008;"1257";"Kvinnor";0;26;1823;1849;0,0140616549486209;1,41
2008;"1260";"Män";0;29;2582;2611;0,0111068556108771;1,11
2008;"1260";"Kvinnor";0;35;1954;1989;0,0175967823026647;1,76
2008;"1261";"Män";0;97;3269;3366;0,0288175876411171;2,88
2008;"1261";"Kvinnor";0;233;3003;3236;0,0720024721878863;7,2
2008;"1262";"Män";0;69;2059;2128;0,0324248120300752;3,24
2008;"1262";"Kvinnor";0;68;2205;2273;0,0299164100307963;2,99
2008;"1263";"Män";0;78;3235;3313;0,0235436160579535;2,35
2008;"1263";"Kvinnor";0;128;2500;2628;0,0487062404870624;4,87
2008;"1264";"Män";0;62;1683;1745;0,0355300859598854;3,55
2008;"1264";"Kvinnor";0;81;1682;1763;0,0459444129325014;4,59
2008;"1265";"Män";0;56;2987;3043;0,0184028918830102;1,84
2008;"1265";"Kvinnor";0;97;2357;2454;0,0395273023634882;3,95
2008;"1266";"Män";0;37;2145;2182;0,0169569202566453;1,7
2008;"1266";"Kvinnor";0;72;2034;2106;0,0341880341880342;3,42
2008;"1267";"Män";0;39;1849;1888;0,0206567796610169;2,07
2008;"1267";"Kvinnor";0;60;2257;2317;0,0258955545964609;2,59
2008;"1270";"Män";0;56;2361;2417;0,0231692180388912;2,32
2008;"1270";"Kvinnor";0;71;1826;1897;0,0374275171323142;3,74
2008;"1272";"Män";0;29;2763;2792;0,0103868194842407;1,04
2008;"1272";"Kvinnor";0;33;1983;2016;0,0163690476190476;1,64
2008;"1273";"Män";0;35;2174;2209;0,01584427342689;1,58
2008;"1273";"Kvinnor";0;47;1765;1812;0,0259381898454746;2,59
2008;"1275";"Män";0;11;1902;1913;0,00575013068478829;0,58
2008;"1275";"Kvinnor";0;11;1216;1227;0,00896495517522412;0,9
2008;"1276";"Män";0;105;2975;3080;0,0340909090909091;3,41
2008;"1276";"Kvinnor";0;77;2391;2468;0,0311993517017828;3,12
2008;"1277";"Män";0;24;2906;2930;0,00819112627986348;0,82
2008;"1277";"Kvinnor";0;110;2451;2561;0,042951971885982;4,3
2008;"1278";"Män";0;100;3274;3374;0,02963841138115;2,96
2008;"1278";"Kvinnor";0;197;2516;2713;0,0726133431625507;7,26
2008;"1280";"Män";0;5032;71426;76458;0,0658139109053336;6,58
2008;"1280";"Kvinnor";0;4976;62707;67683;0,0735191997990633;7,35
2008;"1281";"Män";0;2013;29570;31583;0,0637368204413767;6,37
2008;"1281";"Kvinnor";0;1688;29089;30777;0,0548461513467849;5,48
2008;"1282";"Män";0;317;7350;7667;0,0413460284335464;4,13
2008;"1282";"Kvinnor";0;314;6048;6362;0,0493555485696322;4,94
2008;"1283";"Män";0;1874;29850;31724;0,0590719959651998;5,91
2008;"1283";"Kvinnor";0;2088;27058;29146;0,0716393330131064;7,16
2008;"1284";"Män";0;94;3344;3438;0,0273414776032577;2,73
2008;"1284";"Kvinnor";0;143;3357;3500;0,0408571428571429;4,09
2008;"1285";"Män";0;155;5249;5404;0,0286824574389341;2,87
2008;"1285";"Kvinnor";0;160;4586;4746;0,0337126000842815;3,37
2008;"1286";"Män";0;209;5004;5213;0,0400920774985613;4,01
2008;"1286";"Kvinnor";0;274;5305;5579;0,0491127442193942;4,91
2008;"1287";"Män";0;110;6527;6637;0,0165737532017478;1,66
2008;"1287";"Kvinnor";0;234;5952;6186;0,037827352085354;3,78
2008;"1290";"Män";0;496;15986;16482;0,0300934352627108;3,01
2008;"1290";"Kvinnor";0;695;16120;16815;0,0413321439191198;4,13
2008;"1291";"Män";0;108;3204;3312;0,0326086956521739;3,26
2008;"1291";"Kvinnor";0;160;3165;3325;0,0481203007518797;4,81
2008;"1292";"Män";0;185;6980;7165;0,0258199581297976;2,58
2008;"1292";"Kvinnor";0;377;7691;8068;0,0467278135845315;4,67
2008;"1293";"Män";0;308;10534;10842;0,028408042796532;2,84
2008;"1293";"Kvinnor";0;299;9027;9326;0,0320609049967832;3,21
2008;"1315";"Män";0;34;2624;2658;0,0127915726109857;1,28
2008;"1315";"Kvinnor";0;50;1964;2014;0,0248262164846077;2,48
2008;"1380";"Män";0;879;20731;21610;0,0406756131420639;4,07
2008;"1380";"Kvinnor";0;1122;18819;19941;0,0562659846547315;5,63
2008;"1381";"Män";0;192;4053;4245;0,0452296819787986;4,52
2008;"1381";"Kvinnor";0;167;3444;3611;0,0462475768485184;4,62
2008;"1382";"Män";0;477;8542;9019;0,0528883468233729;5,29
2008;"1382";"Kvinnor";0;1072;6832;7904;0,135627530364372;13,56
2008;"1383";"Män";0;458;12743;13201;0,0346943413377774;3,47
2008;"1383";"Kvinnor";0;737;10943;11680;0,0630993150684931;6,31
2008;"1384";"Män";0;646;8954;9600;0,0672916666666667;6,73
2008;"1384";"Kvinnor";0;826;10091;10917;0,0756618118530732;7,57
2008;"1401";"Män";0;294;6287;6581;0,0446740616927519;4,47
2008;"1401";"Kvinnor";0;256;5663;5919;0,0432505490792364;4,33
2008;"1402";"Män";0;214;5088;5302;0,040362127499057;4,04
2008;"1402";"Kvinnor";0;361;4542;4903;0,0736283907811544;7,36
2008;"1407";"Män";0;27;1202;1229;0,0219690805532954;2,2
2008;"1407";"Kvinnor";0;45;1384;1429;0,0314905528341498;3,15
2008;"1415";"Män";0;85;6130;6215;0,0136765888978278;1,37
2008;"1415";"Kvinnor";0;224;4038;4262;0,0525574847489442;5,26
2008;"1419";"Män";0;33;1958;1991;0,0165745856353591;1,66
2008;"1419";"Kvinnor";0;60;2117;2177;0,0275608635737253;2,76
2008;"1421";"Män";0;19;2672;2691;0,00706057227796358;0,71
2008;"1421";"Kvinnor";0;40;2113;2153;0,018578727357176;1,86
2008;"1427";"Män";0;22;1911;1933;0,0113812726332126;1,14
2008;"1427";"Kvinnor";0;39;1752;1791;0,0217755443886097;2,18
2008;"1430";"Män";0;87;1753;1840;0,0472826086956522;4,73
2008;"1430";"Kvinnor";0;61;1556;1617;0,0377241805813234;3,77
2008;"1435";"Män";0;80;2414;2494;0,0320769847634322;3,21
2008;"1435";"Kvinnor";0;151;1935;2086;0,0723873441994247;7,24
2008;"1438";"Män";0;14;1034;1048;0,0133587786259542;1,34
2008;"1438";"Kvinnor";0;13;806;819;0,0158730158730159;1,59
2008;"1439";"Män";0;4;964;968;0,00413223140495868;0,41
2008;"1439";"Kvinnor";0;6;976;982;0,00610997963340122;0,61
2008;"1440";"Män";0;60;2968;3028;0,0198150594451783;1,98
2008;"1440";"Kvinnor";0;62;3051;3113;0,0199164792804369;1,99
2008;"1441";"Män";0;160;3741;3901;0,0410151243270956;4,1
2008;"1441";"Kvinnor";0;193;4429;4622;0,0417568152315015;4,18
2008;"1442";"Män";0;49;2569;2618;0,018716577540107;1,87
2008;"1442";"Kvinnor";0;43;1907;1950;0,022051282051282;2,21
2008;"1443";"Män";0;34;1299;1333;0,0255063765941485;2,55
2008;"1443";"Kvinnor";0;31;948;979;0,0316649642492339;3,17
2008;"1444";"Män";0;6;703;709;0,00846262341325811;0,85
2008;"1444";"Kvinnor";0;19;730;749;0,0253671562082777;2,54
2008;"1445";"Män";0;51;1025;1076;0,0473977695167286;4,74
2008;"1445";"Kvinnor";0;62;756;818;0,0757946210268949;7,58
2008;"1446";"Män";0;27;1513;1540;0,0175324675324675;1,75
2008;"1446";"Kvinnor";0;23;1207;1230;0,0186991869918699;1,87
2008;"1447";"Män";0;5;1020;1025;0,0048780487804878;0,49
2008;"1447";"Kvinnor";0;8;718;726;0,0110192837465565;1,1
2008;"1452";"Män";0;106;3472;3578;0,0296254891000559;2,96
2008;"1452";"Kvinnor";0;141;2084;2225;0,0633707865168539;6,34
2008;"1460";"Män";0;42;1877;1919;0,0218863991662324;2,19
2008;"1460";"Kvinnor";0;84;1700;1784;0,047085201793722;4,71
2008;"1461";"Män";0;14;1621;1635;0,00856269113149847;0,86
2008;"1461";"Kvinnor";0;42;1402;1444;0,0290858725761773;2,91
2008;"1462";"Män";0;25;1889;1914;0,0130616509926855;1,31
2008;"1462";"Kvinnor";0;23;1831;1854;0,0124056094929881;1,24
2008;"1463";"Män";0;226;5348;5574;0,0405453893074991;4,05
2008;"1463";"Kvinnor";0;305;5237;5542;0,0550342836521112;5,5
2008;"1465";"Män";0;313;1726;2039;0,153506620892594;15,35
2008;"1465";"Kvinnor";0;180;1671;1851;0,0972447325769854;9,72
2008;"1466";"Män";0;11;2153;2164;0,00508317929759704;0,51
2008;"1466";"Kvinnor";0;14;1566;1580;0,00886075949367089;0,89
2008;"1470";"Män";0;71;4840;4911;0,0144573406638159;1,45
2008;"1470";"Kvinnor";0;86;2810;2896;0,0296961325966851;2,97
2008;"1471";"Män";0;47;3520;3567;0,0131763386599383;1,32
2008;"1471";"Kvinnor";0;47;2517;2564;0,0183307332293292;1,83
2008;"1472";"Män";0;30;1977;2007;0,0149476831091181;1,49
2008;"1472";"Kvinnor";0;33;1716;1749;0,0188679245283019;1,89
2008;"1473";"Män";0;19;1694;1713;0,0110916520723876;1,11
2008;"1473";"Kvinnor";0;28;1317;1345;0,020817843866171;2,08
2008;"1480";"Män";0;7697;150556;158253;0,0486373086134228;4,86
2008;"1480";"Kvinnor";0;9125;128403;137528;0,0663501250654412;6,64
2008;"1481";"Män";0;677;15823;16500;0,041030303030303;4,1
2008;"1481";"Kvinnor";0;931;14655;15586;0,0597330938021301;5,97
2008;"1482";"Män";0;211;6861;7072;0,0298359728506787;2,98
2008;"1482";"Kvinnor";0;206;6608;6814;0,0302318755503375;3,02
2008;"1484";"Män";0;53;3111;3164;0,0167509481668774;1,68
2008;"1484";"Kvinnor";0;83;2364;2447;0,0339190845933796;3,39
2008;"1485";"Män";0;402;10403;10805;0,0372049976862564;3,72
2008;"1485";"Kvinnor";0;615;10933;11548;0,0532559750606166;5,33
2008;"1486";"Män";0;115;2529;2644;0,0434947049924357;4,35
2008;"1486";"Kvinnor";0;219;2742;2961;0,0739614994934144;7,4
2008;"1487";"Män";0;144;6236;6380;0,0225705329153605;2,26
2008;"1487";"Kvinnor";0;188;6134;6322;0,0297374248655489;2,97
2008;"1488";"Män";0;229;15858;16087;0,0142350966619009;1,42
2008;"1488";"Kvinnor";0;462;12300;12762;0,0362012223789375;3,62
2008;"1489";"Män";0;199;5875;6074;0,0327625946657886;3,28
2008;"1489";"Kvinnor";0;295;6634;6929;0,0425746861018906;4,26
2008;"1490";"Män";0;2151;22014;24165;0,0890130353817505;8,9
2008;"1490";"Kvinnor";0;2594;21475;24069;0,107773484565208;10,78
2008;"1491";"Män";0;294;4128;4422;0,0664857530529172;6,65
2008;"1491";"Kvinnor";0;387;3375;3762;0,102870813397129;10,29
2008;"1492";"Män";0;72;2368;2440;0,0295081967213115;2,95
2008;"1492";"Kvinnor";0;83;2049;2132;0,0389305816135084;3,89
2008;"1493";"Män";0;63;4612;4675;0,013475935828877;1,35
2008;"1493";"Kvinnor";0;118;4235;4353;0,0271077417872731;2,71
2008;"1494";"Män";0;204;8521;8725;0,0233810888252149;2,34
2008;"1494";"Kvinnor";0;289;7024;7313;0,0395186653904007;3,95
2008;"1495";"Män";0;129;4132;4261;0,0302745834311195;3,03
2008;"1495";"Kvinnor";0;171;3817;3988;0,0428786359077232;4,29
2008;"1496";"Män";0;300;15994;16294;0,0184116852829262;1,84
2008;"1496";"Kvinnor";0;473;12734;13207;0,0358143408798365;3,58
2008;"1497";"Män";0;25;1357;1382;0,0180897250361794;1,81
2008;"1497";"Kvinnor";0;49;1312;1361;0,0360029390154298;3,6
2008;"1498";"Män";0;37;2501;2538;0,0145784081954295;1,46
2008;"1498";"Kvinnor";0;53;1915;1968;0,0269308943089431;2,69
2008;"1499";"Män";0;200;6431;6631;0,0301613632936209;3,02
2008;"1499";"Kvinnor";0;204;5569;5773;0,0353369132166984;3,53
2008;"1715";"Män";0;27;1650;1677;0,0161001788908766;1,61
2008;"1715";"Kvinnor";0;34;1359;1393;0,0244077530509691;2,44
2008;"1730";"Män";0;15;1436;1451;0,0103376981392143;1,03
2008;"1730";"Kvinnor";0;129;1552;1681;0,0767400356930399;7,67
2008;"1737";"Män";0;35;2350;2385;0,0146750524109015;1,47
2008;"1737";"Kvinnor";0;51;2384;2435;0,0209445585215606;2,09
2008;"1760";"Män";0;1;728;729;0,00137174211248285;0,14
2008;"1760";"Kvinnor";0;3;513;516;0,00581395348837209;0,58
2008;"1761";"Män";0;16;2047;2063;0,00775569558894813;0,78
2008;"1761";"Kvinnor";0;24;1733;1757;0,0136596471257826;1,37
2008;"1762";"Män";0;25;778;803;0,0311332503113325;3,11
2008;"1762";"Kvinnor";0;32;595;627;0,05103668261563;5,1
2008;"1763";"Män";0;19;1092;1111;0,0171017101710171;1,71
2008;"1763";"Kvinnor";0;26;1263;1289;0,0201706749418154;2,02
2008;"1764";"Män";0;8;1823;1831;0,00436919716002185;0,44
2008;"1764";"Kvinnor";0;11;1297;1308;0,00840978593272171;0,84
2008;"1765";"Män";0;32;1790;1822;0,017563117453348;1,76
2008;"1765";"Kvinnor";0;122;1742;1864;0,065450643776824;6,55
2008;"1766";"Män";0;137;2592;2729;0,050201539025284;5,02
2008;"1766";"Kvinnor";0;111;2063;2174;0,0510579576816927;5,11
2008;"1780";"Män";0;1052;22464;23516;0,0447354992345637;4,47
2008;"1780";"Kvinnor";0;1221;20293;21514;0,0567537417495584;5,68
2008;"1781";"Män";0;61;4917;4978;0,0122539172358377;1,23
2008;"1781";"Kvinnor";0;108;3555;3663;0,0294840294840295;2,95
2008;"1782";"Män";0;24;1949;1973;0,0121642169285352;1,22
2008;"1782";"Kvinnor";0;27;1753;1780;0,0151685393258427;1,52
2008;"1783";"Män";0;19;2564;2583;0,00735578784359272;0,74
2008;"1783";"Kvinnor";0;45;1932;1977;0,0227617602427921;2,28
2008;"1784";"Män";0;93;5857;5950;0,0156302521008403;1,56
2008;"1784";"Kvinnor";0;157;4667;4824;0,0325456053067993;3,25
2008;"1785";"Män";0;49;3275;3324;0,0147412755716005;1,47
2008;"1785";"Kvinnor";0;70;2299;2369;0,0295483326298016;2,95
2008;"1814";"Män";0;17;819;836;0,0203349282296651;2,03
2008;"1814";"Kvinnor";0;10;759;769;0,0130039011703511;1,3
2008;"1860";"Män";0;18;1610;1628;0,0110565110565111;1,11
2008;"1860";"Kvinnor";0;14;991;1005;0,0139303482587065;1,39
2008;"1861";"Män";0;82;4178;4260;0,0192488262910798;1,92
2008;"1861";"Kvinnor";0;72;2882;2954;0,024373730534868;2,44
2008;"1862";"Män";0;13;1642;1655;0,00785498489425982;0,79
2008;"1862";"Kvinnor";0;22;1228;1250;0,0176;1,76
2008;"1863";"Män";0;18;1443;1461;0,0123203285420945;1,23
2008;"1863";"Kvinnor";0;32;1117;1149;0,0278503046127067;2,79
2008;"1864";"Män";0;10;797;807;0,0123915737298637;1,24
2008;"1864";"Kvinnor";0;15;750;765;0,0196078431372549;1,96
2008;"1880";"Män";0;1401;32131;33532;0,0417809853274484;4,18
2008;"1880";"Kvinnor";0;1615;30204;31819;0,0507558377070304;5,08
2008;"1881";"Män";0;115;3310;3425;0,0335766423357664;3,36
2008;"1881";"Kvinnor";0;101;2946;3047;0,0331473580571053;3,31
2008;"1882";"Män";0;28;1898;1926;0,0145379023883697;1,45
2008;"1882";"Kvinnor";0;42;1531;1573;0,0267005721551176;2,67
2008;"1883";"Män";0;153;7581;7734;0,0197827773467804;1,98
2008;"1883";"Kvinnor";0;232;6409;6641;0,0349344978165939;3,49
2008;"1884";"Män";0;35;1534;1569;0,0223072020395156;2,23
2008;"1884";"Kvinnor";0;69;1424;1493;0,0462156731413262;4,62
2008;"1885";"Män";0;113;4852;4965;0,0227593152064451;2,28
2008;"1885";"Kvinnor";0;101;4431;4532;0,0222859664607237;2,23
2008;"1904";"Män";0;12;700;712;0,0168539325842697;1,69
2008;"1904";"Kvinnor";0;7;649;656;0,0106707317073171;1,07
2008;"1907";"Män";0;11;1742;1753;0,0062749572162008;0,63
2008;"1907";"Kvinnor";0;23;1309;1332;0,0172672672672673;1,73
2008;"1960";"Män";0;8;1618;1626;0,00492004920049201;0,49
2008;"1960";"Kvinnor";0;13;1286;1299;0,0100076982294072;1
2008;"1961";"Män";0;34;2824;2858;0,0118964310706788;1,19
2008;"1961";"Kvinnor";0;35;2398;2433;0,0143855322646938;1,44
2008;"1962";"Män";0;16;845;861;0,0185830429732869;1,86
2008;"1962";"Kvinnor";0;27;711;738;0,0365853658536585;3,66
2008;"1980";"Män";0;1250;31328;32578;0,038369451777273;3,84
2008;"1980";"Kvinnor";0;1503;27315;28818;0,0521549031855091;5,22
2008;"1981";"Män";0;96;3699;3795;0,025296442687747;2,53
2008;"1981";"Kvinnor";0;153;3631;3784;0,0404334038054968;4,04
2008;"1982";"Män";0;28;3561;3589;0,00780161604903873;0,78
2008;"1982";"Kvinnor";0;63;2720;2783;0,0226374416097736;2,26
2008;"1983";"Män";0;63;6467;6530;0,00964777947932619;0,96
2008;"1983";"Kvinnor";0;161;4824;4985;0,032296890672016;3,23
2008;"1984";"Män";0;29;2719;2748;0,0105531295487627;1,06
2008;"1984";"Kvinnor";0;53;2185;2238;0,0236818588025022;2,37
2008;"2021";"Män";0;17;1288;1305;0,0130268199233716;1,3
2008;"2021";"Kvinnor";0;22;1110;1132;0,019434628975265;1,94
2008;"2023";"Män";0;80;2713;2793;0,0286430361618332;2,86
2008;"2023";"Kvinnor";0;86;2503;2589;0,0332174584781769;3,32
2008;"2026";"Män";0;17;1244;1261;0,0134813639968279;1,35
2008;"2026";"Kvinnor";0;23;1198;1221;0,0188370188370188;1,88
2008;"2029";"Män";0;101;3076;3177;0,0317909977966635;3,18
2008;"2029";"Kvinnor";0;122;2642;2764;0,0441389290882779;4,41
2008;"2031";"Män";0;53;1614;1667;0,0317936412717457;3,18
2008;"2031";"Kvinnor";0;93;1602;1695;0,0548672566371681;5,49
2008;"2034";"Män";0;27;907;934;0,0289079229122056;2,89
2008;"2034";"Kvinnor";0;35;958;993;0,0352467270896274;3,52
2008;"2039";"Män";0;10;1384;1394;0,00717360114777618;0,72
2008;"2039";"Kvinnor";0;28;1248;1276;0,0219435736677116;2,19
2008;"2061";"Män";0;30;1878;1908;0,0157232704402516;1,57
2008;"2061";"Kvinnor";0;27;1277;1304;0,0207055214723926;2,07
2008;"2062";"Män";0;96;5145;5241;0,0183171150543789;1,83
2008;"2062";"Kvinnor";0;167;4417;4584;0,0364310645724258;3,64
2008;"2080";"Män";0;786;11707;12493;0,0629152325302169;6,29
2008;"2080";"Kvinnor";0;707;12342;13049;0,0541803969652847;5,42
2008;"2081";"Män";0;294;13623;13917;0,0211252425091615;2,11
2008;"2081";"Kvinnor";0;431;9894;10325;0,0417433414043584;4,17
2008;"2082";"Män";0;16;1377;1393;0,0114860014357502;1,15
2008;"2082";"Kvinnor";0;26;1553;1579;0,0164661177960735;1,65
2008;"2083";"Män";0;60;3348;3408;0,0176056338028169;1,76
2008;"2083";"Kvinnor";0;68;2847;2915;0,023327615780446;2,33
2008;"2084";"Män";0;92;5480;5572;0,0165111270638909;1,65
2008;"2084";"Kvinnor";0;132;4098;4230;0,0312056737588652;3,12
2008;"2085";"Män";0;68;5995;6063;0,0112155698499093;1,12
2008;"2085";"Kvinnor";0;116;5176;5292;0,0219198790627362;2,19
2008;"2101";"Män";0;11;847;858;0,0128205128205128;1,28
2008;"2101";"Kvinnor";0;16;829;845;0,0189349112426036;1,89
2008;"2104";"Män";0;108;2335;2443;0,0442079410560786;4,42
2008;"2104";"Kvinnor";0;159;1657;1816;0,0875550660792952;8,76
2008;"2121";"Män";0;25;2981;3006;0,0083166999334664;0,83
2008;"2121";"Kvinnor";0;46;2040;2086;0,0220517737296261;2,21
2008;"2132";"Män";0;17;1484;1501;0,011325782811459;1,13
2008;"2132";"Kvinnor";0;18;1162;1180;0,0152542372881356;1,53
2008;"2161";"Män";0;135;4014;4149;0,0325379609544469;3,25
2008;"2161";"Kvinnor";0;189;3250;3439;0,0549578365804013;5,5
2008;"2180";"Män";0;728;21243;21971;0,0331345865003869;3,31
2008;"2180";"Kvinnor";0;983;18725;19708;0,0498782220418104;4,99
2008;"2181";"Män";0;105;10167;10272;0,0102219626168224;1,02
2008;"2181";"Kvinnor";0;166;7281;7447;0,0222908553780046;2,23
2008;"2182";"Män";0;122;4895;5017;0,024317321108232;2,43
2008;"2182";"Kvinnor";0;164;4366;4530;0,0362030905077263;3,62
2008;"2183";"Män";0;160;5021;5181;0,0308820690986296;3,09
2008;"2183";"Kvinnor";0;184;4994;5178;0,0355349555813055;3,55
2008;"2184";"Män";0;256;8159;8415;0,0304218657159834;3,04
2008;"2184";"Kvinnor";0;339;7171;7510;0,0451398135818908;4,51
2008;"2260";"Män";0;68;2241;2309;0,0294499783456042;2,94
2008;"2260";"Kvinnor";0;83;1829;1912;0,0434100418410042;4,34
2008;"2262";"Män";0;36;2788;2824;0,0127478753541076;1,27
2008;"2262";"Kvinnor";0;43;1944;1987;0,0216406643180674;2,16
2008;"2280";"Män";0;273;4651;4924;0,055442729488221;5,54
2008;"2280";"Kvinnor";0;345;4500;4845;0,0712074303405573;7,12
2008;"2281";"Män";0;740;23471;24211;0,0305646193878815;3,06
2008;"2281";"Kvinnor";0;1040;20979;22019;0,047231936055225;4,72
2008;"2282";"Män";0;73;3946;4019;0,0181637223189848;1,82
2008;"2282";"Kvinnor";0;79;3230;3309;0,0238742822605017;2,39
2008;"2283";"Män";0;107;3869;3976;0,0269114688128773;2,69
2008;"2283";"Kvinnor";0;147;3872;4019;0,0365762627519283;3,66
2008;"2284";"Män";0;262;12967;13229;0,0198049739209313;1,98
2008;"2284";"Kvinnor";0;412;10285;10697;0,0385154716275591;3,85
2008;"2303";"Män";0;4;1219;1223;0,00327064595257563;0,33
2008;"2303";"Kvinnor";0;7;1016;1023;0,00684261974584555;0,68
2008;"2305";"Män";0;11;1041;1052;0,0104562737642586;1,05
2008;"2305";"Kvinnor";0;13;1060;1073;0,0121155638397018;1,21
2008;"2309";"Män";0;28;2235;2263;0,0123729562527618;1,24
2008;"2309";"Kvinnor";0;23;2030;2053;0,0112031173891866;1,12
2008;"2313";"Män";0;19;2398;2417;0,00786098469176665;0,79
2008;"2313";"Kvinnor";0;37;2124;2161;0,017121702915317;1,71
2008;"2321";"Män";0;89;2435;2524;0,0352614896988906;3,53
2008;"2321";"Kvinnor";0;97;2236;2333;0,0415773681954565;4,16
2008;"2326";"Män";0;19;1424;1443;0,0131670131670132;1,32
2008;"2326";"Kvinnor";0;7;1147;1154;0,00606585788561525;0,61
2008;"2361";"Män";0;37;2461;2498;0,0148118494795837;1,48
2008;"2361";"Kvinnor";0;45;2016;2061;0,0218340611353712;2,18
2008;"2380";"Män";0;676;14772;15448;0,0437597099948213;4,38
2008;"2380";"Kvinnor";0;698;14491;15189;0,0459543090394364;4,6
2008;"2401";"Män";0;5;1108;1113;0,00449236298292902;0,45
2008;"2401";"Kvinnor";0;14;935;949;0,0147523709167545;1,48
2008;"2403";"Män";0;0;296;296;0;0
2008;"2403";"Kvinnor";0;4;311;315;0,0126984126984127;1,27
2008;"2404";"Män";0;13;1181;1194;0,0108877721943049;1,09
2008;"2404";"Kvinnor";0;20;861;881;0,0227014755959137;2,27
2008;"2409";"Män";0;8;1111;1119;0,00714924039320822;0,71
2008;"2409";"Kvinnor";0;9;1038;1047;0,00859598853868195;0,86
2008;"2417";"Män";0;12;936;948;0,0126582278481013;1,27
2008;"2417";"Kvinnor";0;32;794;826;0,0387409200968523;3,87
2008;"2418";"Män";0;3;709;712;0,00421348314606742;0,42
2008;"2418";"Kvinnor";0;13;554;567;0,0229276895943563;2,29
2008;"2421";"Män";0;15;1289;1304;0,0115030674846626;1,15
2008;"2421";"Kvinnor";0;25;1102;1127;0,0221827861579414;2,22
2008;"2422";"Män";0;1;495;496;0,00201612903225806;0,2
2008;"2422";"Kvinnor";0;9;469;478;0,0188284518828452;1,88
2008;"2425";"Män";0;2;601;603;0,0033167495854063;0,33
2008;"2425";"Kvinnor";0;7;519;526;0,0133079847908745;1,33
2008;"2460";"Män";0;6;1332;1338;0,00448430493273543;0,45
2008;"2460";"Kvinnor";0;13;1112;1125;0,0115555555555556;1,16
2008;"2462";"Män";0;26;1170;1196;0,0217391304347826;2,17
2008;"2462";"Kvinnor";0;29;1149;1178;0,0246179966044143;2,46
2008;"2463";"Män";0;1;525;526;0,00190114068441065;0,19
2008;"2463";"Kvinnor";0;10;482;492;0,0203252032520325;2,03
2008;"2480";"Män";0;981;27976;28957;0,033877818834824;3,39
2008;"2480";"Kvinnor";0;1112;25445;26557;0,0418721994201152;4,19
2008;"2481";"Män";0;61;2907;2968;0,0205525606469003;2,06
2008;"2481";"Kvinnor";0;75;2548;2623;0,0285932138772398;2,86
2008;"2482";"Män";0;368;16772;17140;0,0214702450408401;2,15
2008;"2482";"Kvinnor";0;475;13873;14348;0,0331056593253415;3,31
2008;"2505";"Män";0;11;1323;1334;0,00824587706146927;0,82
2008;"2505";"Kvinnor";0;32;1191;1223;0,0261651676206051;2,62
2008;"2506";"Män";0;10;690;700;0,0142857142857143;1,43
2008;"2506";"Kvinnor";0;23;604;627;0,0366826156299841;3,67
2008;"2510";"Män";0;19;1080;1099;0,0172884440400364;1,73
2008;"2510";"Kvinnor";0;42;882;924;0,0454545454545455;4,55
2008;"2513";"Män";0;20;734;754;0,026525198938992;2,65
2008;"2513";"Kvinnor";0;39;629;668;0,0583832335329341;5,84
2008;"2514";"Män";0;30;3416;3446;0,00870574579222287;0,87
2008;"2514";"Kvinnor";0;45;3101;3146;0,0143038779402416;1,43
2008;"2518";"Män";0;10;779;789;0,0126742712294043;1,27
2008;"2518";"Kvinnor";0;25;725;750;0,0333333333333333;3,33
2008;"2521";"Män";0;32;1001;1033;0,0309777347531462;3,1
2008;"2521";"Kvinnor";0;20;918;938;0,0213219616204691;2,13
2008;"2523";"Män";0;65;4807;4872;0,0133415435139573;1,33
2008;"2523";"Kvinnor";0;77;3446;3523;0,0218563724098779;2,19
2008;"2560";"Män";0;6;1435;1441;0,00416377515614157;0,42
2008;"2560";"Kvinnor";0;22;1345;1367;0,0160936356986101;1,61
2008;"2580";"Män";0;767;19419;20186;0,0379966313286436;3,8
2008;"2580";"Kvinnor";0;980;15987;16967;0,0577591795838982;5,78
2008;"2581";"Män";0;188;8292;8480;0,0221698113207547;2,22
2008;"2581";"Kvinnor";0;282;7070;7352;0,0383569096844396;3,84
2008;"2582";"Män";0;39;4939;4978;0,00783447167537163;0,78
2008;"2582";"Kvinnor";0;62;4242;4304;0,0144052044609665;1,44
2008;"2583";"Män";0;24;1568;1592;0,0150753768844221;1,51
2008;"2583";"Kvinnor";0;44;1632;1676;0,0262529832935561;2,63
2008;"2584";"Män";0;156;6379;6535;0,0238714613618975;2,39
2008;"2584";"Kvinnor";0;284;4965;5249;0,0541055439131263;5,41
2008;"9999";"Män";0;1349;122907;124256;0,0108566185938707;1,09
2008;"9999";"Kvinnor";0;1609;151602;153211;0,0105018569162789;1,05
2009;"0114";"Män";0;174;6997;7171;0,024264398270813;2,43
2009;"0114";"Kvinnor";0;220;6134;6354;0,0346238589864652;3,46
2009;"0115";"Män";0;89;3341;3430;0,0259475218658892;2,59
2009;"0115";"Kvinnor";0;100;3365;3465;0,0288600288600289;2,89
2009;"0117";"Män";0;154;3970;4124;0,0373423860329777;3,73
2009;"0117";"Kvinnor";0;202;4290;4492;0,0449688334817453;4,5
2009;"0120";"Män";0;192;4577;4769;0,0402600125812539;4,03
2009;"0120";"Kvinnor";0;225;4379;4604;0,0488705473501303;4,89
2009;"0123";"Män";0;279;11276;11555;0,0241453916053656;2,41
2009;"0123";"Kvinnor";0;437;8548;8985;0,0486366165831942;4,86
2009;"0125";"Män";0;118;3454;3572;0,0330347144456887;3,3
2009;"0125";"Kvinnor";0;135;3163;3298;0,040933899332929;4,09
2009;"0126";"Män";0;397;18345;18742;0,0211823711450219;2,12
2009;"0126";"Kvinnor";0;469;19966;20435;0,0229508196721311;2,3
2009;"0127";"Män";0;409;10630;11039;0,0370504574689736;3,71
2009;"0127";"Kvinnor";0;431;8447;8878;0,0485469700382969;4,85
2009;"0128";"Män";0;31;1044;1075;0,0288372093023256;2,88
2009;"0128";"Kvinnor";0;37;1324;1361;0,0271858927259368;2,72
2009;"0136";"Män";0;210;11951;12161;0,0172683167502672;1,73
2009;"0136";"Kvinnor";0;326;9452;9778;0,0333401513601964;3,33
2009;"0138";"Män";0;184;4585;4769;0,038582512057035;3,86
2009;"0138";"Kvinnor";0;174;4264;4438;0,039206849932402;3,92
2009;"0139";"Män";0;61;4058;4119;0,0148094197620782;1,48
2009;"0139";"Kvinnor";0;51;2900;2951;0,0172822771941715;1,73
2009;"0140";"Män";0;9;1185;1194;0,00753768844221105;0,75
2009;"0140";"Kvinnor";0;12;876;888;0,0135135135135135;1,35
2009;"0160";"Män";0;441;10298;10739;0,0410652760964708;4,11
2009;"0160";"Kvinnor";0;692;9668;10360;0,0667953667953668;6,68
2009;"0162";"Män";0;163;5801;5964;0,0273306505700872;2,73
2009;"0162";"Kvinnor";0;253;9404;9657;0,026198612405509;2,62
2009;"0163";"Män";0;330;11630;11960;0,0275919732441472;2,76
2009;"0163";"Kvinnor";0;492;10079;10571;0,0465424273957052;4,65
2009;"0180";"Män";0;29176;256052;285228;0,102290097746364;10,23
2009;"0180";"Kvinnor";0;31926;232833;264759;0,12058513591606;12,06
2009;"0181";"Män";0;553;22921;23474;0,0235579790406407;2,36
2009;"0181";"Kvinnor";0;551;18444;18995;0,0290076335877863;2,9
2009;"0182";"Män";0;809;14678;15487;0,0522373603667592;5,22
2009;"0182";"Kvinnor";0;1228;13277;14505;0,0846604619096863;8,47
2009;"0183";"Män";0;281;9912;10193;0,0275679387815167;2,76
2009;"0183";"Kvinnor";0;248;7983;8231;0,0301299963552424;3,01
2009;"0184";"Män";0;1591;33347;34938;0,0455378098345641;4,55
2009;"0184";"Kvinnor";0;1613;32211;33824;0,047688032166509;4,77
2009;"0186";"Män";0;624;4835;5459;0,114306649569518;11,43
2009;"0186";"Kvinnor";0;515;5484;5999;0,0858476412735456;8,58
2009;"0187";"Män";0;56;1020;1076;0,0520446096654275;5,2
2009;"0187";"Kvinnor";0;65;1197;1262;0,0515055467511886;5,15
2009;"0188";"Män";0;237;8904;9141;0,0259271414506072;2,59
2009;"0188";"Kvinnor";0;292;8988;9280;0,0314655172413793;3,15
2009;"0191";"Män";0;194;13812;14006;0,0138512066257318;1,39
2009;"0191";"Kvinnor";0;275;10461;10736;0,0256147540983607;2,56
2009;"0192";"Män";0;64;2983;3047;0,0210042664916311;2,1
2009;"0192";"Kvinnor";0;103;3063;3166;0,0325331648768162;3,25
2009;"0305";"Män";0;45;2130;2175;0,0206896551724138;2,07
2009;"0305";"Kvinnor";0;75;2105;2180;0,0344036697247706;3,44
2009;"0319";"Män";0;33;1293;1326;0,0248868778280543;2,49
2009;"0319";"Kvinnor";0;31;971;1002;0,030938123752495;3,09
2009;"0330";"Män";0;28;1469;1497;0,0187040748162993;1,87
2009;"0330";"Kvinnor";0;43;1543;1586;0,0271122320302648;2,71
2009;"0331";"Män";0;124;1591;1715;0,0723032069970845;7,23
2009;"0331";"Kvinnor";0;162;1539;1701;0,0952380952380952;9,52
2009;"0360";"Män";0;46;3376;3422;0,0134424313267095;1,34
2009;"0360";"Kvinnor";0;58;2532;2590;0,0223938223938224;2,24
2009;"0380";"Män";0;1903;37651;39554;0,0481114425848208;4,81
2009;"0380";"Kvinnor";0;2245;41343;43588;0,0515050013765257;5,15
2009;"0381";"Män";0;113;6571;6684;0,0169060442848594;1,69
2009;"0381";"Kvinnor";0;181;6136;6317;0,0286528415387051;2,87
2009;"0382";"Män";0;31;4838;4869;0,00636681043335387;0,64
2009;"0382";"Kvinnor";0;48;3577;3625;0,0132413793103448;1,32
2009;"0428";"Män";0;62;1513;1575;0,0393650793650794;3,94
2009;"0428";"Kvinnor";0;112;1175;1287;0,087024087024087;8,7
2009;"0461";"Män";0;27;1016;1043;0,0258868648130393;2,59
2009;"0461";"Kvinnor";0;38;1308;1346;0,0282317979197623;2,82
2009;"0480";"Män";0;277;9521;9798;0,0282710757297408;2,83
2009;"0480";"Kvinnor";0;389;9847;10236;0,0380031262211801;3,8
2009;"0481";"Män";0;20;3023;3043;0,00657246138678935;0,66
2009;"0481";"Kvinnor";0;27;1565;1592;0,0169597989949749;1,7
2009;"0482";"Män";0;41;2752;2793;0,0146795560329395;1,47
2009;"0482";"Kvinnor";0;69;2428;2497;0,0276331597917501;2,76
2009;"0483";"Män";0;423;5996;6419;0,0658981149711793;6,59
2009;"0483";"Kvinnor";0;274;5452;5726;0,0478519035976249;4,79
2009;"0484";"Män";0;590;18261;18851;0,0312980743727123;3,13
2009;"0484";"Kvinnor";0;852;17306;18158;0,0469214671219297;4,69
2009;"0486";"Män";0;145;4804;4949;0,0292988482521722;2,93
2009;"0486";"Kvinnor";0;172;4555;4727;0,036386714618151;3,64
2009;"0488";"Män";0;92;1516;1608;0,0572139303482587;5,72
2009;"0488";"Kvinnor";0;120;1574;1694;0,0708382526564345;7,08
2009;"0509";"Män";0;46;826;872;0,0527522935779817;5,28
2009;"0509";"Kvinnor";0;21;740;761;0,0275952693823916;2,76
2009;"0512";"Män";0;4;629;633;0,00631911532385466;0,63
2009;"0512";"Kvinnor";0;10;446;456;0,0219298245614035;2,19
2009;"0513";"Män";0;33;1616;1649;0,0200121285627653;2
2009;"0513";"Kvinnor";0;29;1410;1439;0,0201528839471855;2,02
2009;"0560";"Män";0;3;1031;1034;0,00290135396518375;0,29
2009;"0560";"Kvinnor";0;8;584;592;0,0135135135135135;1,35
2009;"0561";"Män";0;48;1614;1662;0,0288808664259928;2,89
2009;"0561";"Kvinnor";0;43;1380;1423;0,0302178496134926;3,02
2009;"0562";"Män";0;35;5489;5524;0,00633598841419261;0,63
2009;"0562";"Kvinnor";0;50;3344;3394;0,0147318797878609;1,47
2009;"0563";"Män";0;13;1460;1473;0,0088255261371351;0,88
2009;"0563";"Kvinnor";0;21;1050;1071;0,0196078431372549;1,96
2009;"0580";"Män";0;943;34928;35871;0,02628864542388;2,63
2009;"0580";"Kvinnor";0;1149;31055;32204;0,0356787976648864;3,57
2009;"0581";"Män";0;986;27760;28746;0,034300424406874;3,43
2009;"0581";"Kvinnor";0;1160;24950;26110;0,0444274224435082;4,44
2009;"0582";"Män";0;47;1888;1935;0,0242894056847545;2,43
2009;"0582";"Kvinnor";0;71;1719;1790;0,0396648044692737;3,97
2009;"0583";"Män";0;210;7178;7388;0,0284244721169464;2,84
2009;"0583";"Kvinnor";0;212;6548;6760;0,0313609467455621;3,14
2009;"0584";"Män";0;58;1523;1581;0,036685641998735;3,67
2009;"0584";"Kvinnor";0;65;1248;1313;0,0495049504950495;4,95
2009;"0586";"Män";0;152;5544;5696;0,026685393258427;2,67
2009;"0586";"Kvinnor";0;162;3811;3973;0,0407752328215454;4,08
2009;"0604";"Män";0;16;1323;1339;0,011949215832711;1,19
2009;"0604";"Kvinnor";0;16;1002;1018;0,0157170923379175;1,57
2009;"0617";"Män";0;46;3080;3126;0,0147152911068458;1,47
2009;"0617";"Kvinnor";0;51;2119;2170;0,0235023041474654;2,35
2009;"0642";"Män";0;16;1178;1194;0,0134003350083752;1,34
2009;"0642";"Kvinnor";0;29;1020;1049;0,0276453765490944;2,76
2009;"0643";"Män";0;38;1714;1752;0,021689497716895;2,17
2009;"0643";"Kvinnor";0;23;1435;1458;0,0157750342935528;1,58
2009;"0662";"Män";0;105;7589;7694;0,0136469976605147;1,36
2009;"0662";"Kvinnor";0;166;5710;5876;0,0282505105513955;2,83
2009;"0665";"Män";0;27;2779;2806;0,00962223806129722;0,96
2009;"0665";"Kvinnor";0;34;2078;2112;0,0160984848484848;1,61
2009;"0680";"Män";0;1117;30350;31467;0,0354975053230368;3,55
2009;"0680";"Kvinnor";0;1249;26927;28176;0,0443285065303805;4,43
2009;"0682";"Män";0;255;6360;6615;0,0385487528344671;3,85
2009;"0682";"Kvinnor";0;213;4911;5124;0,0415690866510539;4,16
2009;"0683";"Män";0;231;7787;8018;0,0288101771015216;2,88
2009;"0683";"Kvinnor";0;292;7227;7519;0,0388349514563107;3,88
2009;"0684";"Män";0;27;2216;2243;0,012037449843959;1,2
2009;"0684";"Kvinnor";0;29;1599;1628;0,0178132678132678;1,78
2009;"0685";"Män";0;78;6262;6340;0,0123028391167192;1,23
2009;"0685";"Kvinnor";0;136;4771;4907;0,0277155084573059;2,77
2009;"0686";"Män";0;88;4091;4179;0,0210576692988753;2,11
2009;"0686";"Kvinnor";0;119;4047;4166;0,028564570331253;2,86
2009;"0687";"Män";0;121;3916;4037;0,0299727520435967;3
2009;"0687";"Kvinnor";0;134;3339;3473;0,0385833573279585;3,86
2009;"0760";"Män";0;22;2561;2583;0,00851722802942315;0,85
2009;"0760";"Kvinnor";0;17;1842;1859;0,00914470145239376;0,91
2009;"0761";"Män";0;46;1329;1375;0,0334545454545455;3,35
2009;"0761";"Kvinnor";0;89;1234;1323;0,0672713529856387;6,73
2009;"0763";"Män";0;41;2790;2831;0,0144825150123631;1,45
2009;"0763";"Kvinnor";0;50;2290;2340;0,0213675213675214;2,14
2009;"0764";"Män";0;48;3995;4043;0,0118723720009894;1,19
2009;"0764";"Kvinnor";0;49;2952;3001;0,016327890703099;1,63
2009;"0765";"Män";0;697;4235;4932;0,14132197891322;14,13
2009;"0765";"Kvinnor";0;767;3486;4253;0,180343287091465;18,03
2009;"0767";"Män";0;49;2703;2752;0,0178052325581395;1,78
2009;"0767";"Kvinnor";0;48;1850;1898;0,0252897787144362;2,53
2009;"0780";"Män";0;809;19356;20165;0,0401190181006695;4,01
2009;"0780";"Kvinnor";0;884;17731;18615;0,0474885844748858;4,75
2009;"0781";"Män";0;528;6426;6954;0,0759275237273512;7,59
2009;"0781";"Kvinnor";0;393;5324;5717;0,0687423473849921;6,87
2009;"0821";"Män";0;12;838;850;0,0141176470588235;1,41
2009;"0821";"Kvinnor";0;10;869;879;0,0113765642775882;1,14
2009;"0834";"Män";0;10;1477;1487;0,00672494956287828;0,67
2009;"0834";"Kvinnor";0;15;975;990;0,0151515151515152;1,52
2009;"0840";"Män";0;48;2043;2091;0,0229555236728838;2,3
2009;"0840";"Kvinnor";0;95;1846;1941;0,0489438433797012;4,89
2009;"0860";"Män";0;59;2594;2653;0,0222389747455711;2,22
2009;"0860";"Kvinnor";0;42;2198;2240;0,01875;1,88
2009;"0861";"Män";0;27;2301;2328;0,0115979381443299;1,16
2009;"0861";"Kvinnor";0;32;1808;1840;0,0173913043478261;1,74
2009;"0862";"Män";0;32;2626;2658;0,0120391271632807;1,2
2009;"0862";"Kvinnor";0;41;1623;1664;0,0246394230769231;2,46
2009;"0880";"Män";0;671;13916;14587;0,0459998628916158;4,6
2009;"0880";"Kvinnor";0;807;13678;14485;0,055712806351398;5,57
2009;"0881";"Män";0;42;4056;4098;0,0102489019033675;1,02
2009;"0881";"Kvinnor";0;74;3158;3232;0,0228960396039604;2,29
2009;"0882";"Män";0;74;7444;7518;0,00984304336259643;0,98
2009;"0882";"Kvinnor";0;164;5655;5819;0,0281835366901529;2,82
2009;"0883";"Män";0;132;6903;7035;0,0187633262260128;1,88
2009;"0883";"Kvinnor";0;176;6716;6892;0,0255368543238537;2,55
2009;"0884";"Män";0;274;3501;3775;0,0725827814569536;7,26
2009;"0884";"Kvinnor";0;271;2751;3022;0,0896757114493713;8,97
2009;"0885";"Män";0;79;1783;1862;0,0424274973147154;4,24
2009;"0885";"Kvinnor";0;81;1591;1672;0,048444976076555;4,84
2009;"0980";"Män";0;443;11511;11954;0,0370587251129329;3,71
2009;"0980";"Kvinnor";0;538;10980;11518;0,0467094981767668;4,67
2009;"1060";"Män";0;41;3635;3676;0,0111534276387378;1,12
2009;"1060";"Kvinnor";0;53;2161;2214;0,0239385727190605;2,39
2009;"1080";"Män";0;461;14280;14741;0,0312733193134794;3,13
2009;"1080";"Kvinnor";0;491;12645;13136;0,037378197320341;3,74
2009;"1081";"Män";0;92;5794;5886;0,0156303092082909;1,56
2009;"1081";"Kvinnor";0;149;4287;4436;0,0335888187556357;3,36
2009;"1082";"Män";0;167;5436;5603;0,0298054613599857;2,98
2009;"1082";"Kvinnor";0;247;5406;5653;0,04369361401026;4,37
2009;"1083";"Män";0;90;2793;2883;0,0312174817898023;3,12
2009;"1083";"Kvinnor";0;89;2336;2425;0,0367010309278351;3,67
2009;"1214";"Män";0;18;1565;1583;0,0113708149084018;1,14
2009;"1214";"Kvinnor";0;27;1525;1552;0,0173969072164948;1,74
2009;"1230";"Män";0;70;2757;2827;0,0247612309869119;2,48
2009;"1230";"Kvinnor";0;57;2162;2219;0,0256872465074358;2,57
2009;"1231";"Män";0;123;4326;4449;0,0276466621712744;2,76
2009;"1231";"Kvinnor";0;228;2701;2929;0,0778422669853192;7,78
2009;"1233";"Män";0;270;3041;3311;0,0815463606161281;8,15
2009;"1233";"Kvinnor";0;213;3487;3700;0,0575675675675676;5,76
2009;"1256";"Män";0;34;2159;2193;0,0155038759689922;1,55
2009;"1256";"Kvinnor";0;54;1697;1751;0,0308395202741291;3,08
2009;"1257";"Män";0;19;1818;1837;0,0103429504627109;1,03
2009;"1257";"Kvinnor";0;21;1600;1621;0,012954966070327;1,3
2009;"1260";"Män";0;23;2450;2473;0,00930044480388192;0,93
2009;"1260";"Kvinnor";0;30;1887;1917;0,0156494522691706;1,56
2009;"1261";"Män";0;98;2939;3037;0,0322686862034903;3,23
2009;"1261";"Kvinnor";0;218;2880;3098;0,0703679793415107;7,04
2009;"1262";"Män";0;66;1989;2055;0,0321167883211679;3,21
2009;"1262";"Kvinnor";0;77;2267;2344;0,0328498293515358;3,28
2009;"1263";"Män";0;82;3215;3297;0,0248710949347892;2,49
2009;"1263";"Kvinnor";0;116;2463;2579;0,0449786739046142;4,5
2009;"1264";"Män";0;64;1690;1754;0,0364880273660205;3,65
2009;"1264";"Kvinnor";0;80;1652;1732;0,046189376443418;4,62
2009;"1265";"Män";0;53;2849;2902;0,018263266712612;1,83
2009;"1265";"Kvinnor";0;89;2362;2451;0,036311709506324;3,63
2009;"1266";"Män";0;37;2152;2189;0,0169026952946551;1,69
2009;"1266";"Kvinnor";0;66;2003;2069;0,0318994683421943;3,19
2009;"1267";"Män";0;39;1834;1873;0,0208222103577149;2,08
2009;"1267";"Kvinnor";0;61;2212;2273;0,0268367795864496;2,68
2009;"1270";"Män";0;57;2310;2367;0,0240811153358682;2,41
2009;"1270";"Kvinnor";0;77;1792;1869;0,0411985018726592;4,12
2009;"1272";"Män";0;29;2599;2628;0,0110350076103501;1,1
2009;"1272";"Kvinnor";0;35;1823;1858;0,0188374596340151;1,88
2009;"1273";"Män";0;30;2084;2114;0,0141911069063387;1,42
2009;"1273";"Kvinnor";0;47;1688;1735;0,0270893371757925;2,71
2009;"1275";"Män";0;9;1720;1729;0,00520532099479468;0,52
2009;"1275";"Kvinnor";0;11;1158;1169;0,00940975192472198;0,94
2009;"1276";"Män";0;89;2849;2938;0,0302927161334241;3,03
2009;"1276";"Kvinnor";0;74;2349;2423;0,0305406520841932;3,05
2009;"1277";"Män";0;56;2706;2762;0,0202751629254164;2,03
2009;"1277";"Kvinnor";0;127;2368;2495;0,0509018036072144;5,09
2009;"1278";"Män";0;102;3062;3164;0,0322376738305942;3,22
2009;"1278";"Kvinnor";0;172;2548;2720;0,0632352941176471;6,32
2009;"1280";"Män";0;4874;70186;75060;0,0649347188915534;6,49
2009;"1280";"Kvinnor";0;5167;62207;67374;0,0766913052512839;7,67
2009;"1281";"Män";0;2007;28961;30968;0,0648088349263756;6,48
2009;"1281";"Kvinnor";0;1647;28857;30504;0,0539929189614477;5,4
2009;"1282";"Män";0;317;6801;7118;0,0445349817364428;4,45
2009;"1282";"Kvinnor";0;295;5785;6080;0,0485197368421053;4,85
2009;"1283";"Män";0;1702;28820;30522;0,0557630561562152;5,58
2009;"1283";"Kvinnor";0;2018;26246;28264;0,0713982451174639;7,14
2009;"1284";"Män";0;92;3294;3386;0,0271707028942705;2,72
2009;"1284";"Kvinnor";0;143;3256;3399;0,0420711974110032;4,21
2009;"1285";"Män";0;150;5009;5159;0,0290754022097306;2,91
2009;"1285";"Kvinnor";0;165;4479;4644;0,0355297157622739;3,55
2009;"1286";"Män";0;202;5083;5285;0,0382213812677389;3,82
2009;"1286";"Kvinnor";0;258;5422;5680;0,0454225352112676;4,54
2009;"1287";"Män";0;103;6307;6410;0,0160686427457098;1,61
2009;"1287";"Kvinnor";0;231;5928;6159;0,037506088650755;3,75
2009;"1290";"Män";0;478;15539;16017;0,0298432915027783;2,98
2009;"1290";"Kvinnor";0;647;15987;16634;0,0388962366237826;3,89
2009;"1291";"Män";0;112;2973;3085;0,0363047001620746;3,63
2009;"1291";"Kvinnor";0;159;3018;3177;0,0500472143531634;5
2009;"1292";"Män";0;196;6823;7019;0,0279242057273116;2,79
2009;"1292";"Kvinnor";0;325;7547;7872;0,0412855691056911;4,13
2009;"1293";"Män";0;296;9703;9999;0,0296029602960296;2,96
2009;"1293";"Kvinnor";0;274;8492;8766;0,0312571298197582;3,13
2009;"1315";"Män";0;33;2430;2463;0,0133982947624848;1,34
2009;"1315";"Kvinnor";0;45;1857;1902;0,0236593059936909;2,37
2009;"1380";"Män";0;835;19885;20720;0,0402992277992278;4,03
2009;"1380";"Kvinnor";0;1085;18787;19872;0,0545994363929147;5,46
2009;"1381";"Män";0;182;3781;3963;0,04592480444108;4,59
2009;"1381";"Kvinnor";0;152;3245;3397;0,0447453635560789;4,47
2009;"1382";"Män";0;501;8479;8980;0,0557906458797327;5,58
2009;"1382";"Kvinnor";0;1099;6675;7774;0,141368664780036;14,14
2009;"1383";"Män";0;464;12479;12943;0,0358494939349455;3,58
2009;"1383";"Kvinnor";0;665;10998;11663;0,0570179199176884;5,7
2009;"1384";"Män";0;604;8734;9338;0,0646819447419148;6,47
2009;"1384";"Kvinnor";0;823;9792;10615;0,0775317946302402;7,75
2009;"1401";"Män";0;315;6016;6331;0,0497551729584584;4,98
2009;"1401";"Kvinnor";0;253;5432;5685;0,0445030782761653;4,45
2009;"1402";"Män";0;232;4960;5192;0,0446841294298921;4,47
2009;"1402";"Kvinnor";0;349;4343;4692;0,074381926683717;7,44
2009;"1407";"Män";0;21;1353;1374;0,0152838427947598;1,53
2009;"1407";"Kvinnor";0;38;1389;1427;0,0266292922214436;2,66
2009;"1415";"Män";0;75;6083;6158;0,012179278986684;1,22
2009;"1415";"Kvinnor";0;214;4011;4225;0,0506508875739645;5,07
2009;"1419";"Män";0;35;1862;1897;0,018450184501845;1,85
2009;"1419";"Kvinnor";0;62;2059;2121;0,0292314945780292;2,92
2009;"1421";"Män";0;20;2526;2546;0,00785545954438335;0,79
2009;"1421";"Kvinnor";0;36;1980;2016;0,0178571428571429;1,79
2009;"1427";"Män";0;27;1873;1900;0,0142105263157895;1,42
2009;"1427";"Kvinnor";0;38;1732;1770;0,0214689265536723;2,15
2009;"1430";"Män";0;73;1676;1749;0,0417381360777587;4,17
2009;"1430";"Kvinnor";0;53;1480;1533;0,0345727332028702;3,46
2009;"1435";"Män";0;82;2278;2360;0,0347457627118644;3,47
2009;"1435";"Kvinnor";0;163;1747;1910;0,0853403141361257;8,53
2009;"1438";"Män";0;17;998;1015;0,0167487684729064;1,67
2009;"1438";"Kvinnor";0;15;761;776;0,0193298969072165;1,93
2009;"1439";"Män";0;7;891;898;0,00779510022271715;0,78
2009;"1439";"Kvinnor";0;10;894;904;0,0110619469026549;1,11
2009;"1440";"Män";0;53;2876;2929;0,0180949129395698;1,81
2009;"1440";"Kvinnor";0;56;2969;3025;0,0185123966942149;1,85
2009;"1441";"Män";0;158;3503;3661;0,0431576072111445;4,32
2009;"1441";"Kvinnor";0;190;4237;4427;0,0429184549356223;4,29
2009;"1442";"Män";0;45;2415;2460;0,0182926829268293;1,83
2009;"1442";"Kvinnor";0;40;1717;1757;0,022766078542971;2,28
2009;"1443";"Män";0;32;1051;1083;0,0295475530932595;2,95
2009;"1443";"Kvinnor";0;30;872;902;0,0332594235033259;3,33
2009;"1444";"Män";0;3;688;691;0,00434153400868307;0,43
2009;"1444";"Kvinnor";0;18;716;734;0,0245231607629428;2,45
2009;"1445";"Män";0;48;943;991;0,0484359233097881;4,84
2009;"1445";"Kvinnor";0;53;757;810;0,0654320987654321;6,54
2009;"1446";"Män";0;21;1465;1486;0,0141318977119785;1,41
2009;"1446";"Kvinnor";0;23;1141;1164;0,0197594501718213;1,98
2009;"1447";"Män";0;4;1013;1017;0,00393313667649951;0,39
2009;"1447";"Kvinnor";0;6;708;714;0,00840336134453781;0,84
2009;"1452";"Män";0;98;3202;3300;0,0296969696969697;2,97
2009;"1452";"Kvinnor";0;132;1980;2112;0,0625;6,25
2009;"1460";"Män";0;43;1849;1892;0,0227272727272727;2,27
2009;"1460";"Kvinnor";0;83;1661;1744;0,0475917431192661;4,76
2009;"1461";"Män";0;14;1439;1453;0,00963523743977977;0,96
2009;"1461";"Kvinnor";0;45;1310;1355;0,033210332103321;3,32
2009;"1462";"Män";0;16;1808;1824;0,0087719298245614;0,88
2009;"1462";"Kvinnor";0;21;1805;1826;0,011500547645126;1,15
2009;"1463";"Män";0;220;4998;5218;0,0421617477960905;4,22
2009;"1463";"Kvinnor";0;291;4956;5247;0,0554602630074328;5,55
2009;"1465";"Män";0;246;1639;1885;0,130503978779841;13,05
2009;"1465";"Kvinnor";0;151;1603;1754;0,0860889395667047;8,61
2009;"1466";"Män";0;14;2077;2091;0,00669536107125777;0,67
2009;"1466";"Kvinnor";0;17;1469;1486;0,0114401076716016;1,14
2009;"1470";"Män";0;90;4404;4494;0,0200267022696929;2
2009;"1470";"Kvinnor";0;78;2669;2747;0,028394612304332;2,84
2009;"1471";"Män";0;41;3267;3308;0,0123941958887545;1,24
2009;"1471";"Kvinnor";0;39;2284;2323;0,0167886353852777;1,68
2009;"1472";"Män";0;32;1826;1858;0,0172228202368138;1,72
2009;"1472";"Kvinnor";0;28;1629;1657;0,0168980084490042;1,69
2009;"1473";"Män";0;17;1615;1632;0,0104166666666667;1,04
2009;"1473";"Kvinnor";0;28;1260;1288;0,0217391304347826;2,17
2009;"1480";"Män";0;7347;144348;151695;0,0484327103727875;4,84
2009;"1480";"Kvinnor";0;8692;125888;134580;0,0645861197800565;6,46
2009;"1481";"Män";0;654;15610;16264;0,0402115100836203;4,02
2009;"1481";"Kvinnor";0;882;14448;15330;0,0575342465753425;5,75
2009;"1482";"Män";0;216;6762;6978;0,0309544282029235;3,1
2009;"1482";"Kvinnor";0;215;6586;6801;0,0316129980885164;3,16
2009;"1484";"Män";0;55;2968;3023;0,0181938471716838;1,82
2009;"1484";"Kvinnor";0;76;2331;2407;0,0315745741587038;3,16
2009;"1485";"Män";0;416;10087;10503;0,0396077311244406;3,96
2009;"1485";"Kvinnor";0;626;10624;11250;0,0556444444444444;5,56
2009;"1486";"Män";0;122;2580;2702;0,0451517394522576;4,52
2009;"1486";"Kvinnor";0;284;2661;2945;0,0964346349745331;9,64
2009;"1487";"Män";0;135;5657;5792;0,0233080110497238;2,33
2009;"1487";"Kvinnor";0;154;6047;6201;0,0248347040799871;2,48
2009;"1488";"Män";0;222;14843;15065;0,0147361433786923;1,47
2009;"1488";"Kvinnor";0;447;11853;12300;0,0363414634146341;3,63
2009;"1489";"Män";0;193;5760;5953;0,0324206282546615;3,24
2009;"1489";"Kvinnor";0;277;6471;6748;0,0410491997628927;4,1
2009;"1490";"Män";0;2043;21480;23523;0,086851166942992;8,69
2009;"1490";"Kvinnor";0;2481;21138;23619;0,105042550489013;10,5
2009;"1491";"Män";0;277;3922;4199;0,0659680876399143;6,6
2009;"1491";"Kvinnor";0;379;3249;3628;0,104465270121279;10,45
2009;"1492";"Män";0;52;2124;2176;0,0238970588235294;2,39
2009;"1492";"Kvinnor";0;86;1969;2055;0,0418491484184915;4,18
2009;"1493";"Män";0;69;4379;4448;0,0155125899280576;1,55
2009;"1493";"Kvinnor";0;108;4137;4245;0,0254416961130742;2,54
2009;"1494";"Män";0;206;8383;8589;0,0239841657934567;2,4
2009;"1494";"Kvinnor";0;290;7218;7508;0,0386254661694193;3,86
2009;"1495";"Män";0;119;4070;4189;0,0284077345428503;2,84
2009;"1495";"Kvinnor";0;171;3729;3900;0,0438461538461538;4,38
2009;"1496";"Män";0;290;14394;14684;0,0197493870879869;1,97
2009;"1496";"Kvinnor";0;484;12413;12897;0,0375281073117779;3,75
2009;"1497";"Män";0;29;1216;1245;0,0232931726907631;2,33
2009;"1497";"Kvinnor";0;42;1279;1321;0,0317940953822861;3,18
2009;"1498";"Män";0;40;2282;2322;0,0172265288544358;1,72
2009;"1498";"Kvinnor";0;53;1791;1844;0,0287418655097614;2,87
2009;"1499";"Män";0;189;6061;6250;0,03024;3,02
2009;"1499";"Kvinnor";0;183;5413;5596;0,0327019299499643;3,27
2009;"1715";"Män";0;24;1509;1533;0,0156555772994129;1,57
2009;"1715";"Kvinnor";0;32;1262;1294;0,0247295208655332;2,47
2009;"1730";"Män";0;13;1352;1365;0,00952380952380952;0,95
2009;"1730";"Kvinnor";0;113;1484;1597;0,0707576706324358;7,08
2009;"1737";"Män";0;36;2263;2299;0,0156589821661592;1,57
2009;"1737";"Kvinnor";0;49;2217;2266;0,0216240070609003;2,16
2009;"1760";"Män";0;2;632;634;0,00315457413249211;0,32
2009;"1760";"Kvinnor";0;6;452;458;0,0131004366812227;1,31
2009;"1761";"Män";0;15;1971;1986;0,00755287009063444;0,76
2009;"1761";"Kvinnor";0;28;1627;1655;0,0169184290030211;1,69
2009;"1762";"Män";0;23;705;728;0,0315934065934066;3,16
2009;"1762";"Kvinnor";0;27;559;586;0,0460750853242321;4,61
2009;"1763";"Män";0;20;1054;1074;0,0186219739292365;1,86
2009;"1763";"Kvinnor";0;25;1211;1236;0,0202265372168285;2,02
2009;"1764";"Män";0;8;1703;1711;0,00467562828755114;0,47
2009;"1764";"Kvinnor";0;10;1240;1250;0,008;0,8
2009;"1765";"Män";0;41;1696;1737;0,0236039147956246;2,36
2009;"1765";"Kvinnor";0;105;1646;1751;0,0599657338663621;6
2009;"1766";"Män";0;147;2427;2574;0,0571095571095571;5,71
2009;"1766";"Kvinnor";0;120;2026;2146;0,0559179869524697;5,59
2009;"1780";"Män";0;1012;21317;22329;0,0453222267007031;4,53
2009;"1780";"Kvinnor";0;1156;20090;21246;0,0544102419278923;5,44
2009;"1781";"Män";0;64;4588;4652;0,0137575236457438;1,38
2009;"1781";"Kvinnor";0;94;3356;3450;0,0272463768115942;2,72
2009;"1782";"Män";0;24;1785;1809;0,0132669983416252;1,33
2009;"1782";"Kvinnor";0;22;1675;1697;0,0129640542133176;1,3
2009;"1783";"Män";0;17;2335;2352;0,00722789115646259;0,72
2009;"1783";"Kvinnor";0;39;1774;1813;0,0215113072255929;2,15
2009;"1784";"Män";0;90;5015;5105;0,0176297747306562;1,76
2009;"1784";"Kvinnor";0;138;4487;4625;0,0298378378378378;2,98
2009;"1785";"Män";0;46;3128;3174;0,0144927536231884;1,45
2009;"1785";"Kvinnor";0;59;2168;2227;0,0264930399640772;2,65
2009;"1814";"Män";0;16;777;793;0,0201765447667087;2,02
2009;"1814";"Kvinnor";0;8;757;765;0,0104575163398693;1,05
2009;"1860";"Män";0;22;1452;1474;0,0149253731343284;1,49
2009;"1860";"Kvinnor";0;14;909;923;0,0151679306608884;1,52
2009;"1861";"Män";0;76;3829;3905;0,0194622279129321;1,95
2009;"1861";"Kvinnor";0;59;2670;2729;0,0216196408941004;2,16
2009;"1862";"Män";0;8;1537;1545;0,00517799352750809;0,52
2009;"1862";"Kvinnor";0;21;1142;1163;0,0180567497850387;1,81
2009;"1863";"Män";0;20;1369;1389;0,0143988480921526;1,44
2009;"1863";"Kvinnor";0;33;1039;1072;0,0307835820895522;3,08
2009;"1864";"Män";0;9;743;752;0,011968085106383;1,2
2009;"1864";"Kvinnor";0;14;685;699;0,0200286123032904;2
2009;"1880";"Män";0;1328;30719;32047;0,0414391362686055;4,14
2009;"1880";"Kvinnor";0;1565;28994;30559;0,0512124087830099;5,12
2009;"1881";"Män";0;107;3254;3361;0,0318357631657245;3,18
2009;"1881";"Kvinnor";0;84;2883;2967;0,0283114256825076;2,83
2009;"1882";"Män";0;31;1818;1849;0,0167658193618172;1,68
2009;"1882";"Kvinnor";0;49;1468;1517;0,032300593276203;3,23
2009;"1883";"Män";0;154;7050;7204;0,021377012770683;2,14
2009;"1883";"Kvinnor";0;207;6159;6366;0,0325164938737041;3,25
2009;"1884";"Män";0;33;1469;1502;0,0219707057256991;2,2
2009;"1884";"Kvinnor";0;55;1350;1405;0,0391459074733096;3,91
2009;"1885";"Män";0;101;4486;4587;0,0220187486374537;2,2
2009;"1885";"Kvinnor";0;88;4179;4267;0,0206233887977502;2,06
2009;"1904";"Män";0;7;661;668;0,0104790419161677;1,05
2009;"1904";"Kvinnor";0;7;622;629;0,0111287758346582;1,11
2009;"1907";"Män";0;9;1598;1607;0,00560049782202863;0,56
2009;"1907";"Kvinnor";0;24;1209;1233;0,0194647201946472;1,95
2009;"1960";"Män";0;9;1312;1321;0,00681302043906132;0,68
2009;"1960";"Kvinnor";0;13;1181;1194;0,0108877721943049;1,09
2009;"1961";"Män";0;33;2509;2542;0,0129819040125885;1,3
2009;"1961";"Kvinnor";0;27;2322;2349;0,0114942528735632;1,15
2009;"1962";"Män";0;18;767;785;0,0229299363057325;2,29
2009;"1962";"Kvinnor";0;17;639;656;0,0259146341463415;2,59
2009;"1980";"Män";0;1100;30586;31686;0,0347156472890235;3,47
2009;"1980";"Kvinnor";0;1403;26901;28304;0,0495689655172414;4,96
2009;"1981";"Män";0;92;3650;3742;0,0245857830037413;2,46
2009;"1981";"Kvinnor";0;154;3414;3568;0,0431614349775785;4,32
2009;"1982";"Män";0;28;3246;3274;0,00855222968845449;0,86
2009;"1982";"Kvinnor";0;71;2523;2594;0,0273708558211257;2,74
2009;"1983";"Män";0;70;5617;5687;0,0123087743977493;1,23
2009;"1983";"Kvinnor";0;138;4440;4578;0,0301441677588467;3,01
2009;"1984";"Män";0;29;2623;2652;0,0109351432880845;1,09
2009;"1984";"Kvinnor";0;61;2122;2183;0,0279431974347229;2,79
2009;"2021";"Män";0;15;1213;1228;0,012214983713355;1,22
2009;"2021";"Kvinnor";0;21;1074;1095;0,0191780821917808;1,92
2009;"2023";"Män";0;69;2731;2800;0,0246428571428571;2,46
2009;"2023";"Kvinnor";0;77;2420;2497;0,0308370044052863;3,08
2009;"2026";"Män";0;14;1170;1184;0,0118243243243243;1,18
2009;"2026";"Kvinnor";0;13;1207;1220;0,010655737704918;1,07
2009;"2029";"Män";0;89;3029;3118;0,0285439384220654;2,85
2009;"2029";"Kvinnor";0;103;2603;2706;0,0380635624538064;3,81
2009;"2031";"Män";0;56;1623;1679;0,0333531864204884;3,34
2009;"2031";"Kvinnor";0;89;1681;1770;0,0502824858757062;5,03
2009;"2034";"Män";0;28;888;916;0,0305676855895196;3,06
2009;"2034";"Kvinnor";0;21;887;908;0,0231277533039648;2,31
2009;"2039";"Män";0;22;1398;1420;0,0154929577464789;1,55
2009;"2039";"Kvinnor";0;24;1233;1257;0,0190930787589499;1,91
2009;"2061";"Män";0;35;1676;1711;0,0204558737580362;2,05
2009;"2061";"Kvinnor";0;24;1186;1210;0,0198347107438017;1,98
2009;"2062";"Män";0;101;4978;5079;0,0198858042921835;1,99
2009;"2062";"Kvinnor";0;144;4276;4420;0,032579185520362;3,26
2009;"2080";"Män";0;763;10864;11627;0,0656231186032511;6,56
2009;"2080";"Kvinnor";0;698;11952;12650;0,0551778656126482;5,52
2009;"2081";"Män";0;210;13252;13462;0,0155994651611945;1,56
2009;"2081";"Kvinnor";0;403;9612;10015;0,0402396405391912;4,02
2009;"2082";"Män";0;16;1415;1431;0,0111809923130678;1,12
2009;"2082";"Kvinnor";0;28;1537;1565;0,0178913738019169;1,79
2009;"2083";"Män";0;77;3123;3200;0,0240625;2,41
2009;"2083";"Kvinnor";0;70;2595;2665;0,026266416510319;2,63
2009;"2084";"Män";0;89;5116;5205;0,0170989433237272;1,71
2009;"2084";"Kvinnor";0;135;3830;3965;0,0340479192938209;3,4
2009;"2085";"Män";0;75;6168;6243;0,012013455069678;1,2
2009;"2085";"Kvinnor";0;108;5092;5200;0,0207692307692308;2,08
2009;"2101";"Män";0;10;833;843;0,0118623962040332;1,19
2009;"2101";"Kvinnor";0;16;832;848;0,0188679245283019;1,89
2009;"2104";"Män";0;99;2067;2166;0,0457063711911357;4,57
2009;"2104";"Kvinnor";0;128;1478;1606;0,0797011207970112;7,97
2009;"2121";"Män";0;18;2718;2736;0,00657894736842105;0,66
2009;"2121";"Kvinnor";0;42;1860;1902;0,0220820189274448;2,21
2009;"2132";"Män";0;14;1441;1455;0,00962199312714777;0,96
2009;"2132";"Kvinnor";0;16;1114;1130;0,0141592920353982;1,42
2009;"2161";"Män";0;132;3809;3941;0,0334940370464349;3,35
2009;"2161";"Kvinnor";0;177;3173;3350;0,0528358208955224;5,28
2009;"2180";"Män";0;715;20615;21330;0,0335208626347867;3,35
2009;"2180";"Kvinnor";0;959;18597;19556;0,0490386582123134;4,9
2009;"2181";"Män";0;93;9275;9368;0,00992741246797609;0,99
2009;"2181";"Kvinnor";0;130;6658;6788;0,0191514437242192;1,92
2009;"2182";"Män";0;114;4604;4718;0,0241627808393387;2,42
2009;"2182";"Kvinnor";0;158;3847;4005;0,0394506866416979;3,95
2009;"2183";"Män";0;157;4853;5010;0,0313373253493014;3,13
2009;"2183";"Kvinnor";0;182;4835;5017;0,0362766593581822;3,63
2009;"2184";"Män";0;209;7693;7902;0,0264490002531005;2,64
2009;"2184";"Kvinnor";0;306;6958;7264;0,042125550660793;4,21
2009;"2260";"Män";0;58;2149;2207;0,0262800181241504;2,63
2009;"2260";"Kvinnor";0;74;1751;1825;0,0405479452054795;4,05
2009;"2262";"Män";0;33;2591;2624;0,0125762195121951;1,26
2009;"2262";"Kvinnor";0;35;1861;1896;0,0184599156118143;1,85
2009;"2280";"Män";0;228;4345;4573;0,0498578613601574;4,99
2009;"2280";"Kvinnor";0;314;4519;4833;0,0649699979308918;6,5
2009;"2281";"Män";0;709;22647;23356;0,0303562253810584;3,04
2009;"2281";"Kvinnor";0;966;20512;21478;0,0449762547723252;4,5
2009;"2282";"Män";0;53;3834;3887;0,0136351942372009;1,36
2009;"2282";"Kvinnor";0;70;3059;3129;0,0223713646532438;2,24
2009;"2283";"Män";0;96;3716;3812;0,0251836306400839;2,52
2009;"2283";"Kvinnor";0;122;3640;3762;0,0324295587453482;3,24
2009;"2284";"Män";0;237;12604;12841;0,0184565065026088;1,85
2009;"2284";"Kvinnor";0;384;10278;10662;0,036015756893641;3,6
2009;"2303";"Män";0;4;1141;1145;0,00349344978165939;0,35
2009;"2303";"Kvinnor";0;8;936;944;0,00847457627118644;0,85
2009;"2305";"Män";0;12;1012;1024;0,01171875;1,17
2009;"2305";"Kvinnor";0;12;1022;1034;0,011605415860735;1,16
2009;"2309";"Män";0;31;2184;2215;0,0139954853273138;1,4
2009;"2309";"Kvinnor";0;23;1989;2012;0,0114314115308151;1,14
2009;"2313";"Män";0;17;2329;2346;0,0072463768115942;0,72
2009;"2313";"Kvinnor";0;42;2050;2092;0,0200764818355641;2,01
2009;"2321";"Män";0;95;2373;2468;0,0384927066450567;3,85
2009;"2321";"Kvinnor";0;91;2209;2300;0,0395652173913043;3,96
2009;"2326";"Män";0;16;1306;1322;0,0121028744326778;1,21
2009;"2326";"Kvinnor";0;5;1081;1086;0,00460405156537753;0,46
2009;"2361";"Män";0;25;2441;2466;0,0101378751013788;1,01
2009;"2361";"Kvinnor";0;33;1989;2022;0,0163204747774481;1,63
2009;"2380";"Män";0;642;14273;14915;0,0430439155212873;4,3
2009;"2380";"Kvinnor";0;641;14374;15015;0,0426906426906427;4,27
2009;"2401";"Män";0;3;1034;1037;0,00289296046287367;0,29
2009;"2401";"Kvinnor";0;14;914;928;0,0150862068965517;1,51
2009;"2403";"Män";0;1;294;295;0,00338983050847458;0,34
2009;"2403";"Kvinnor";0;5;304;309;0,0161812297734628;1,62
2009;"2404";"Män";0;13;1056;1069;0,0121608980355472;1,22
2009;"2404";"Kvinnor";0;18;785;803;0,0224159402241594;2,24
2009;"2409";"Män";0;9;1032;1041;0,00864553314121038;0,86
2009;"2409";"Kvinnor";0;6;990;996;0,00602409638554217;0,6
2009;"2417";"Män";0;13;836;849;0,0153121319199058;1,53
2009;"2417";"Kvinnor";0;32;746;778;0,0411311053984576;4,11
2009;"2418";"Män";0;2;605;607;0,00329489291598023;0,33
2009;"2418";"Kvinnor";0;14;534;548;0,0255474452554745;2,55
2009;"2421";"Män";0;18;1193;1211;0,0148637489677952;1,49
2009;"2421";"Kvinnor";0;24;1099;1123;0,0213713268032057;2,14
2009;"2422";"Män";0;1;470;471;0,00212314225053079;0,21
2009;"2422";"Kvinnor";0;5;442;447;0,0111856823266219;1,12
2009;"2425";"Män";0;3;528;531;0,00564971751412429;0,56
2009;"2425";"Kvinnor";0;8;485;493;0,0162271805273834;1,62
2009;"2460";"Män";0;6;1244;1250;0,0048;0,48
2009;"2460";"Kvinnor";0;11;1047;1058;0,0103969754253308;1,04
2009;"2462";"Män";0;25;1142;1167;0,0214224507283633;2,14
2009;"2462";"Kvinnor";0;25;1103;1128;0,0221631205673759;2,22
2009;"2463";"Män";0;1;481;482;0,0020746887966805;0,21
2009;"2463";"Kvinnor";0;9;447;456;0,0197368421052632;1,97
2009;"2480";"Män";0;981;26876;27857;0,0352155652080267;3,52
2009;"2480";"Kvinnor";0;1087;25030;26117;0,0416204005054179;4,16
2009;"2481";"Män";0;53;2890;2943;0,018008834522596;1,8
2009;"2481";"Kvinnor";0;69;2487;2556;0,0269953051643192;2,7
2009;"2482";"Män";0;368;15806;16174;0,0227525658464202;2,28
2009;"2482";"Kvinnor";0;489;12881;13370;0,0365744203440539;3,66
2009;"2505";"Män";0;13;1297;1310;0,0099236641221374;0,99
2009;"2505";"Kvinnor";0;29;1158;1187;0,0244313395113732;2,44
2009;"2506";"Män";0;6;726;732;0,00819672131147541;0,82
2009;"2506";"Kvinnor";0;10;593;603;0,0165837479270315;1,66
2009;"2510";"Män";0;21;1073;1094;0,0191956124314442;1,92
2009;"2510";"Kvinnor";0;40;860;900;0,0444444444444444;4,44
2009;"2513";"Män";0;5;728;733;0,00682128240109141;0,68
2009;"2513";"Kvinnor";0;21;618;639;0,0328638497652582;3,29
2009;"2514";"Män";0;30;3322;3352;0,00894988066825776;0,89
2009;"2514";"Kvinnor";0;49;3026;3075;0,0159349593495935;1,59
2009;"2518";"Män";0;17;783;800;0,02125;2,12
2009;"2518";"Kvinnor";0;29;704;733;0,0395634379263302;3,96
2009;"2521";"Män";0;30;947;977;0,0307062436028659;3,07
2009;"2521";"Kvinnor";0;18;859;877;0,0205245153933865;2,05
2009;"2523";"Män";0;64;4664;4728;0,0135363790186125;1,35
2009;"2523";"Kvinnor";0;73;3337;3410;0,0214076246334311;2,14
2009;"2560";"Män";0;2;1403;1405;0,00142348754448399;0,14
2009;"2560";"Kvinnor";0;17;1275;1292;0,0131578947368421;1,32
2009;"2580";"Män";0;693;18718;19411;0,0357014064190408;3,57
2009;"2580";"Kvinnor";0;886;15761;16647;0,0532228029074308;5,32
2009;"2581";"Män";0;187;7940;8127;0,0230097206841393;2,3
2009;"2581";"Kvinnor";0;268;6866;7134;0,0375665825623773;3,76
2009;"2582";"Män";0;46;4707;4753;0,00967809804334105;0,97
2009;"2582";"Kvinnor";0;78;4255;4333;0,0180013847219017;1,8
2009;"2583";"Män";0;27;1399;1426;0,0189340813464236;1,89
2009;"2583";"Kvinnor";0;35;1529;1564;0,0223785166240409;2,24
2009;"2584";"Män";0;132;6051;6183;0,0213488597768074;2,13
2009;"2584";"Kvinnor";0;282;4588;4870;0,0579055441478439;5,79
2009;"9999";"Män";0;1377;122903;124280;0,0110798197618281;1,11
2009;"9999";"Kvinnor";0;1580;148732;150312;0,0105114694768215;1,05
2010;"0114";"Män";0;207;7110;7317;0,028290282902829;2,83
2010;"0114";"Kvinnor";0;243;6199;6442;0,0377212045948463;3,77
2010;"0115";"Män";0;84;3514;3598;0,0233463035019455;2,33
2010;"0115";"Kvinnor";0;106;3527;3633;0,029176988714561;2,92
2010;"0117";"Män";0;165;4202;4367;0,0377833753148615;3,78
2010;"0117";"Kvinnor";0;194;4441;4635;0,0418554476806904;4,19
2010;"0120";"Män";0;180;4735;4915;0,0366225839267548;3,66
2010;"0120";"Kvinnor";0;196;4496;4692;0,0417732310315431;4,18
2010;"0123";"Män";0;296;11910;12206;0,0242503686711453;2,43
2010;"0123";"Kvinnor";0;431;9129;9560;0,0450836820083682;4,51
2010;"0125";"Män";0;117;3632;3749;0,0312083222192585;3,12
2010;"0125";"Kvinnor";0;114;3292;3406;0,0334703464474457;3,35
2010;"0126";"Män";0;432;19197;19629;0,0220082530949106;2,2
2010;"0126";"Kvinnor";0;510;20662;21172;0,0240884186661629;2,41
2010;"0127";"Män";0;409;11046;11455;0,0357049323439546;3,57
2010;"0127";"Kvinnor";0;475;8764;9239;0,0514124905292781;5,14
2010;"0128";"Män";0;32;1179;1211;0,0264244426094137;2,64
2010;"0128";"Kvinnor";0;43;1342;1385;0,0310469314079422;3,1
2010;"0136";"Män";0;199;12528;12727;0,0156360493439145;1,56
2010;"0136";"Kvinnor";0;374;9708;10082;0,037095814322555;3,71
2010;"0138";"Män";0;165;4763;4928;0,0334821428571429;3,35
2010;"0138";"Kvinnor";0;184;4381;4565;0,0403066812705367;4,03
2010;"0139";"Män";0;56;3892;3948;0,0141843971631206;1,42
2010;"0139";"Kvinnor";0;60;2922;2982;0,0201207243460765;2,01
2010;"0140";"Män";0;13;1260;1273;0,0102120974076984;1,02
2010;"0140";"Kvinnor";0;14;890;904;0,0154867256637168;1,55
2010;"0160";"Män";0;434;10789;11223;0,0386705871870266;3,87
2010;"0160";"Kvinnor";0;695;9828;10523;0,0660458044283949;6,6
2010;"0162";"Män";0;151;5964;6115;0,024693376941946;2,47
2010;"0162";"Kvinnor";0;254;9934;10188;0,024931291715744;2,49
2010;"0163";"Män";0;349;12122;12471;0,0279849250260605;2,8
2010;"0163";"Kvinnor";0;564;10400;10964;0,0514410798978475;5,14
2010;"0180";"Män";0;29731;266591;296322;0,100333421075722;10,03
2010;"0180";"Kvinnor";0;33052;243179;276231;0,119653478429286;11,97
2010;"0181";"Män";0;544;23235;23779;0,0228773287354388;2,29
2010;"0181";"Kvinnor";0;523;18542;19065;0,0274324678730658;2,74
2010;"0182";"Män";0;838;15436;16274;0,0514931793044119;5,15
2010;"0182";"Kvinnor";0;1319;13843;15162;0,0869938002901992;8,7
2010;"0183";"Män";0;346;10082;10428;0,0331799002685079;3,32
2010;"0183";"Kvinnor";0;270;8296;8566;0,0315199626430072;3,15
2010;"0184";"Män";0;1559;33237;34796;0,044804000459823;4,48
2010;"0184";"Kvinnor";0;1584;31929;33513;0,0472652403544893;4,73
2010;"0186";"Män";0;622;4904;5526;0,112558812884546;11,26
2010;"0186";"Kvinnor";0;521;5533;6054;0,0860588040964651;8,61
2010;"0187";"Män";0;55;1054;1109;0,0495942290351668;4,96
2010;"0187";"Kvinnor";0;61;1222;1283;0,0475448168355417;4,75
2010;"0188";"Män";0;219;9354;9573;0,0228768411156377;2,29
2010;"0188";"Kvinnor";0;280;9411;9691;0,028892787122072;2,89
2010;"0191";"Män";0;214;13858;14072;0,0152075042637862;1,52
2010;"0191";"Kvinnor";0;261;10487;10748;0,0242835876442129;2,43
2010;"0192";"Män";0;60;3061;3121;0,0192246074975969;1,92
2010;"0192";"Kvinnor";0;110;3069;3179;0,0346020761245675;3,46
2010;"0305";"Män";0;46;2246;2292;0,0200698080279232;2,01
2010;"0305";"Kvinnor";0;87;2168;2255;0,0385809312638581;3,86
2010;"0319";"Män";0;22;1317;1339;0,0164301717699776;1,64
2010;"0319";"Kvinnor";0;22;988;1010;0,0217821782178218;2,18
2010;"0330";"Män";0;36;1548;1584;0,0227272727272727;2,27
2010;"0330";"Kvinnor";0;50;1607;1657;0,0301750150875075;3,02
2010;"0331";"Män";0;109;1680;1789;0,0609278926774734;6,09
2010;"0331";"Kvinnor";0;130;1639;1769;0,073487846240814;7,35
2010;"0360";"Män";0;43;3410;3453;0,0124529394729221;1,25
2010;"0360";"Kvinnor";0;51;2614;2665;0,0191369606003752;1,91
2010;"0380";"Män";0;1940;39404;41344;0,0469233746130031;4,69
2010;"0380";"Kvinnor";0;2317;42775;45092;0,0513838374878027;5,14
2010;"0381";"Män";0;115;6956;7071;0,0162636119360769;1,63
2010;"0381";"Kvinnor";0;217;6394;6611;0,0328240810769929;3,28
2010;"0382";"Män";0;30;4958;4988;0,00601443464314354;0,6
2010;"0382";"Kvinnor";0;48;3697;3745;0,0128170894526035;1,28
2010;"0428";"Män";0;53;1465;1518;0,0349143610013175;3,49
2010;"0428";"Kvinnor";0;117;1170;1287;0,0909090909090909;9,09
2010;"0461";"Män";0;34;1113;1147;0,029642545771578;2,96
2010;"0461";"Kvinnor";0;39;1362;1401;0,0278372591006424;2,78
2010;"0480";"Män";0;280;9882;10162;0,0275536311749656;2,76
2010;"0480";"Kvinnor";0;404;10157;10561;0,0382539532241265;3,83
2010;"0481";"Män";0;27;3127;3154;0,00856055802155992;0,86
2010;"0481";"Kvinnor";0;30;1586;1616;0,0185643564356436;1,86
2010;"0482";"Män";0;41;2759;2800;0,0146428571428571;1,46
2010;"0482";"Kvinnor";0;63;2406;2469;0,0255164034021871;2,55
2010;"0483";"Män";0;398;6151;6549;0,0607726370438235;6,08
2010;"0483";"Kvinnor";0;317;5564;5881;0,0539023975514368;5,39
2010;"0484";"Män";0;630;18811;19441;0,0324057404454503;3,24
2010;"0484";"Kvinnor";0;894;17444;18338;0,0487512269604101;4,88
2010;"0486";"Män";0;142;4866;5008;0,0283546325878594;2,84
2010;"0486";"Kvinnor";0;188;4674;4862;0,0386672151378034;3,87
2010;"0488";"Män";0;96;1575;1671;0,0574506283662478;5,75
2010;"0488";"Kvinnor";0;121;1651;1772;0,0682844243792325;6,83
2010;"0509";"Män";0;42;808;850;0,0494117647058823;4,94
2010;"0509";"Kvinnor";0;20;745;765;0,0261437908496732;2,61
2010;"0512";"Män";0;8;636;644;0,0124223602484472;1,24
2010;"0512";"Kvinnor";0;11;442;453;0,0242825607064018;2,43
2010;"0513";"Män";0;29;1636;1665;0,0174174174174174;1,74
2010;"0513";"Kvinnor";0;38;1455;1493;0,0254521098459478;2,55
2010;"0560";"Män";0;2;1005;1007;0,00198609731876862;0,2
2010;"0560";"Kvinnor";0;6;564;570;0,0105263157894737;1,05
2010;"0561";"Män";0;56;1656;1712;0,0327102803738318;3,27
2010;"0561";"Kvinnor";0;48;1397;1445;0,0332179930795848;3,32
2010;"0562";"Män";0;36;5562;5598;0,00643086816720257;0,64
2010;"0562";"Kvinnor";0;57;3400;3457;0,0164882846398612;1,65
2010;"0563";"Män";0;19;1454;1473;0,0128988458927359;1,29
2010;"0563";"Kvinnor";0;22;1058;1080;0,0203703703703704;2,04
2010;"0580";"Män";0;896;35756;36652;0,0244461420932009;2,44
2010;"0580";"Kvinnor";0;1162;31711;32873;0,0353481580628479;3,53
2010;"0581";"Män";0;1040;28736;29776;0,0349274583557227;3,49
2010;"0581";"Kvinnor";0;1299;26043;27342;0,0475093263111696;4,75
2010;"0582";"Män";0;53;1931;1984;0,0267137096774194;2,67
2010;"0582";"Kvinnor";0;58;1741;1799;0,0322401334074486;3,22
2010;"0583";"Män";0;192;7047;7239;0,0265230004144219;2,65
2010;"0583";"Kvinnor";0;207;6635;6842;0,0302543116047939;3,03
2010;"0584";"Män";0;61;1523;1584;0,038510101010101;3,85
2010;"0584";"Kvinnor";0;61;1282;1343;0,0454206999255398;4,54
2010;"0586";"Män";0;162;5574;5736;0,0282426778242678;2,82
2010;"0586";"Kvinnor";0;180;3834;4014;0,0448430493273543;4,48
2010;"0604";"Män";0;18;1344;1362;0,013215859030837;1,32
2010;"0604";"Kvinnor";0;17;1004;1021;0,0166503428011753;1,67
2010;"0617";"Män";0;44;3211;3255;0,0135176651305684;1,35
2010;"0617";"Kvinnor";0;52;2283;2335;0,0222698072805139;2,23
2010;"0642";"Män";0;14;1259;1273;0,0109976433621367;1,1
2010;"0642";"Kvinnor";0;29;1057;1086;0,0267034990791897;2,67
2010;"0643";"Män";0;37;1763;1800;0,0205555555555556;2,06
2010;"0643";"Kvinnor";0;25;1443;1468;0,0170299727520436;1,7
2010;"0662";"Män";0;89;7729;7818;0,0113839856740854;1,14
2010;"0662";"Kvinnor";0;149;5735;5884;0,0253229095853161;2,53
2010;"0665";"Män";0;31;2926;2957;0,0104835982414609;1,05
2010;"0665";"Kvinnor";0;31;2129;2160;0,0143518518518519;1,44
2010;"0680";"Män";0;1210;31088;32298;0,0374636200383925;3,75
2010;"0680";"Kvinnor";0;1277;28043;29320;0,0435538881309686;4,36
2010;"0682";"Män";0;237;6500;6737;0,0351788629953985;3,52
2010;"0682";"Kvinnor";0;195;4915;5110;0,038160469667319;3,82
2010;"0683";"Män";0;223;8114;8337;0,0267482307784575;2,67
2010;"0683";"Kvinnor";0;301;7383;7684;0,0391723060905778;3,92
2010;"0684";"Män";0;19;2303;2322;0,00818260120585702;0,82
2010;"0684";"Kvinnor";0;36;1622;1658;0,0217129071170084;2,17
2010;"0685";"Män";0;76;6522;6598;0,0115186420127311;1,15
2010;"0685";"Kvinnor";0;125;4902;5027;0,0248657250845435;2,49
2010;"0686";"Män";0;95;4153;4248;0,0223634651600753;2,24
2010;"0686";"Kvinnor";0;116;4016;4132;0,0280735721200387;2,81
2010;"0687";"Män";0;112;4033;4145;0,0270205066344994;2,7
2010;"0687";"Kvinnor";0;143;3341;3484;0,041044776119403;4,1
2010;"0760";"Män";0;22;2592;2614;0,00841622035195103;0,84
2010;"0760";"Kvinnor";0;17;1867;1884;0,00902335456475584;0,9
2010;"0761";"Män";0;45;1280;1325;0,0339622641509434;3,4
2010;"0761";"Kvinnor";0;90;1227;1317;0,0683371298405467;6,83
2010;"0763";"Män";0;38;2872;2910;0,0130584192439863;1,31
2010;"0763";"Kvinnor";0;47;2296;2343;0,0200597524541187;2,01
2010;"0764";"Män";0;53;4031;4084;0,0129774730656219;1,3
2010;"0764";"Kvinnor";0;64;2965;3029;0,0211290855067679;2,11
2010;"0765";"Män";0;751;4287;5038;0,149067090115125;14,91
2010;"0765";"Kvinnor";0;794;3474;4268;0,186035613870665;18,6
2010;"0767";"Män";0;54;2755;2809;0,0192239231043076;1,92
2010;"0767";"Kvinnor";0;48;1880;1928;0,024896265560166;2,49
2010;"0780";"Män";0;779;19896;20675;0,0376783555018138;3,77
2010;"0780";"Kvinnor";0;836;18219;19055;0,043872999212805;4,39
2010;"0781";"Män";0;512;6420;6932;0,0738603577611079;7,39
2010;"0781";"Kvinnor";0;398;5232;5630;0,0706927175843694;7,07
2010;"0821";"Män";0;15;854;869;0,0172612197928654;1,73
2010;"0821";"Kvinnor";0;9;846;855;0,0105263157894737;1,05
2010;"0834";"Män";0;9;1444;1453;0,00619408121128699;0,62
2010;"0834";"Kvinnor";0;18;947;965;0,0186528497409326;1,87
2010;"0840";"Män";0;52;2173;2225;0,0233707865168539;2,34
2010;"0840";"Kvinnor";0;100;1945;2045;0,0488997555012225;4,89
2010;"0860";"Män";0;56;2759;2815;0,0198934280639432;1,99
2010;"0860";"Kvinnor";0;38;2231;2269;0,0167474658439841;1,67
2010;"0861";"Män";0;24;2363;2387;0,0100544616673649;1,01
2010;"0861";"Kvinnor";0;34;1822;1856;0,0183189655172414;1,83
2010;"0862";"Män";0;33;2600;2633;0,0125332320546905;1,25
2010;"0862";"Kvinnor";0;35;1641;1676;0,0208830548926014;2,09
2010;"0880";"Män";0;682;14185;14867;0,0458734109100693;4,59
2010;"0880";"Kvinnor";0;864;14101;14965;0,0577347143334447;5,77
2010;"0881";"Män";0;47;4116;4163;0,0112899351429258;1,13
2010;"0881";"Kvinnor";0;77;3154;3231;0,0238316310739709;2,38
2010;"0882";"Män";0;82;7401;7483;0,0109581718562074;1,1
2010;"0882";"Kvinnor";0;173;5562;5735;0,0301656495204882;3,02
2010;"0883";"Män";0;129;7178;7307;0,0176543040919666;1,77
2010;"0883";"Kvinnor";0;164;7011;7175;0,0228571428571429;2,29
2010;"0884";"Män";0;303;3635;3938;0,0769426104621635;7,69
2010;"0884";"Kvinnor";0;306;2809;3115;0,0982343499197432;9,82
2010;"0885";"Män";0;75;1873;1948;0,0385010266940452;3,85
2010;"0885";"Kvinnor";0;88;1693;1781;0,0494104435710275;4,94
2010;"0980";"Män";0;478;11805;12283;0,038915574371082;3,89
2010;"0980";"Kvinnor";0;553;11227;11780;0,0469439728353141;4,69
2010;"1060";"Män";0;40;3598;3638;0,0109950522264981;1,1
2010;"1060";"Kvinnor";0;55;2075;2130;0,0258215962441315;2,58
2010;"1080";"Män";0;496;14329;14825;0,0334569983136594;3,35
2010;"1080";"Kvinnor";0;509;12910;13419;0,0379312914524182;3,79
2010;"1081";"Män";0;98;5874;5972;0,0164099129269926;1,64
2010;"1081";"Kvinnor";0;154;4371;4525;0,0340331491712707;3,4
2010;"1082";"Män";0;178;5523;5701;0,0312225925276267;3,12
2010;"1082";"Kvinnor";0;281;5537;5818;0,0482983843245101;4,83
2010;"1083";"Män";0;93;2863;2956;0,0314614343707713;3,15
2010;"1083";"Kvinnor";0;89;2293;2382;0,0373635600335852;3,74
2010;"1214";"Män";0;19;1591;1610;0,0118012422360248;1,18
2010;"1214";"Kvinnor";0;33;1580;1613;0,0204587724736516;2,05
2010;"1230";"Män";0;72;2911;2983;0,0241367750586658;2,41
2010;"1230";"Kvinnor";0;55;2211;2266;0,0242718446601942;2,43
2010;"1231";"Män";0;81;4481;4562;0,0177553704515563;1,78
2010;"1231";"Kvinnor";0;170;2733;2903;0,0585601102307957;5,86
2010;"1233";"Män";0;280;3275;3555;0,0787623066104079;7,88
2010;"1233";"Kvinnor";0;228;3599;3827;0,0595766919257904;5,96
2010;"1256";"Män";0;41;2212;2253;0,0181979582778518;1,82
2010;"1256";"Kvinnor";0;61;1674;1735;0,0351585014409222;3,52
2010;"1257";"Män";0;10;1795;1805;0,00554016620498615;0,55
2010;"1257";"Kvinnor";0;24;1598;1622;0,0147965474722565;1,48
2010;"1260";"Män";0;31;2420;2451;0,0126478988168095;1,26
2010;"1260";"Kvinnor";0;29;1923;1952;0,0148565573770492;1,49
2010;"1261";"Män";0;104;3092;3196;0,032540675844806;3,25
2010;"1261";"Kvinnor";0;220;3043;3263;0,067422617223414;6,74
2010;"1262";"Män";0;72;2055;2127;0,0338504936530324;3,39
2010;"1262";"Kvinnor";0;91;2356;2447;0,0371883939517777;3,72
2010;"1263";"Män";0;85;3312;3397;0,0250220783043862;2,5
2010;"1263";"Kvinnor";0;108;2535;2643;0,0408626560726447;4,09
2010;"1264";"Män";0;69;1757;1826;0,0377875136911281;3,78
2010;"1264";"Kvinnor";0;79;1686;1765;0,0447592067988669;4,48
2010;"1265";"Män";0;56;2861;2917;0,0191978059650326;1,92
2010;"1265";"Kvinnor";0;84;2349;2433;0,0345252774352651;3,45
2010;"1266";"Män";0;38;2256;2294;0,016564952048823;1,66
2010;"1266";"Kvinnor";0;68;2072;2140;0,0317757009345794;3,18
2010;"1267";"Män";0;45;1892;1937;0,0232318017552917;2,32
2010;"1267";"Kvinnor";0;68;2320;2388;0,0284757118927973;2,85
2010;"1270";"Män";0;64;2289;2353;0,0271993200169996;2,72
2010;"1270";"Kvinnor";0;75;1781;1856;0,0404094827586207;4,04
2010;"1272";"Män";0;30;2624;2654;0,0113036925395629;1,13
2010;"1272";"Kvinnor";0;37;1887;1924;0,0192307692307692;1,92
2010;"1273";"Män";0;31;2157;2188;0,0141681901279707;1,42
2010;"1273";"Kvinnor";0;52;1742;1794;0,0289855072463768;2,9
2010;"1275";"Män";0;8;1658;1666;0,00480192076830732;0,48
2010;"1275";"Kvinnor";0;12;1164;1176;0,0102040816326531;1,02
2010;"1276";"Män";0;93;2880;2973;0,0312815338042381;3,13
2010;"1276";"Kvinnor";0;70;2447;2517;0,0278108859753675;2,78
2010;"1277";"Män";0;42;2783;2825;0,0148672566371681;1,49
2010;"1277";"Kvinnor";0;124;2423;2547;0,0486847271299568;4,87
2010;"1278";"Män";0;111;3164;3275;0,0338931297709924;3,39
2010;"1278";"Kvinnor";0;177;2570;2747;0,0644339279213688;6,44
2010;"1280";"Män";0;5031;72081;77112;0,0652427637721755;6,52
2010;"1280";"Kvinnor";0;5357;64009;69366;0,0772280367903584;7,72
2010;"1281";"Män";0;944;30427;31371;0,0300914857671098;3,01
2010;"1281";"Kvinnor";0;1342;29996;31338;0,042823409279469;4,28
2010;"1282";"Män";0;311;6769;7080;0,0439265536723164;4,39
2010;"1282";"Kvinnor";0;253;5793;6046;0,0418458484948726;4,18
2010;"1283";"Män";0;1509;29601;31110;0,0485053037608486;4,85
2010;"1283";"Kvinnor";0;1956;26995;28951;0,0675624330765777;6,76
2010;"1284";"Män";0;104;3380;3484;0,0298507462686567;2,99
2010;"1284";"Kvinnor";0;153;3361;3514;0,043540125213432;4,35
2010;"1285";"Män";0;161;5057;5218;0,0308547336144117;3,09
2010;"1285";"Kvinnor";0;173;4397;4570;0,037855579868709;3,79
2010;"1286";"Män";0;195;5183;5378;0,0362588322796579;3,63
2010;"1286";"Kvinnor";0;273;5560;5833;0,0468026744385393;4,68
2010;"1287";"Män";0;100;6359;6459;0,0154822727976467;1,55
2010;"1287";"Kvinnor";0;222;6166;6388;0,0347526612398247;3,48
2010;"1290";"Män";0;524;16108;16632;0,0315055315055315;3,15
2010;"1290";"Kvinnor";0;671;16433;17104;0,0392305893358279;3,92
2010;"1291";"Män";0;108;3144;3252;0,033210332103321;3,32
2010;"1291";"Kvinnor";0;165;3092;3257;0,0506601166717838;5,07
2010;"1292";"Män";0;199;7188;7387;0,0269392175443346;2,69
2010;"1292";"Kvinnor";0;335;7743;8078;0,0414706610547165;4,15
2010;"1293";"Män";0;281;9618;9899;0,0283867057278513;2,84
2010;"1293";"Kvinnor";0;267;8423;8690;0,0307249712313003;3,07
2010;"1315";"Män";0;31;2492;2523;0,0122869599682917;1,23
2010;"1315";"Kvinnor";0;49;1869;1918;0,0255474452554745;2,55
2010;"1380";"Män";0;868;20688;21556;0,0402672109853405;4,03
2010;"1380";"Kvinnor";0;1134;19369;20503;0,0553089791737795;5,53
2010;"1381";"Män";0;182;3884;4066;0,044761436301033;4,48
2010;"1381";"Kvinnor";0;153;3349;3502;0,0436893203883495;4,37
2010;"1382";"Män";0;540;8586;9126;0,0591715976331361;5,92
2010;"1382";"Kvinnor";0;1151;6743;7894;0,145806941981252;14,58
2010;"1383";"Män";0;446;12870;13316;0,0334935416040853;3,35
2010;"1383";"Kvinnor";0;739;11146;11885;0,0621792175010517;6,22
2010;"1384";"Män";0;527;9262;9789;0,0538359382980897;5,38
2010;"1384";"Kvinnor";0;862;10177;11039;0,078086783223118;7,81
2010;"1401";"Män";0;433;6160;6593;0,0656757166691946;6,57
2010;"1401";"Kvinnor";0;295;5532;5827;0,0506263943710314;5,06
2010;"1402";"Män";0;260;5074;5334;0,0487439070116235;4,87
2010;"1402";"Kvinnor";0;388;4506;4894;0,0792807519411524;7,93
2010;"1407";"Män";0;19;1490;1509;0,0125911199469848;1,26
2010;"1407";"Kvinnor";0;43;1396;1439;0,0298818624044475;2,99
2010;"1415";"Män";0;84;6412;6496;0,0129310344827586;1,29
2010;"1415";"Kvinnor";0;224;4144;4368;0,0512820512820513;5,13
2010;"1419";"Män";0;36;2073;2109;0,0170697012802276;1,71
2010;"1419";"Kvinnor";0;64;2153;2217;0,0288678394226432;2,89
2010;"1421";"Män";0;25;2529;2554;0,00978856695379796;0,98
2010;"1421";"Kvinnor";0;38;2040;2078;0,0182868142444658;1,83
2010;"1427";"Män";0;24;1892;1916;0,0125260960334029;1,25
2010;"1427";"Kvinnor";0;44;1712;1756;0,0250569476082005;2,51
2010;"1430";"Män";0;74;1804;1878;0,0394036208732694;3,94
2010;"1430";"Kvinnor";0;54;1511;1565;0,0345047923322684;3,45
2010;"1435";"Män";0;77;2347;2424;0,0317656765676568;3,18
2010;"1435";"Kvinnor";0;95;1825;1920;0,0494791666666667;4,95
2010;"1438";"Män";0;14;1029;1043;0,0134228187919463;1,34
2010;"1438";"Kvinnor";0;18;791;809;0,0222496909765142;2,22
2010;"1439";"Män";0;9;1020;1029;0,0087463556851312;0,87
2010;"1439";"Kvinnor";0;13;950;963;0,0134994807892004;1,35
2010;"1440";"Män";0;56;2902;2958;0,0189317106152806;1,89
2010;"1440";"Kvinnor";0;65;3009;3074;0,0211450878334418;2,11
2010;"1441";"Män";0;166;3614;3780;0,0439153439153439;4,39
2010;"1441";"Kvinnor";0;190;4409;4599;0,0413133289845619;4,13
2010;"1442";"Män";0;38;2374;2412;0,0157545605306799;1,58
2010;"1442";"Kvinnor";0;33;1727;1760;0,01875;1,88
2010;"1443";"Män";0;29;1125;1154;0,0251299826689775;2,51
2010;"1443";"Kvinnor";0;33;949;982;0,0336048879837067;3,36
2010;"1444";"Män";0;4;700;704;0,00568181818181818;0,57
2010;"1444";"Kvinnor";0;22;747;769;0,0286085825747724;2,86
2010;"1445";"Män";0;43;961;1004;0,0428286852589641;4,28
2010;"1445";"Kvinnor";0;50;762;812;0,061576354679803;6,16
2010;"1446";"Män";0;22;1558;1580;0,0139240506329114;1,39
2010;"1446";"Kvinnor";0;25;1129;1154;0,0216637781629116;2,17
2010;"1447";"Män";0;14;1037;1051;0,0133206470028544;1,33
2010;"1447";"Kvinnor";0;8;709;717;0,0111576011157601;1,12
2010;"1452";"Män";0;102;3235;3337;0,0305663769853162;3,06
2010;"1452";"Kvinnor";0;137;2043;2180;0,0628440366972477;6,28
2010;"1460";"Män";0;44;1952;1996;0,0220440881763527;2,2
2010;"1460";"Kvinnor";0;73;1716;1789;0,0408049189491336;4,08
2010;"1461";"Män";0;22;1366;1388;0,015850144092219;1,59
2010;"1461";"Kvinnor";0;44;1290;1334;0,0329835082458771;3,3
2010;"1462";"Män";0;28;1899;1927;0,0145303580695381;1,45
2010;"1462";"Kvinnor";0;29;1773;1802;0,0160932297447281;1,61
2010;"1463";"Män";0;210;5063;5273;0,0398255262658828;3,98
2010;"1463";"Kvinnor";0;298;4995;5293;0,0563007746079728;5,63
2010;"1465";"Män";0;280;1701;1981;0,141342756183746;14,13
2010;"1465";"Kvinnor";0;140;1600;1740;0,0804597701149425;8,05
2010;"1466";"Män";0;20;2156;2176;0,00919117647058824;0,92
2010;"1466";"Kvinnor";0;29;1515;1544;0,0187823834196891;1,88
2010;"1470";"Män";0;71;4497;4568;0,0155429071803853;1,55
2010;"1470";"Kvinnor";0;76;2691;2767;0,0274665702927358;2,75
2010;"1471";"Män";0;38;3362;3400;0,0111764705882353;1,12
2010;"1471";"Kvinnor";0;42;2328;2370;0,0177215189873418;1,77
2010;"1472";"Män";0;26;1894;1920;0,0135416666666667;1,35
2010;"1472";"Kvinnor";0;16;1645;1661;0,00963275135460566;0,96
2010;"1473";"Män";0;18;1631;1649;0,0109157064887811;1,09
2010;"1473";"Kvinnor";0;25;1282;1307;0,0191277735271614;1,91
2010;"1480";"Män";0;7383;147539;154922;0,0476562399142794;4,77
2010;"1480";"Kvinnor";0;8893;129206;138099;0,0643958319756117;6,44
2010;"1481";"Män";0;649;16631;17280;0,0375578703703704;3,76
2010;"1481";"Kvinnor";0;917;15269;16186;0,0566538984307426;5,67
2010;"1482";"Män";0;206;7012;7218;0,028539761706844;2,85
2010;"1482";"Kvinnor";0;226;6805;7031;0,0321433650974257;3,21
2010;"1484";"Män";0;65;3002;3067;0,0211933485490708;2,12
2010;"1484";"Kvinnor";0;78;2422;2500;0,0312;3,12
2010;"1485";"Män";0;407;10303;10710;0,0380018674136321;3,8
2010;"1485";"Kvinnor";0;654;10619;11273;0,0580147254501907;5,8
2010;"1486";"Män";0;119;2728;2847;0,0417983842641377;4,18
2010;"1486";"Kvinnor";0;312;2753;3065;0,101794453507341;10,18
2010;"1487";"Män";0;148;5664;5812;0,0254645560908465;2,55
2010;"1487";"Kvinnor";0;151;5978;6129;0,0246369717735356;2,46
2010;"1488";"Män";0;226;14866;15092;0,0149748210972701;1,5
2010;"1488";"Kvinnor";0;453;12070;12523;0,0361734408688014;3,62
2010;"1489";"Män";0;198;5797;5995;0,0330275229357798;3,3
2010;"1489";"Kvinnor";0;285;6571;6856;0,0415694282380397;4,16
2010;"1490";"Män";0;2141;22310;24451;0,0875628808637684;8,76
2010;"1490";"Kvinnor";0;2562;21751;24313;0,105375724920824;10,54
2010;"1491";"Män";0;282;3962;4244;0,0664467483506126;6,64
2010;"1491";"Kvinnor";0;382;3300;3682;0,103747963063552;10,37
2010;"1492";"Män";0;45;2083;2128;0,0211466165413534;2,11
2010;"1492";"Kvinnor";0;78;1987;2065;0,037772397094431;3,78
2010;"1493";"Män";0;68;4490;4558;0,014918824045634;1,49
2010;"1493";"Kvinnor";0;108;4186;4294;0,0251513740102469;2,52
2010;"1494";"Män";0;210;8377;8587;0,0244555723768487;2,45
2010;"1494";"Kvinnor";0;296;7278;7574;0,0390810668074993;3,91
2010;"1495";"Män";0;119;4132;4251;0,0279934133145142;2,8
2010;"1495";"Kvinnor";0;170;3721;3891;0,0436905679773837;4,37
2010;"1496";"Män";0;308;14992;15300;0,0201307189542484;2,01
2010;"1496";"Kvinnor";0;478;12583;13061;0,0365975040196003;3,66
2010;"1497";"Män";0;23;1266;1289;0,0178432893716059;1,78
2010;"1497";"Kvinnor";0;36;1286;1322;0,027231467473525;2,72
2010;"1498";"Män";0;37;2192;2229;0,0165993719156572;1,66
2010;"1498";"Kvinnor";0;52;1751;1803;0,028840820854132;2,88
2010;"1499";"Män";0;188;6167;6355;0,0295830055074744;2,96
2010;"1499";"Kvinnor";0;180;5443;5623;0,0320113818246488;3,2
2010;"1715";"Män";0;27;1586;1613;0,0167389956602604;1,67
2010;"1715";"Kvinnor";0;33;1268;1301;0,0253651037663336;2,54
2010;"1730";"Män";0;15;1397;1412;0,0106232294617564;1,06
2010;"1730";"Kvinnor";0;117;1576;1693;0,0691080921441229;6,91
2010;"1737";"Män";0;35;2410;2445;0,0143149284253579;1,43
2010;"1737";"Kvinnor";0;53;2334;2387;0,0222036028487641;2,22
2010;"1760";"Män";0;1;594;595;0,00168067226890756;0,17
2010;"1760";"Kvinnor";0;6;453;459;0,0130718954248366;1,31
2010;"1761";"Män";0;23;2074;2097;0,010968049594659;1,1
2010;"1761";"Kvinnor";0;33;1705;1738;0,0189873417721519;1,9
2010;"1762";"Män";0;21;749;770;0,0272727272727273;2,73
2010;"1762";"Kvinnor";0;28;575;603;0,0464344941956882;4,64
2010;"1763";"Män";0;17;990;1007;0,0168818272095333;1,69
2010;"1763";"Kvinnor";0;26;1219;1245;0,0208835341365462;2,09
2010;"1764";"Män";0;10;1760;1770;0,00564971751412429;0,56
2010;"1764";"Kvinnor";0;11;1216;1227;0,00896495517522412;0,9
2010;"1765";"Män";0;37;1760;1797;0,0205898720089037;2,06
2010;"1765";"Kvinnor";0;105;1664;1769;0,0593555681175806;5,94
2010;"1766";"Män";0;153;2443;2596;0,0589368258859784;5,89
2010;"1766";"Kvinnor";0;134;2082;2216;0,0604693140794224;6,05
2010;"1780";"Män";0;991;22088;23079;0,042939468781143;4,29
2010;"1780";"Kvinnor";0;1139;20810;21949;0,0518930247391681;5,19
2010;"1781";"Män";0;67;4662;4729;0,0141679001903151;1,42
2010;"1781";"Kvinnor";0;108;3399;3507;0,0307955517536356;3,08
2010;"1782";"Män";0;17;1838;1855;0,0091644204851752;0,92
2010;"1782";"Kvinnor";0;20;1671;1691;0,0118273211117682;1,18
2010;"1783";"Män";0;16;2432;2448;0,0065359477124183;0,65
2010;"1783";"Kvinnor";0;39;1868;1907;0,0204509701101206;2,05
2010;"1784";"Män";0;84;5300;5384;0,0156017830609212;1,56
2010;"1784";"Kvinnor";0;132;4537;4669;0,0282715784964661;2,83
2010;"1785";"Män";0;42;3105;3147;0,0133460438512869;1,33
2010;"1785";"Kvinnor";0;64;2159;2223;0,0287899235267656;2,88
2010;"1814";"Män";0;13;847;860;0,0151162790697674;1,51
2010;"1814";"Kvinnor";0;9;761;770;0,0116883116883117;1,17
2010;"1860";"Män";0;12;1522;1534;0,00782268578878748;0,78
2010;"1860";"Kvinnor";0;12;941;953;0,012591815320042;1,26
2010;"1861";"Män";0;79;3735;3814;0,0207131620346093;2,07
2010;"1861";"Kvinnor";0;61;2694;2755;0,0221415607985481;2,21
2010;"1862";"Män";0;10;1517;1527;0,00654878847413229;0,65
2010;"1862";"Kvinnor";0;28;1117;1145;0,0244541484716157;2,45
2010;"1863";"Män";0;18;1377;1395;0,0129032258064516;1,29
2010;"1863";"Kvinnor";0;36;1029;1065;0,0338028169014084;3,38
2010;"1864";"Män";0;7;754;761;0,00919842312746386;0,92
2010;"1864";"Kvinnor";0;13;698;711;0,0182841068917018;1,83
2010;"1880";"Män";0;1301;31665;32966;0,0394649032336347;3,95
2010;"1880";"Kvinnor";0;1588;29695;31283;0,050762394910974;5,08
2010;"1881";"Män";0;103;3349;3452;0,029837775202781;2,98
2010;"1881";"Kvinnor";0;81;2950;3031;0,0267238535136919;2,67
2010;"1882";"Män";0;30;1902;1932;0,015527950310559;1,55
2010;"1882";"Kvinnor";0;43;1449;1492;0,0288203753351206;2,88
2010;"1883";"Män";0;166;6888;7054;0,0235327473773745;2,35
2010;"1883";"Kvinnor";0;201;6079;6280;0,0320063694267516;3,2
2010;"1884";"Män";0;33;1492;1525;0,0216393442622951;2,16
2010;"1884";"Kvinnor";0;59;1374;1433;0,0411723656664341;4,12
2010;"1885";"Män";0;93;4588;4681;0,0198675496688742;1,99
2010;"1885";"Kvinnor";0;91;4230;4321;0,0210599398287433;2,11
2010;"1904";"Män";0;8;690;698;0,0114613180515759;1,15
2010;"1904";"Kvinnor";0;7;604;611;0,0114566284779051;1,15
2010;"1907";"Män";0;10;1540;1550;0,00645161290322581;0,65
2010;"1907";"Kvinnor";0;24;1175;1199;0,0200166805671393;2
2010;"1960";"Män";0;9;1274;1283;0,00701480904130943;0,7
2010;"1960";"Kvinnor";0;13;1104;1117;0,0116383169203223;1,16
2010;"1961";"Män";0;35;2400;2435;0,0143737166324435;1,44
2010;"1961";"Kvinnor";0;28;2340;2368;0,0118243243243243;1,18
2010;"1962";"Män";0;14;804;818;0,0171149144254279;1,71
2010;"1962";"Kvinnor";0;17;646;663;0,0256410256410256;2,56
2010;"1980";"Män";0;1107;31874;32981;0,0335647797216579;3,36
2010;"1980";"Kvinnor";0;1414;27909;29323;0,0482215325853426;4,82
2010;"1981";"Män";0;97;3682;3779;0,0256681661815295;2,57
2010;"1981";"Kvinnor";0;170;3435;3605;0,0471567267683773;4,72
2010;"1982";"Män";0;35;3354;3389;0,01032753024491;1,03
2010;"1982";"Kvinnor";0;92;2444;2536;0,0362776025236593;3,63
2010;"1983";"Män";0;78;5367;5445;0,0143250688705234;1,43
2010;"1983";"Kvinnor";0;119;4368;4487;0,0265210608424337;2,65
2010;"1984";"Män";0;32;2682;2714;0,0117907148120855;1,18
2010;"1984";"Kvinnor";0;58;2146;2204;0,0263157894736842;2,63
2010;"2021";"Män";0;11;1246;1257;0,00875099443118536;0,88
2010;"2021";"Kvinnor";0;17;1082;1099;0,0154686078252957;1,55
2010;"2023";"Män";0;73;2854;2927;0,0249402118209771;2,49
2010;"2023";"Kvinnor";0;76;2534;2610;0,0291187739463602;2,91
2010;"2026";"Män";0;21;1173;1194;0,0175879396984925;1,76
2010;"2026";"Kvinnor";0;16;1209;1225;0,0130612244897959;1,31
2010;"2029";"Män";0;82;3096;3178;0,025802391441158;2,58
2010;"2029";"Kvinnor";0;106;2707;2813;0,0376821898329186;3,77
2010;"2031";"Män";0;60;1651;1711;0,0350672121566335;3,51
2010;"2031";"Kvinnor";0;80;1598;1678;0,0476758045292014;4,77
2010;"2034";"Män";0;36;920;956;0,0376569037656904;3,77
2010;"2034";"Kvinnor";0;26;913;939;0,0276890308839191;2,77
2010;"2039";"Män";0;15;1392;1407;0,0106609808102345;1,07
2010;"2039";"Kvinnor";0;31;1259;1290;0,024031007751938;2,4
2010;"2061";"Män";0;26;1696;1722;0,0150987224157956;1,51
2010;"2061";"Kvinnor";0;21;1203;1224;0,017156862745098;1,72
2010;"2062";"Män";0;84;4898;4982;0,0168606985146528;1,69
2010;"2062";"Kvinnor";0;134;4296;4430;0,0302483069977427;3,02
2010;"2080";"Män";0;758;11136;11894;0,0637296115688582;6,37
2010;"2080";"Kvinnor";0;707;12260;12967;0,0545230199737796;5,45
2010;"2081";"Män";0;209;13711;13920;0,015014367816092;1,5
2010;"2081";"Kvinnor";0;415;9814;10229;0,0405709257991984;4,06
2010;"2082";"Män";0;21;1523;1544;0,0136010362694301;1,36
2010;"2082";"Kvinnor";0;28;1542;1570;0,0178343949044586;1,78
2010;"2083";"Män";0;65;3269;3334;0,019496100779844;1,95
2010;"2083";"Kvinnor";0;68;2644;2712;0,0250737463126844;2,51
2010;"2084";"Män";0;95;5252;5347;0,0177669721339069;1,78
2010;"2084";"Kvinnor";0;127;3920;4047;0,0313812700766;3,14
2010;"2085";"Män";0;73;6268;6341;0,0115123797508279;1,15
2010;"2085";"Kvinnor";0;117;5128;5245;0,0223069590085796;2,23
2010;"2101";"Män";0;12;914;926;0,0129589632829374;1,3
2010;"2101";"Kvinnor";0;18;868;886;0,0203160270880361;2,03
2010;"2104";"Män";0;100;2006;2106;0,0474833808167142;4,75
2010;"2104";"Kvinnor";0;113;1498;1611;0,0701427684667908;7,01
2010;"2121";"Män";0;21;2766;2787;0,00753498385360603;0,75
2010;"2121";"Kvinnor";0;36;1907;1943;0,0185280494081318;1,85
2010;"2132";"Män";0;8;1491;1499;0,00533689126084056;0,53
2010;"2132";"Kvinnor";0;12;1143;1155;0,0103896103896104;1,04
2010;"2161";"Män";0;142;3766;3908;0,0363357215967247;3,63
2010;"2161";"Kvinnor";0;204;3203;3407;0,0598767243909598;5,99
2010;"2180";"Män";0;708;21048;21756;0,0325427468284611;3,25
2010;"2180";"Kvinnor";0;949;19239;20188;0,0470081236378046;4,7
2010;"2181";"Män";0;90;9362;9452;0,00952179432924249;0,95
2010;"2181";"Kvinnor";0;151;6564;6715;0,0224869694713328;2,25
2010;"2182";"Män";0;132;4796;4928;0,0267857142857143;2,68
2010;"2182";"Kvinnor";0;156;3897;4053;0,0384900074019245;3,85
2010;"2183";"Män";0;149;4945;5094;0,0292500981546918;2,93
2010;"2183";"Kvinnor";0;174;5020;5194;0,0335001925298421;3,35
2010;"2184";"Män";0;200;7994;8194;0,0244081034903588;2,44
2010;"2184";"Kvinnor";0;282;7224;7506;0,0375699440447642;3,76
2010;"2260";"Män";0;52;2180;2232;0,0232974910394265;2,33
2010;"2260";"Kvinnor";0;66;1842;1908;0,0345911949685535;3,46
2010;"2262";"Män";0;37;2799;2836;0,0130465444287729;1,3
2010;"2262";"Kvinnor";0;31;1911;1942;0,0159629248197734;1,6
2010;"2280";"Män";0;230;4399;4629;0,0496867573990063;4,97
2010;"2280";"Kvinnor";0;282;4452;4734;0,0595690747782003;5,96
2010;"2281";"Män";0;687;22556;23243;0,0295572860646216;2,96
2010;"2281";"Kvinnor";0;980;20711;21691;0,0451800285832834;4,52
2010;"2282";"Män";0;40;3834;3874;0,0103252452245741;1,03
2010;"2282";"Kvinnor";0;56;3130;3186;0,0175768989328311;1,76
2010;"2283";"Män";0;96;3565;3661;0,0262223436219612;2,62
2010;"2283";"Kvinnor";0;117;3498;3615;0,0323651452282158;3,24
2010;"2284";"Män";0;244;12451;12695;0,0192201654194565;1,92
2010;"2284";"Kvinnor";0;356;10392;10748;0,0331224413844436;3,31
2010;"2303";"Män";0;5;1197;1202;0,00415973377703827;0,42
2010;"2303";"Kvinnor";0;7;977;984;0,00711382113821138;0,71
2010;"2305";"Män";0;7;914;921;0,00760043431053203;0,76
2010;"2305";"Kvinnor";0;14;977;991;0,0141271442986882;1,41
2010;"2309";"Män";0;33;2216;2249;0,0146731880835927;1,47
2010;"2309";"Kvinnor";0;26;1970;1996;0,0130260521042084;1,3
2010;"2313";"Män";0;17;2386;2403;0,00707449022055764;0,71
2010;"2313";"Kvinnor";0;39;2062;2101;0,0185625892432175;1,86
2010;"2321";"Män";0;105;2446;2551;0,0411603292826343;4,12
2010;"2321";"Kvinnor";0;112;2290;2402;0,0466278101582015;4,66
2010;"2326";"Män";0;15;1249;1264;0,0118670886075949;1,19
2010;"2326";"Kvinnor";0;5;1113;1118;0,00447227191413238;0,45
2010;"2361";"Män";0;10;2477;2487;0,00402090872537193;0,4
2010;"2361";"Kvinnor";0;22;2037;2059;0,0106847984458475;1,07
2010;"2380";"Män";0;639;14315;14954;0,0427310418617092;4,27
2010;"2380";"Kvinnor";0;650;14566;15216;0,0427181913774974;4,27
2010;"2401";"Män";0;4;1052;1056;0,00378787878787879;0,38
2010;"2401";"Kvinnor";0;22;943;965;0,0227979274611399;2,28
2010;"2403";"Män";0;1;306;307;0,00325732899022801;0,33
2010;"2403";"Kvinnor";0;4;295;299;0,0133779264214047;1,34
2010;"2404";"Män";0;13;1130;1143;0,0113735783027122;1,14
2010;"2404";"Kvinnor";0;20;824;844;0,023696682464455;2,37
2010;"2409";"Män";0;9;1037;1046;0,00860420650095602;0,86
2010;"2409";"Kvinnor";0;6;1026;1032;0,00581395348837209;0,58
2010;"2417";"Män";0;12;833;845;0,0142011834319527;1,42
2010;"2417";"Kvinnor";0;29;762;791;0,0366624525916561;3,67
2010;"2418";"Män";0;6;668;674;0,00890207715133531;0,89
2010;"2418";"Kvinnor";0;15;560;575;0,0260869565217391;2,61
2010;"2421";"Män";0;16;1273;1289;0,0124127230411171;1,24
2010;"2421";"Kvinnor";0;22;1109;1131;0,0194518125552608;1,95
2010;"2422";"Män";0;1;491;492;0,00203252032520325;0,2
2010;"2422";"Kvinnor";0;6;462;468;0,0128205128205128;1,28
2010;"2425";"Män";0;3;552;555;0,00540540540540541;0,54
2010;"2425";"Kvinnor";0;8;492;500;0,016;1,6
2010;"2460";"Män";0;6;1283;1289;0,00465477114041893;0,47
2010;"2460";"Kvinnor";0;10;1072;1082;0,00924214417744917;0,92
2010;"2462";"Män";0;23;1156;1179;0,0195080576759966;1,95
2010;"2462";"Kvinnor";0;23;1133;1156;0,0198961937716263;1,99
2010;"2463";"Män";0;2;521;523;0,00382409177820268;0,38
2010;"2463";"Kvinnor";0;8;454;462;0,0173160173160173;1,73
2010;"2480";"Män";0;999;27617;28616;0,0349105395582891;3,49
2010;"2480";"Kvinnor";0;1111;25926;27037;0,0410918371121056;4,11
2010;"2481";"Män";0;56;2951;3007;0,018623212504157;1,86
2010;"2481";"Kvinnor";0;71;2556;2627;0,027027027027027;2,7
2010;"2482";"Män";0;364;16002;16366;0,0222412318220701;2,22
2010;"2482";"Kvinnor";0;481;13099;13580;0,035419734904271;3,54
2010;"2505";"Män";0;13;1312;1325;0,00981132075471698;0,98
2010;"2505";"Kvinnor";0;32;1170;1202;0,0266222961730449;2,66
2010;"2506";"Män";0;4;722;726;0,00550964187327824;0,55
2010;"2506";"Kvinnor";0;13;614;627;0,0207336523125997;2,07
2010;"2510";"Män";0;16;1126;1142;0,0140105078809107;1,4
2010;"2510";"Kvinnor";0;31;852;883;0,0351075877689694;3,51
2010;"2513";"Män";0;3;728;731;0,00410396716826265;0,41
2010;"2513";"Kvinnor";0;17;611;628;0,0270700636942675;2,71
2010;"2514";"Män";0;31;3369;3400;0,00911764705882353;0,91
2010;"2514";"Kvinnor";0;40;3074;3114;0,0128452151573539;1,28
2010;"2518";"Män";0;8;776;784;0,0102040816326531;1,02
2010;"2518";"Kvinnor";0;19;691;710;0,0267605633802817;2,68
2010;"2521";"Män";0;31;989;1020;0,0303921568627451;3,04
2010;"2521";"Kvinnor";0;23;880;903;0,0254706533776301;2,55
2010;"2523";"Män";0;62;4973;5035;0,0123138033763654;1,23
2010;"2523";"Kvinnor";0;82;3558;3640;0,0225274725274725;2,25
2010;"2560";"Män";0;2;1399;1401;0,00142755174875089;0,14
2010;"2560";"Kvinnor";0;21;1254;1275;0,0164705882352941;1,65
2010;"2580";"Män";0;693;19147;19840;0,034929435483871;3,49
2010;"2580";"Kvinnor";0;893;16205;17098;0,0522283307989239;5,22
2010;"2581";"Män";0;182;8074;8256;0,0220445736434109;2,2
2010;"2581";"Kvinnor";0;277;6983;7260;0,0381542699724518;3,82
2010;"2582";"Män";0;49;5145;5194;0,00943396226415094;0,94
2010;"2582";"Kvinnor";0;83;4333;4416;0,0187952898550725;1,88
2010;"2583";"Män";0;29;1480;1509;0,0192180251822399;1,92
2010;"2583";"Kvinnor";0;37;1546;1583;0,0233733417561592;2,34
2010;"2584";"Män";0;137;6472;6609;0,0207293085186866;2,07
2010;"2584";"Kvinnor";0;277;4819;5096;0,0543563579277865;5,44
2010;"9999";"Män";0;1372;124495;125867;0,0109003948612424;1,09
2010;"9999";"Kvinnor";0;1789;154920;156709;0,0114160641698945;1,14
2011;"0114";"Män";0;179;6835;7014;0,0255203877958369;2,55
2011;"0114";"Kvinnor";0;237;6219;6456;0,0367100371747212;3,67
2011;"0115";"Män";0;117;3583;3700;0,0316216216216216;3,16
2011;"0115";"Kvinnor";0;119;3565;3684;0,0323018458197611;3,23
2011;"0117";"Män";0;161;4337;4498;0,0357936860827034;3,58
2011;"0117";"Kvinnor";0;228;4425;4653;0,0490006447453256;4,9
2011;"0120";"Män";0;181;4888;5069;0,0357072400868021;3,57
2011;"0120";"Kvinnor";0;199;4475;4674;0,0425759520753102;4,26
2011;"0123";"Män";0;302;12084;12386;0,0243823671887615;2,44
2011;"0123";"Kvinnor";0;439;8844;9283;0,0472907465259076;4,73
2011;"0125";"Män";0;127;3724;3851;0,0329784471565827;3,3
2011;"0125";"Kvinnor";0;140;3334;3474;0,0402993667242372;4,03
2011;"0126";"Män";0;412;20078;20490;0,0201073694485115;2,01
2011;"0126";"Kvinnor";0;471;20724;21195;0,0222222222222222;2,22
2011;"0127";"Män";0;426;11279;11705;0,0363947031183255;3,64
2011;"0127";"Kvinnor";0;477;8744;9221;0,0517297473159093;5,17
2011;"0128";"Män";0;46;1038;1084;0,0424354243542435;4,24
2011;"0128";"Kvinnor";0;44;1388;1432;0,0307262569832402;3,07
2011;"0136";"Män";0;204;13275;13479;0,0151346539060761;1,51
2011;"0136";"Kvinnor";0;334;9853;10187;0,0327868852459016;3,28
2011;"0138";"Män";0;176;4904;5080;0,0346456692913386;3,46
2011;"0138";"Kvinnor";0;167;4380;4547;0,0367275126457005;3,67
2011;"0139";"Män";0;57;4510;4567;0,0124808408145391;1,25
2011;"0139";"Kvinnor";0;59;3004;3063;0,0192621612797911;1,93
2011;"0140";"Män";0;12;1345;1357;0,00884303610906411;0,88
2011;"0140";"Kvinnor";0;13;855;868;0,0149769585253456;1,5
2011;"0160";"Män";0;490;10879;11369;0,043099656961914;4,31
2011;"0160";"Kvinnor";0;694;9792;10486;0,06618348273889;6,62
2011;"0162";"Män";0;179;6299;6478;0,0276319851806113;2,76
2011;"0162";"Kvinnor";0;264;10179;10443;0,025280091927607;2,53
2011;"0163";"Män";0;326;12621;12947;0,0251795782806828;2,52
2011;"0163";"Kvinnor";0;517;10737;11254;0,0459392216100942;4,59
2011;"0180";"Män";0;30291;273843;304134;0,0995975458186194;9,96
2011;"0180";"Kvinnor";0;33903;248573;282476;0,120020815927725;12
2011;"0181";"Män";0;484;24033;24517;0,019741403923808;1,97
2011;"0181";"Kvinnor";0;532;18742;19274;0,0276019508145688;2,76
2011;"0182";"Män";0;849;15437;16286;0,0521306643743092;5,21
2011;"0182";"Kvinnor";0;1276;14047;15323;0,0832735104091888;8,33
2011;"0183";"Män";0;364;9802;10166;0,0358056265984655;3,58
2011;"0183";"Kvinnor";0;282;7983;8265;0,0341197822141561;3,41
2011;"0184";"Män";0;1487;34419;35906;0,0414136913050744;4,14
2011;"0184";"Kvinnor";0;1481;32446;33927;0,0436525481180181;4,37
2011;"0186";"Män";0;545;4606;5151;0,105804698116871;10,58
2011;"0186";"Kvinnor";0;498;5424;5922;0,0840932117527862;8,41
2011;"0187";"Män";0;47;1080;1127;0,0417036379769299;4,17
2011;"0187";"Kvinnor";0;66;1229;1295;0,050965250965251;5,1
2011;"0188";"Män";0;235;9497;9732;0,0241471434443074;2,41
2011;"0188";"Kvinnor";0;297;9525;9822;0,0302382406841784;3,02
2011;"0191";"Män";0;220;14688;14908;0,0147571773544406;1,48
2011;"0191";"Kvinnor";0;243;11067;11310;0,0214854111405836;2,15
2011;"0192";"Män";0;74;3146;3220;0,0229813664596273;2,3
2011;"0192";"Kvinnor";0;105;3074;3179;0,0330292544825417;3,3
2011;"0305";"Män";0;52;2364;2416;0,021523178807947;2,15
2011;"0305";"Kvinnor";0;91;2190;2281;0,0398947829899167;3,99
2011;"0319";"Män";0;16;1276;1292;0,0123839009287926;1,24
2011;"0319";"Kvinnor";0;23;935;958;0,0240083507306889;2,4
2011;"0330";"Män";0;36;1633;1669;0,0215698022768125;2,16
2011;"0330";"Kvinnor";0;48;1596;1644;0,0291970802919708;2,92
2011;"0331";"Män";0;121;1681;1802;0,0671476137624861;6,71
2011;"0331";"Kvinnor";0;150;1618;1768;0,084841628959276;8,48
2011;"0360";"Män";0;45;3431;3476;0,012945914844649;1,29
2011;"0360";"Kvinnor";0;50;2564;2614;0,0191277735271614;1,91
2011;"0380";"Män";0;1922;40556;42478;0,0452469513630585;4,52
2011;"0380";"Kvinnor";0;2318;43268;45586;0,0508489448514895;5,08
2011;"0381";"Män";0;122;7355;7477;0,0163167045606527;1,63
2011;"0381";"Kvinnor";0;196;6616;6812;0,0287727539635937;2,88
2011;"0382";"Män";0;30;4979;5009;0,00598921940507087;0,6
2011;"0382";"Kvinnor";0;60;3675;3735;0,0160642570281124;1,61
2011;"0428";"Män";0;53;1388;1441;0,0367800138792505;3,68
2011;"0428";"Kvinnor";0;113;1151;1264;0,0893987341772152;8,94
2011;"0461";"Män";0;40;1122;1162;0,0344234079173838;3,44
2011;"0461";"Kvinnor";0;36;1331;1367;0,0263350402340892;2,63
2011;"0480";"Män";0;263;10175;10438;0,025196397777352;2,52
2011;"0480";"Kvinnor";0;408;10359;10767;0,0378935636667595;3,79
2011;"0481";"Män";0;27;3393;3420;0,00789473684210526;0,79
2011;"0481";"Kvinnor";0;31;1702;1733;0,0178880553952683;1,79
2011;"0482";"Män";0;37;2745;2782;0,0132997843278217;1,33
2011;"0482";"Kvinnor";0;51;2285;2336;0,0218321917808219;2,18
2011;"0483";"Män";0;385;6258;6643;0,0579557428872497;5,8
2011;"0483";"Kvinnor";0;309;5701;6010;0,051414309484193;5,14
2011;"0484";"Män";0;578;19498;20076;0,0287905957362024;2,88
2011;"0484";"Kvinnor";0;851;17906;18757;0,0453697286346431;4,54
2011;"0486";"Män";0;151;5026;5177;0,0291674715085957;2,92
2011;"0486";"Kvinnor";0;184;4779;4963;0,0370743501914165;3,71
2011;"0488";"Män";0;95;1597;1692;0,0561465721040189;5,61
2011;"0488";"Kvinnor";0;109;1632;1741;0,0626076967260195;6,26
2011;"0509";"Män";0;38;820;858;0,0442890442890443;4,43
2011;"0509";"Kvinnor";0;22;753;775;0,0283870967741936;2,84
2011;"0512";"Män";0;10;640;650;0,0153846153846154;1,54
2011;"0512";"Kvinnor";0;13;425;438;0,0296803652968037;2,97
2011;"0513";"Män";0;31;1693;1724;0,0179814385150812;1,8
2011;"0513";"Kvinnor";0;35;1427;1462;0,0239398084815321;2,39
2011;"0560";"Män";0;3;968;971;0,00308959835221421;0,31
2011;"0560";"Kvinnor";0;7;567;574;0,0121951219512195;1,22
2011;"0561";"Män";0;57;1653;1710;0,0333333333333333;3,33
2011;"0561";"Kvinnor";0;49;1384;1433;0,0341939986043266;3,42
2011;"0562";"Män";0;29;5685;5714;0,00507525376268813;0,51
2011;"0562";"Kvinnor";0;62;3376;3438;0,0180337405468296;1,8
2011;"0563";"Män";0;19;1436;1455;0,0130584192439863;1,31
2011;"0563";"Kvinnor";0;23;1031;1054;0,0218216318785579;2,18
2011;"0580";"Män";0;867;36670;37537;0,023097210752058;2,31
2011;"0580";"Kvinnor";0;1128;31664;32792;0,0343986338131252;3,44
2011;"0581";"Män";0;1064;28970;30034;0,0354265166145036;3,54
2011;"0581";"Kvinnor";0;1267;26497;27764;0,0456346347788503;4,56
2011;"0582";"Män";0;55;1922;1977;0,0278199291856348;2,78
2011;"0582";"Kvinnor";0;70;1634;1704;0,0410798122065728;4,11
2011;"0583";"Män";0;208;6769;6977;0,0298122402178587;2,98
2011;"0583";"Kvinnor";0;198;6505;6703;0,0295390123825153;2,95
2011;"0584";"Män";0;62;1584;1646;0,0376670716889429;3,77
2011;"0584";"Kvinnor";0;69;1255;1324;0,0521148036253776;5,21
2011;"0586";"Män";0;82;5992;6074;0,0135001646361541;1,35
2011;"0586";"Kvinnor";0;132;3952;4084;0,0323212536728697;3,23
2011;"0604";"Män";0;14;1366;1380;0,0101449275362319;1,01
2011;"0604";"Kvinnor";0;13;966;979;0,0132788559754852;1,33
2011;"0617";"Män";0;30;3266;3296;0,00910194174757281;0,91
2011;"0617";"Kvinnor";0;38;2221;2259;0,016821602478973;1,68
2011;"0642";"Män";0;17;1279;1296;0,0131172839506173;1,31
2011;"0642";"Kvinnor";0;38;1060;1098;0,034608378870674;3,46
2011;"0643";"Män";0;34;1774;1808;0,0188053097345133;1,88
2011;"0643";"Kvinnor";0;24;1429;1453;0,0165175498967653;1,65
2011;"0662";"Män";0;80;7815;7895;0,0101329955668144;1,01
2011;"0662";"Kvinnor";0;136;5813;5949;0,0228609850395024;2,29
2011;"0665";"Män";0;30;3079;3109;0,00964940495336121;0,96
2011;"0665";"Kvinnor";0;35;2135;2170;0,0161290322580645;1,61
2011;"0680";"Män";0;1134;32105;33239;0,034116549836036;3,41
2011;"0680";"Kvinnor";0;1241;28254;29495;0,0420749279538905;4,21
2011;"0682";"Män";0;223;6458;6681;0,0333782367908996;3,34
2011;"0682";"Kvinnor";0;186;4923;5109;0,0364063417498532;3,64
2011;"0683";"Män";0;209;8221;8430;0,0247924080664294;2,48
2011;"0683";"Kvinnor";0;296;7427;7723;0,0383270749708662;3,83
2011;"0684";"Män";0;21;2331;2352;0,00892857142857143;0,89
2011;"0684";"Kvinnor";0;31;1634;1665;0,0186186186186186;1,86
2011;"0685";"Män";0;80;6607;6687;0,0119635112905638;1,2
2011;"0685";"Kvinnor";0;128;4780;4908;0,026079869600652;2,61
2011;"0686";"Män";0;89;4281;4370;0,0203661327231121;2,04
2011;"0686";"Kvinnor";0;106;4027;4133;0,0256472296152916;2,56
2011;"0687";"Män";0;109;4137;4246;0,0256712199717381;2,57
2011;"0687";"Kvinnor";0;115;3337;3452;0,0333140208574739;3,33
2011;"0760";"Män";0;21;2563;2584;0,00812693498452012;0,81
2011;"0760";"Kvinnor";0;17;1834;1851;0,00918422474338196;0,92
2011;"0761";"Män";0;44;1324;1368;0,0321637426900585;3,22
2011;"0761";"Kvinnor";0;81;1210;1291;0,0627420604182804;6,27
2011;"0763";"Män";0;38;2920;2958;0,0128465179175118;1,28
2011;"0763";"Kvinnor";0;50;2276;2326;0,0214961306964746;2,15
2011;"0764";"Män";0;57;3956;4013;0,0142038375280339;1,42
2011;"0764";"Kvinnor";0;64;2904;2968;0,0215633423180593;2,16
2011;"0765";"Män";0;775;4328;5103;0,151871448167744;15,19
2011;"0765";"Kvinnor";0;828;3447;4275;0,193684210526316;19,37
2011;"0767";"Män";0;47;2893;2940;0,0159863945578231;1,6
2011;"0767";"Kvinnor";0;38;1810;1848;0,0205627705627706;2,06
2011;"0780";"Män";0;815;20260;21075;0,0386714116251483;3,87
2011;"0780";"Kvinnor";0;908;18513;19421;0,046753514237166;4,68
2011;"0781";"Män";0;494;6580;7074;0,0698331919705966;6,98
2011;"0781";"Kvinnor";0;390;5299;5689;0,0685533485674108;6,86
2011;"0821";"Män";0;12;813;825;0,0145454545454545;1,45
2011;"0821";"Kvinnor";0;11;862;873;0,0126002290950745;1,26
2011;"0834";"Män";0;10;1377;1387;0,00720980533525595;0,72
2011;"0834";"Kvinnor";0;17;928;945;0,017989417989418;1,8
2011;"0840";"Män";0;56;2135;2191;0,0255591054313099;2,56
2011;"0840";"Kvinnor";0;95;1959;2054;0,0462512171372931;4,63
2011;"0860";"Män";0;44;2841;2885;0,0152512998266898;1,53
2011;"0860";"Kvinnor";0;34;2188;2222;0,0153015301530153;1,53
2011;"0861";"Män";0;21;2341;2362;0,00889077053344623;0,89
2011;"0861";"Kvinnor";0;35;1836;1871;0,0187065740245858;1,87
2011;"0862";"Män";0;33;2564;2597;0,0127069695802849;1,27
2011;"0862";"Kvinnor";0;26;1653;1679;0,015485407980941;1,55
2011;"0880";"Män";0;651;14297;14948;0,0435509767192936;4,36
2011;"0880";"Kvinnor";0;854;14131;14985;0,0569903236569903;5,7
2011;"0881";"Män";0;46;4189;4235;0,01086186540732;1,09
2011;"0881";"Kvinnor";0;84;3191;3275;0,0256488549618321;2,56
2011;"0882";"Män";0;75;7565;7640;0,00981675392670157;0,98
2011;"0882";"Kvinnor";0;154;5518;5672;0,0271509167842031;2,72
2011;"0883";"Män";0;142;7317;7459;0,019037404477812;1,9
2011;"0883";"Kvinnor";0;142;7133;7275;0,0195189003436426;1,95
2011;"0884";"Män";0;314;3739;4053;0,077473476437207;7,75
2011;"0884";"Kvinnor";0;317;2819;3136;0,101084183673469;10,11
2011;"0885";"Män";0;71;1874;1945;0,0365038560411311;3,65
2011;"0885";"Kvinnor";0;74;1650;1724;0,04292343387471;4,29
2011;"0980";"Män";0;466;12010;12476;0,0373517152933633;3,74
2011;"0980";"Kvinnor";0;563;11213;11776;0,0478091032608696;4,78
2011;"1060";"Män";0;39;3768;3807;0,0102442868400315;1,02
2011;"1060";"Kvinnor";0;53;2094;2147;0,0246856078248719;2,47
2011;"1080";"Män";0;472;14613;15085;0,0312893602916805;3,13
2011;"1080";"Kvinnor";0;486;12912;13398;0,0362740707568294;3,63
2011;"1081";"Män";0;82;5710;5792;0,0141574585635359;1,42
2011;"1081";"Kvinnor";0;122;4273;4395;0,0277588168373151;2,78
2011;"1082";"Män";0;187;5506;5693;0,0328473564025997;3,28
2011;"1082";"Kvinnor";0;291;5445;5736;0,0507322175732218;5,07
2011;"1083";"Män";0;92;2913;3005;0,0306156405990017;3,06
2011;"1083";"Kvinnor";0;78;2336;2414;0,0323115161557581;3,23
2011;"1214";"Män";0;27;1611;1638;0,0164835164835165;1,65
2011;"1214";"Kvinnor";0;32;1541;1573;0,0203432930705658;2,03
2011;"1230";"Män";0;72;3032;3104;0,0231958762886598;2,32
2011;"1230";"Kvinnor";0;58;2260;2318;0,0250215703192407;2,5
2011;"1231";"Män";0;83;4641;4724;0,0175698560541914;1,76
2011;"1231";"Kvinnor";0;203;2754;2957;0,0686506594521474;6,87
2011;"1233";"Män";0;269;3252;3521;0,0763987503550128;7,64
2011;"1233";"Kvinnor";0;230;3478;3708;0,0620280474649407;6,2
2011;"1256";"Män";0;51;2258;2309;0,0220874837592031;2,21
2011;"1256";"Kvinnor";0;69;1651;1720;0,0401162790697674;4,01
2011;"1257";"Män";0;13;1835;1848;0,00703463203463203;0,7
2011;"1257";"Kvinnor";0;29;1533;1562;0,0185659411011524;1,86
2011;"1260";"Män";0;14;2452;2466;0,0056772100567721;0,57
2011;"1260";"Kvinnor";0;18;1932;1950;0,00923076923076923;0,92
2011;"1261";"Män";0;98;3204;3302;0,0296789824348879;2,97
2011;"1261";"Kvinnor";0;215;3149;3364;0,0639120095124851;6,39
2011;"1262";"Män";0;81;2147;2228;0,0363554757630162;3,64
2011;"1262";"Kvinnor";0;87;2438;2525;0,0344554455445545;3,45
2011;"1263";"Män";0;81;3415;3496;0,0231693363844394;2,32
2011;"1263";"Kvinnor";0;117;2623;2740;0,0427007299270073;4,27
2011;"1264";"Män";0;74;1798;1872;0,0395299145299145;3,95
2011;"1264";"Kvinnor";0;85;1697;1782;0,047699214365881;4,77
2011;"1265";"Män";0;48;2700;2748;0,0174672489082969;1,75
2011;"1265";"Kvinnor";0;61;2251;2312;0,0263840830449827;2,64
2011;"1266";"Män";0;35;2263;2298;0,015230635335074;1,52
2011;"1266";"Kvinnor";0;52;2087;2139;0,0243104254324451;2,43
2011;"1267";"Män";0;44;1862;1906;0,0230849947534103;2,31
2011;"1267";"Kvinnor";0;63;2323;2386;0,0264040234702431;2,64
2011;"1270";"Män";0;68;2344;2412;0,0281923714759536;2,82
2011;"1270";"Kvinnor";0;75;1836;1911;0,0392464678178964;3,92
2011;"1272";"Män";0;28;2586;2614;0,0107115531752104;1,07
2011;"1272";"Kvinnor";0;35;1831;1866;0,0187566988210075;1,88
2011;"1273";"Män";0;33;2201;2234;0,0147717099373321;1,48
2011;"1273";"Kvinnor";0;45;1792;1837;0,0244964616222101;2,45
2011;"1275";"Män";0;9;1732;1741;0,00516944284893739;0,52
2011;"1275";"Kvinnor";0;13;1140;1153;0,0112749349522984;1,13
2011;"1276";"Män";0;87;2759;2846;0,0305692199578356;3,06
2011;"1276";"Kvinnor";0;62;2213;2275;0,0272527472527473;2,73
2011;"1277";"Män";0;26;2814;2840;0,00915492957746479;0,92
2011;"1277";"Kvinnor";0;134;2429;2563;0,0522824814670308;5,23
2011;"1278";"Män";0;112;3140;3252;0,034440344403444;3,44
2011;"1278";"Kvinnor";0;155;2639;2794;0,0554760200429492;5,55
2011;"1280";"Män";0;5179;73743;78922;0,065621753123337;6,56
2011;"1280";"Kvinnor";0;5260;65438;70698;0,0744009731534131;7,44
2011;"1281";"Män";0;922;30752;31674;0,0291090484308897;2,91
2011;"1281";"Kvinnor";0;1329;29652;30981;0,0428972596107292;4,29
2011;"1282";"Män";0;311;6896;7207;0,0431524906341057;4,32
2011;"1282";"Kvinnor";0;268;5706;5974;0,0448610646133244;4,49
2011;"1283";"Män";0;1687;30364;32051;0,052634863186796;5,26
2011;"1283";"Kvinnor";0;1971;27185;29156;0,0676018658252161;6,76
2011;"1284";"Män";0;144;3486;3630;0,0396694214876033;3,97
2011;"1284";"Kvinnor";0;197;3398;3595;0,054798331015299;5,48
2011;"1285";"Män";0;143;5083;5226;0,027363184079602;2,74
2011;"1285";"Kvinnor";0;151;4431;4582;0,0329550414666085;3,3
2011;"1286";"Män";0;211;5348;5559;0,0379564669904659;3,8
2011;"1286";"Kvinnor";0;265;5617;5882;0,0450527031621897;4,51
2011;"1287";"Män";0;96;6258;6354;0,0151085930122757;1,51
2011;"1287";"Kvinnor";0;207;6050;6257;0,0330829470992488;3,31
2011;"1290";"Män";0;529;16347;16876;0,0313462905901872;3,13
2011;"1290";"Kvinnor";0;647;16688;17335;0,0373233342947793;3,73
2011;"1291";"Män";0;98;3212;3310;0,029607250755287;2,96
2011;"1291";"Kvinnor";0;158;3075;3233;0,0488710176306836;4,89
2011;"1292";"Män";0;174;7354;7528;0,0231137088204038;2,31
2011;"1292";"Kvinnor";0;318;7809;8127;0,0391288298265042;3,91
2011;"1293";"Män";0;242;9621;9863;0,0245361451890905;2,45
2011;"1293";"Kvinnor";0;256;8364;8620;0,0296983758700696;2,97
2011;"1315";"Män";0;36;2559;2595;0,0138728323699422;1,39
2011;"1315";"Kvinnor";0;47;1856;1903;0,0246978455070941;2,47
2011;"1380";"Män";0;868;21311;22179;0,0391361197529194;3,91
2011;"1380";"Kvinnor";0;1101;19408;20509;0,0536837485981764;5,37
2011;"1381";"Män";0;156;3986;4142;0,0376629647513279;3,77
2011;"1381";"Kvinnor";0;150;3435;3585;0,0418410041841004;4,18
2011;"1382";"Män";0;316;8961;9277;0,0340627357982106;3,41
2011;"1382";"Kvinnor";0;390;7617;8007;0,0487073810415886;4,87
2011;"1383";"Män";0;466;13382;13848;0,0336510687463894;3,37
2011;"1383";"Kvinnor";0;764;11429;12193;0,0626589026490609;6,27
2011;"1384";"Män";0;486;9708;10194;0,0476751030017657;4,77
2011;"1384";"Kvinnor";0;837;10454;11291;0,0741298379240103;7,41
2011;"1401";"Män";0;371;6297;6668;0,0556388722255549;5,56
2011;"1401";"Kvinnor";0;316;5576;5892;0,0536320434487441;5,36
2011;"1402";"Män";0;251;5322;5573;0,0450385788623721;4,5
2011;"1402";"Kvinnor";0;385;4499;4884;0,0788288288288288;7,88
2011;"1407";"Män";0;27;1521;1548;0,0174418604651163;1,74
2011;"1407";"Kvinnor";0;45;1425;1470;0,0306122448979592;3,06
2011;"1415";"Män";0;95;6608;6703;0,0141727584663583;1,42
2011;"1415";"Kvinnor";0;237;4232;4469;0,0530319982098904;5,3
2011;"1419";"Män";0;38;2094;2132;0,0178236397748593;1,78
2011;"1419";"Kvinnor";0;61;2074;2135;0,0285714285714286;2,86
2011;"1421";"Män";0;24;2558;2582;0,00929512006196747;0,93
2011;"1421";"Kvinnor";0;46;2027;2073;0,0221900627110468;2,22
2011;"1427";"Män";0;26;1919;1945;0,0133676092544987;1,34
2011;"1427";"Kvinnor";0;46;1707;1753;0,0262407301768397;2,62
2011;"1430";"Män";0;82;1811;1893;0,0433174854727945;4,33
2011;"1430";"Kvinnor";0;55;1510;1565;0,0351437699680511;3,51
2011;"1435";"Män";0;65;2379;2444;0,0265957446808511;2,66
2011;"1435";"Kvinnor";0;90;1791;1881;0,0478468899521531;4,78
2011;"1438";"Män";0;22;1015;1037;0,0212150433944069;2,12
2011;"1438";"Kvinnor";0;19;757;776;0,0244845360824742;2,45
2011;"1439";"Män";0;11;1019;1030;0,0106796116504854;1,07
2011;"1439";"Kvinnor";0;14;875;889;0,015748031496063;1,57
2011;"1440";"Män";0;61;3077;3138;0,0194391332058636;1,94
2011;"1440";"Kvinnor";0;63;3028;3091;0,0203817534778389;2,04
2011;"1441";"Män";0;159;3751;3910;0,0406649616368286;4,07
2011;"1441";"Kvinnor";0;185;4411;4596;0,0402523933855527;4,03
2011;"1442";"Män";0;47;2410;2457;0,0191290191290191;1,91
2011;"1442";"Kvinnor";0;37;1717;1754;0,0210946408209806;2,11
2011;"1443";"Män";0;56;1168;1224;0,0457516339869281;4,58
2011;"1443";"Kvinnor";0;44;939;983;0,0447609359104781;4,48
2011;"1444";"Män";0;5;721;726;0,0068870523415978;0,69
2011;"1444";"Kvinnor";0;15;721;736;0,0203804347826087;2,04
2011;"1445";"Män";0;49;1045;1094;0,0447897623400366;4,48
2011;"1445";"Kvinnor";0;53;804;857;0,0618436406067678;6,18
2011;"1446";"Män";0;24;1726;1750;0,0137142857142857;1,37
2011;"1446";"Kvinnor";0;22;1117;1139;0,019315188762072;1,93
2011;"1447";"Män";0;16;1016;1032;0,0155038759689922;1,55
2011;"1447";"Kvinnor";0;9;737;746;0,0120643431635389;1,21
2011;"1452";"Män";0;105;3293;3398;0,0309005297233667;3,09
2011;"1452";"Kvinnor";0;146;2049;2195;0,0665148063781321;6,65
2011;"1460";"Män";0;48;1994;2042;0,0235063663075416;2,35
2011;"1460";"Kvinnor";0;77;1751;1828;0,0421225382932166;4,21
2011;"1461";"Män";0;40;1387;1427;0,028030833917309;2,8
2011;"1461";"Kvinnor";0;59;1277;1336;0,0441616766467066;4,42
2011;"1462";"Män";0;28;1853;1881;0,0148856990962254;1,49
2011;"1462";"Kvinnor";0;30;1774;1804;0,016629711751663;1,66
2011;"1463";"Män";0;190;5181;5371;0,0353751629119345;3,54
2011;"1463";"Kvinnor";0;264;5115;5379;0,049079754601227;4,91
2011;"1465";"Män";0;226;1728;1954;0,115660184237462;11,57
2011;"1465";"Kvinnor";0;130;1560;1690;0,0769230769230769;7,69
2011;"1466";"Män";0;14;2116;2130;0,00657276995305164;0,66
2011;"1466";"Kvinnor";0;14;1526;1540;0,00909090909090909;0,91
2011;"1470";"Män";0;67;4624;4691;0,0142826689405244;1,43
2011;"1470";"Kvinnor";0;71;2745;2816;0,0252130681818182;2,52
2011;"1471";"Män";0;31;3276;3307;0,00937405503477472;0,94
2011;"1471";"Kvinnor";0;37;2390;2427;0,015245158632056;1,52
2011;"1472";"Män";0;29;1875;1904;0,0152310924369748;1,52
2011;"1472";"Kvinnor";0;22;1659;1681;0,0130874479476502;1,31
2011;"1473";"Män";0;14;1648;1662;0,00842358604091456;0,84
2011;"1473";"Kvinnor";0;23;1307;1330;0,0172932330827068;1,73
2011;"1480";"Män";0;7373;151115;158488;0,0465208722426935;4,65
2011;"1480";"Kvinnor";0;8855;130434;139289;0,0635728593069087;6,36
2011;"1481";"Män";0;680;17377;18057;0,0376585257794761;3,77
2011;"1481";"Kvinnor";0;948;15509;16457;0,0576046667071763;5,76
2011;"1482";"Män";0;251;7293;7544;0,033271474019088;3,33
2011;"1482";"Kvinnor";0;221;6901;7122;0,0310306093793878;3,1
2011;"1484";"Män";0;55;2996;3051;0,0180268764339561;1,8
2011;"1484";"Kvinnor";0;84;2373;2457;0,0341880341880342;3,42
2011;"1485";"Män";0;360;10347;10707;0,0336228635472121;3,36
2011;"1485";"Kvinnor";0;584;10493;11077;0,0527218560982215;5,27
2011;"1486";"Män";0;123;2767;2890;0,042560553633218;4,26
2011;"1486";"Kvinnor";0;333;2698;3031;0,109864731111844;10,99
2011;"1487";"Män";0;143;5778;5921;0,0241513257895626;2,42
2011;"1487";"Kvinnor";0;176;5957;6133;0,0286972118049894;2,87
2011;"1488";"Män";0;228;14301;14529;0,0156927524261821;1,57
2011;"1488";"Kvinnor";0;486;12001;12487;0,0389204772963882;3,89
2011;"1489";"Män";0;211;5866;6077;0,0347210794800066;3,47
2011;"1489";"Kvinnor";0;270;6639;6909;0,0390794615718628;3,91
2011;"1490";"Män";0;2041;23115;25156;0,0811337255525521;8,11
2011;"1490";"Kvinnor";0;2577;21894;24471;0,105308324138777;10,53
2011;"1491";"Män";0;273;4177;4450;0,0613483146067416;6,13
2011;"1491";"Kvinnor";0;364;3287;3651;0,0996987126814571;9,97
2011;"1492";"Män";0;51;2124;2175;0,023448275862069;2,34
2011;"1492";"Kvinnor";0;70;1921;1991;0,0351582119537921;3,52
2011;"1493";"Män";0;73;4394;4467;0,0163420640250728;1,63
2011;"1493";"Kvinnor";0;102;4087;4189;0,0243494867510146;2,43
2011;"1494";"Män";0;235;8393;8628;0,027236903106166;2,72
2011;"1494";"Kvinnor";0;292;7222;7514;0,0388607931860527;3,89
2011;"1495";"Män";0;106;3977;4083;0,0259613029635072;2,6
2011;"1495";"Kvinnor";0;160;3580;3740;0,0427807486631016;4,28
2011;"1496";"Män";0;317;15987;16304;0,0194430814524043;1,94
2011;"1496";"Kvinnor";0;499;12928;13427;0,0371639234378491;3,72
2011;"1497";"Män";0;30;1262;1292;0,0232198142414861;2,32
2011;"1497";"Kvinnor";0;36;1289;1325;0,0271698113207547;2,72
2011;"1498";"Män";0;44;2171;2215;0,0198645598194131;1,99
2011;"1498";"Kvinnor";0;54;1770;1824;0,0296052631578947;2,96
2011;"1499";"Män";0;210;6297;6507;0,0322729368372522;3,23
2011;"1499";"Kvinnor";0;196;5463;5659;0,0346350945396713;3,46
2011;"1715";"Män";0;30;1691;1721;0,0174317257408483;1,74
2011;"1715";"Kvinnor";0;36;1307;1343;0,0268056589724497;2,68
2011;"1730";"Män";0;15;1436;1451;0,0103376981392143;1,03
2011;"1730";"Kvinnor";0;126;1593;1719;0,0732984293193717;7,33
2011;"1737";"Män";0;43;2437;2480;0,0173387096774194;1,73
2011;"1737";"Kvinnor";0;55;2390;2445;0,0224948875255624;2,25
2011;"1760";"Män";0;2;587;589;0,0033955857385399;0,34
2011;"1760";"Kvinnor";0;5;465;470;0,0106382978723404;1,06
2011;"1761";"Män";0;34;2003;2037;0,0166912125675012;1,67
2011;"1761";"Kvinnor";0;50;1707;1757;0,0284575981787137;2,85
2011;"1762";"Män";0;23;776;799;0,0287859824780976;2,88
2011;"1762";"Kvinnor";0;29;589;618;0,0469255663430421;4,69
2011;"1763";"Män";0;20;978;998;0,0200400801603206;2
2011;"1763";"Kvinnor";0;29;1188;1217;0,0238290879211175;2,38
2011;"1764";"Män";0;10;1760;1770;0,00564971751412429;0,56
2011;"1764";"Kvinnor";0;11;1190;1201;0,00915903413821815;0,92
2011;"1765";"Män";0;34;1832;1866;0,0182207931404073;1,82
2011;"1765";"Kvinnor";0;98;1663;1761;0,0556501987507098;5,57
2011;"1766";"Män";0;158;2477;2635;0,0599620493358634;6
2011;"1766";"Kvinnor";0;143;2078;2221;0,0643854119765871;6,44
2011;"1780";"Män";0;962;22509;23471;0,0409867496058966;4,1
2011;"1780";"Kvinnor";0;1125;21089;22214;0,0506437381831278;5,06
2011;"1781";"Män";0;61;4626;4687;0,0130147215703008;1,3
2011;"1781";"Kvinnor";0;105;3342;3447;0,030461270670148;3,05
2011;"1782";"Män";0;21;1895;1916;0,0109603340292276;1,1
2011;"1782";"Kvinnor";0;22;1673;1695;0,0129793510324484;1,3
2011;"1783";"Män";0;22;2466;2488;0,00884244372990354;0,88
2011;"1783";"Kvinnor";0;34;1831;1865;0,018230563002681;1,82
2011;"1784";"Män";0;80;5293;5373;0,0148892611204169;1,49
2011;"1784";"Kvinnor";0;128;4449;4577;0,0279659165392178;2,8
2011;"1785";"Män";0;29;3192;3221;0,00900341508848184;0,9
2011;"1785";"Kvinnor";0;61;2136;2197;0,02776513427401;2,78
2011;"1814";"Män";0;13;858;871;0,0149253731343284;1,49
2011;"1814";"Kvinnor";0;12;797;809;0,0148331273176761;1,48
2011;"1860";"Män";0;13;1486;1499;0,00867244829886591;0,87
2011;"1860";"Kvinnor";0;15;971;986;0,0152129817444219;1,52
2011;"1861";"Män";0;85;3849;3934;0,0216065073716319;2,16
2011;"1861";"Kvinnor";0;55;2723;2778;0,0197984161267099;1,98
2011;"1862";"Män";0;9;1500;1509;0,00596421471172962;0,6
2011;"1862";"Kvinnor";0;27;1132;1159;0,0232959447799827;2,33
2011;"1863";"Män";0;9;1405;1414;0,00636492220650637;0,64
2011;"1863";"Kvinnor";0;33;1039;1072;0,0307835820895522;3,08
2011;"1864";"Män";0;7;778;785;0,0089171974522293;0,89
2011;"1864";"Kvinnor";0;13;702;715;0,0181818181818182;1,82
2011;"1880";"Män";0;1248;32778;34026;0,0366778345970728;3,67
2011;"1880";"Kvinnor";0;1537;29838;31375;0,0489880478087649;4,9
2011;"1881";"Män";0;101;3398;3499;0,0288653901114604;2,89
2011;"1881";"Kvinnor";0;78;3054;3132;0,024904214559387;2,49
2011;"1882";"Män";0;27;1963;1990;0,0135678391959799;1,36
2011;"1882";"Kvinnor";0;44;1435;1479;0,0297498309668695;2,97
2011;"1883";"Män";0;161;6925;7086;0,0227208580299181;2,27
2011;"1883";"Kvinnor";0;190;6072;6262;0,0303417438518045;3,03
2011;"1884";"Män";0;32;1505;1537;0,0208197787898504;2,08
2011;"1884";"Kvinnor";0;49;1384;1433;0,0341939986043266;3,42
2011;"1885";"Män";0;74;4873;4947;0,0149585607438852;1,5
2011;"1885";"Kvinnor";0;71;4342;4413;0,0160888284613642;1,61
2011;"1904";"Män";0;11;757;768;0,0143229166666667;1,43
2011;"1904";"Kvinnor";0;6;600;606;0,0099009900990099;0,99
2011;"1907";"Män";0;12;1551;1563;0,00767754318618042;0,77
2011;"1907";"Kvinnor";0;28;1183;1211;0,023121387283237;2,31
2011;"1960";"Män";0;8;1120;1128;0,00709219858156028;0,71
2011;"1960";"Kvinnor";0;16;973;989;0,0161779575328615;1,62
2011;"1961";"Män";0;34;2502;2536;0,0134069400630915;1,34
2011;"1961";"Kvinnor";0;21;2234;2255;0,00931263858093126;0,93
2011;"1962";"Män";0;15;786;801;0,0187265917602996;1,87
2011;"1962";"Kvinnor";0;18;641;659;0,0273141122913505;2,73
2011;"1980";"Män";0;1139;32869;34008;0,0334921195012938;3,35
2011;"1980";"Kvinnor";0;1528;28274;29802;0,0512717267297497;5,13
2011;"1981";"Män";0;94;3685;3779;0,0248743053717915;2,49
2011;"1981";"Kvinnor";0;144;3367;3511;0,0410139561378525;4,1
2011;"1982";"Män";0;20;3437;3457;0,00578536303153023;0,58
2011;"1982";"Kvinnor";0;51;2647;2698;0,0189028910303929;1,89
2011;"1983";"Män";0;80;5331;5411;0,0147846978377379;1,48
2011;"1983";"Kvinnor";0;117;4321;4438;0,0263632266786841;2,64
2011;"1984";"Män";0;19;2673;2692;0,00705794947994056;0,71
2011;"1984";"Kvinnor";0;44;2166;2210;0,0199095022624434;1,99
2011;"2021";"Män";0;10;1301;1311;0,007627765064836;0,76
2011;"2021";"Kvinnor";0;18;1045;1063;0,0169332079021637;1,69
2011;"2023";"Män";0;68;2781;2849;0,0238680238680239;2,39
2011;"2023";"Kvinnor";0;78;2486;2564;0,0304212168486739;3,04
2011;"2026";"Män";0;20;1220;1240;0,0161290322580645;1,61
2011;"2026";"Kvinnor";0;14;1238;1252;0,0111821086261981;1,12
2011;"2029";"Män";0;79;3190;3269;0,0241664117467115;2,42
2011;"2029";"Kvinnor";0;101;2648;2749;0,0367406329574391;3,67
2011;"2031";"Män";0;58;1674;1732;0,0334872979214781;3,35
2011;"2031";"Kvinnor";0;71;1529;1600;0,044375;4,44
2011;"2034";"Män";0;30;955;985;0,0304568527918782;3,05
2011;"2034";"Kvinnor";0;23;876;899;0,0255839822024472;2,56
2011;"2039";"Män";0;17;1413;1430;0,0118881118881119;1,19
2011;"2039";"Kvinnor";0;26;1230;1256;0,0207006369426752;2,07
2011;"2061";"Män";0;23;1734;1757;0,0130904951622083;1,31
2011;"2061";"Kvinnor";0;30;1158;1188;0,0252525252525253;2,53
2011;"2062";"Män";0;102;4793;4895;0,0208375893769152;2,08
2011;"2062";"Kvinnor";0;154;4283;4437;0,0347081361280144;3,47
2011;"2080";"Män";0;734;11130;11864;0,0618678354686446;6,19
2011;"2080";"Kvinnor";0;696;12406;13102;0,0531216608151427;5,31
2011;"2081";"Män";0;246;14078;14324;0,0171739737503491;1,72
2011;"2081";"Kvinnor";0;431;9982;10413;0,0413905694804571;4,14
2011;"2082";"Män";0;28;1527;1555;0,0180064308681672;1,8
2011;"2082";"Kvinnor";0;30;1546;1576;0,0190355329949239;1,9
2011;"2083";"Män";0;70;3366;3436;0,020372526193248;2,04
2011;"2083";"Kvinnor";0;66;2716;2782;0,0237239396117901;2,37
2011;"2084";"Män";0;87;5286;5373;0,0161920714684534;1,62
2011;"2084";"Kvinnor";0;138;3933;4071;0,0338983050847458;3,39
2011;"2085";"Män";0;81;6342;6423;0,0126109294722092;1,26
2011;"2085";"Kvinnor";0;117;4979;5096;0,0229591836734694;2,3
2011;"2101";"Män";0;10;960;970;0,0103092783505155;1,03
2011;"2101";"Kvinnor";0;15;893;908;0,0165198237885463;1,65
2011;"2104";"Män";0;79;2073;2152;0,0367100371747212;3,67
2011;"2104";"Kvinnor";0;116;1539;1655;0,0700906344410876;7,01
2011;"2121";"Män";0;18;2855;2873;0,006265227984685;0,63
2011;"2121";"Kvinnor";0;39;1934;1973;0,0197668525088697;1,98
2011;"2132";"Män";0;12;1498;1510;0,00794701986754967;0,79
2011;"2132";"Kvinnor";0;14;1202;1216;0,0115131578947368;1,15
2011;"2161";"Män";0;152;3766;3918;0,038795303726391;3,88
2011;"2161";"Kvinnor";0;210;3184;3394;0,0618738951090159;6,19
2011;"2180";"Män";0;725;20956;21681;0,0334394170010608;3,34
2011;"2180";"Kvinnor";0;966;19084;20050;0,0481795511221945;4,82
2011;"2181";"Män";0;99;9725;9824;0,0100773615635179;1,01
2011;"2181";"Kvinnor";0;140;6658;6798;0,0205942924389526;2,06
2011;"2182";"Män";0;134;4923;5057;0,0264979236701602;2,65
2011;"2182";"Kvinnor";0;171;3985;4156;0,0411453320500481;4,11
2011;"2183";"Män";0;141;5019;5160;0,0273255813953488;2,73
2011;"2183";"Kvinnor";0;193;4922;5115;0,0377321603128055;3,77
2011;"2184";"Män";0;211;8107;8318;0,0253666746814138;2,54
2011;"2184";"Kvinnor";0;269;7206;7475;0,0359866220735786;3,6
2011;"2260";"Män";0;54;2169;2223;0,0242914979757085;2,43
2011;"2260";"Kvinnor";0;64;1726;1790;0,0357541899441341;3,58
2011;"2262";"Män";0;38;2886;2924;0,0129958960328317;1,3
2011;"2262";"Kvinnor";0;30;1927;1957;0,0153295861011753;1,53
2011;"2280";"Män";0;189;4446;4635;0,0407766990291262;4,08
2011;"2280";"Kvinnor";0;256;4427;4683;0,0546658125133461;5,47
2011;"2281";"Män";0;692;23115;23807;0,0290670811105977;2,91
2011;"2281";"Kvinnor";0;960;20500;21460;0,0447343895619758;4,47
2011;"2282";"Män";0;43;3747;3790;0,0113456464379947;1,13
2011;"2282";"Kvinnor";0;55;3001;3056;0,0179973821989529;1,8
2011;"2283";"Män";0;109;3588;3697;0,0294833648904517;2,95
2011;"2283";"Kvinnor";0;122;3433;3555;0,0343178621659634;3,43
2011;"2284";"Män";0;238;12631;12869;0,0184940554821664;1,85
2011;"2284";"Kvinnor";0;348;10401;10749;0,0323751046608987;3,24
2011;"2303";"Män";0;4;1189;1193;0,00335289186923722;0,34
2011;"2303";"Kvinnor";0;11;953;964;0,0114107883817427;1,14
2011;"2305";"Män";0;8;996;1004;0,00796812749003984;0,8
2011;"2305";"Kvinnor";0;14;964;978;0,0143149284253579;1,43
2011;"2309";"Män";0;30;2236;2266;0,0132391879964696;1,32
2011;"2309";"Kvinnor";0;25;1983;2008;0,0124501992031873;1,25
2011;"2313";"Män";0;17;2449;2466;0,00689375506893755;0,69
2011;"2313";"Kvinnor";0;35;2044;2079;0,0168350168350168;1,68
2011;"2321";"Män";0;98;2414;2512;0,0390127388535032;3,9
2011;"2321";"Kvinnor";0;123;2276;2399;0,051271363067945;5,13
2011;"2326";"Män";0;15;1288;1303;0,0115118956254797;1,15
2011;"2326";"Kvinnor";0;5;1157;1162;0,00430292598967298;0,43
2011;"2361";"Män";0;14;2415;2429;0,00576368876080692;0,58
2011;"2361";"Kvinnor";0;26;2029;2055;0,0126520681265207;1,27
2011;"2380";"Män";0;638;14617;15255;0,0418223533267781;4,18
2011;"2380";"Kvinnor";0;686;14705;15391;0,0445715028263271;4,46
2011;"2401";"Män";0;7;1064;1071;0,0065359477124183;0,65
2011;"2401";"Kvinnor";0;21;964;985;0,0213197969543147;2,13
2011;"2403";"Män";0;2;319;321;0,00623052959501558;0,62
2011;"2403";"Kvinnor";0;5;299;304;0,0164473684210526;1,64
2011;"2404";"Män";0;13;1167;1180;0,0110169491525424;1,1
2011;"2404";"Kvinnor";0;19;848;867;0,0219146482122261;2,19
2011;"2409";"Män";0;11;1080;1091;0,0100824931255729;1,01
2011;"2409";"Kvinnor";0;10;1047;1057;0,00946073793755913;0,95
2011;"2417";"Män";0;11;824;835;0,0131736526946108;1,32
2011;"2417";"Kvinnor";0;31;766;797;0,0388958594730238;3,89
2011;"2418";"Män";0;8;667;675;0,0118518518518519;1,19
2011;"2418";"Kvinnor";0;19;564;583;0,032590051457976;3,26
2011;"2421";"Män";0;13;1258;1271;0,010228166797797;1,02
2011;"2421";"Kvinnor";0;25;1090;1115;0,0224215246636771;2,24
2011;"2422";"Män";0;0;506;506;0;0
2011;"2422";"Kvinnor";0;7;464;471;0,0148619957537155;1,49
2011;"2425";"Män";0;5;531;536;0,00932835820895522;0,93
2011;"2425";"Kvinnor";0;11;489;500;0,022;2,2
2011;"2460";"Män";0;6;1290;1296;0,00462962962962963;0,46
2011;"2460";"Kvinnor";0;12;1096;1108;0,0108303249097473;1,08
2011;"2462";"Män";0;21;1133;1154;0,0181975736568458;1,82
2011;"2462";"Kvinnor";0;21;1127;1148;0,0182926829268293;1,83
2011;"2463";"Män";0;2;509;511;0,00391389432485323;0,39
2011;"2463";"Kvinnor";0;9;451;460;0,0195652173913043;1,96
2011;"2480";"Män";0;991;28324;29315;0,0338052191710728;3,38
2011;"2480";"Kvinnor";0;1078;26253;27331;0,0394423914236581;3,94
2011;"2481";"Män";0;51;2948;2999;0,0170056685561854;1,7
2011;"2481";"Kvinnor";0;70;2524;2594;0,0269853508095605;2,7
2011;"2482";"Män";0;356;16298;16654;0,0213762459469197;2,14
2011;"2482";"Kvinnor";0;448;13216;13664;0,0327868852459016;3,28
2011;"2505";"Män";0;13;1411;1424;0,00912921348314607;0,91
2011;"2505";"Kvinnor";0;32;1166;1198;0,0267111853088481;2,67
2011;"2506";"Män";0;4;760;764;0,00523560209424084;0,52
2011;"2506";"Kvinnor";0;13;636;649;0,0200308166409861;2
2011;"2510";"Män";0;18;1143;1161;0,0155038759689922;1,55
2011;"2510";"Kvinnor";0;31;836;867;0,0357554786620531;3,58
2011;"2513";"Män";0;4;713;717;0,00557880055788006;0,56
2011;"2513";"Kvinnor";0;17;618;635;0,0267716535433071;2,68
2011;"2514";"Män";0;59;3415;3474;0,0169833045480714;1,7
2011;"2514";"Kvinnor";0;111;2925;3036;0,0365612648221344;3,66
2011;"2518";"Män";0;11;786;797;0,013801756587202;1,38
2011;"2518";"Kvinnor";0;20;678;698;0,0286532951289398;2,87
2011;"2521";"Män";0;36;1023;1059;0,0339943342776204;3,4
2011;"2521";"Kvinnor";0;22;995;1017;0,0216322517207473;2,16
2011;"2523";"Män";0;59;5113;5172;0,0114075792730085;1,14
2011;"2523";"Kvinnor";0;80;3593;3673;0,0217805608494419;2,18
2011;"2560";"Män";0;7;1373;1380;0,00507246376811594;0,51
2011;"2560";"Kvinnor";0;20;1276;1296;0,0154320987654321;1,54
2011;"2580";"Män";0;676;19538;20214;0,0334421687939052;3,34
2011;"2580";"Kvinnor";0;888;16132;17020;0,0521739130434783;5,22
2011;"2581";"Män";0;169;8066;8235;0,0205221615057681;2,05
2011;"2581";"Kvinnor";0;272;6922;7194;0,0378092855157075;3,78
2011;"2582";"Män";0;63;5270;5333;0,0118132383273955;1,18
2011;"2582";"Kvinnor";0;87;4721;4808;0,0180948419301165;1,81
2011;"2583";"Män";0;28;1455;1483;0,0188806473364801;1,89
2011;"2583";"Kvinnor";0;40;1589;1629;0,0245549416820135;2,46
2011;"2584";"Män";0;137;6812;6949;0,019715066916103;1,97
2011;"2584";"Kvinnor";0;286;5014;5300;0,0539622641509434;5,4
2011;"9999";"Män";0;1199;159044;160243;0,00748238612607103;0,75
2011;"9999";"Kvinnor";0;1408;174938;176346;0,00798430358499768;0,8
2012;"0114";"Män";0;177;6999;7176;0,0246655518394649;2,47
2012;"0114";"Kvinnor";0;233;6300;6533;0,0356650849533139;3,57
2012;"0115";"Män";0;119;3680;3799;0,0313240326401685;3,13
2012;"0115";"Kvinnor";0;115;3714;3829;0,0300339514233481;3
2012;"0117";"Män";0;163;4417;4580;0,035589519650655;3,56
2012;"0117";"Kvinnor";0;228;4416;4644;0,0490956072351421;4,91
2012;"0120";"Män";0;187;4910;5097;0,0366882479890131;3,67
2012;"0120";"Kvinnor";0;204;4640;4844;0,0421139554087531;4,21
2012;"0123";"Män";0;313;12371;12684;0,0246767581204667;2,47
2012;"0123";"Kvinnor";0;459;8795;9254;0,0496001728982062;4,96
2012;"0125";"Män";0;160;3811;3971;0,0402921178544447;4,03
2012;"0125";"Kvinnor";0;183;3429;3612;0,0506644518272425;5,07
2012;"0126";"Män";0;406;20527;20933;0,0193952132995748;1,94
2012;"0126";"Kvinnor";0;461;21062;21523;0,0214189471727919;2,14
2012;"0127";"Män";0;437;11480;11917;0,0366703029285894;3,67
2012;"0127";"Kvinnor";0;465;8919;9384;0,0495524296675192;4,96
2012;"0128";"Män";0;36;1089;1125;0,032;3,2
2012;"0128";"Kvinnor";0;43;1415;1458;0,0294924554183813;2,95
2012;"0136";"Män";0;203;13515;13718;0,014798075521213;1,48
2012;"0136";"Kvinnor";0;330;9995;10325;0,0319612590799031;3,2
2012;"0138";"Män";0;166;4976;5142;0,0322831583041618;3,23
2012;"0138";"Kvinnor";0;183;4597;4780;0,0382845188284519;3,83
2012;"0139";"Män";0;59;4806;4865;0,0121274409044193;1,21
2012;"0139";"Kvinnor";0;52;3039;3091;0,0168230346166289;1,68
2012;"0140";"Män";0;19;1273;1292;0,0147058823529412;1,47
2012;"0140";"Kvinnor";0;13;900;913;0,0142387732749179;1,42
2012;"0160";"Män";0;532;11089;11621;0,0457791928405473;4,58
2012;"0160";"Kvinnor";0;755;9919;10674;0,0707326213228405;7,07
2012;"0162";"Män";0;164;6378;6542;0,0250687863038826;2,51
2012;"0162";"Kvinnor";0;241;10357;10598;0,0227401396489904;2,27
2012;"0163";"Män";0;342;12595;12937;0,0264358042822911;2,64
2012;"0163";"Kvinnor";0;555;10974;11529;0,0481394743689826;4,81
2012;"0180";"Män";0;30716;281041;311757;0,098525454119715;9,85
2012;"0180";"Kvinnor";0;34452;256415;290867;0,118445887639368;11,84
2012;"0181";"Män";0;520;24359;24879;0,0209011616222517;2,09
2012;"0181";"Kvinnor";0;544;19252;19796;0,0274802990503132;2,75
2012;"0182";"Män";0;853;15942;16795;0,0507889252753796;5,08
2012;"0182";"Kvinnor";0;1333;14605;15938;0,0836365917931986;8,36
2012;"0183";"Män";0;362;9760;10122;0,0357636830665876;3,58
2012;"0183";"Kvinnor";0;276;8185;8461;0,0326202576527597;3,26
2012;"0184";"Män";0;1505;36412;37917;0,039691958752011;3,97
2012;"0184";"Kvinnor";0;1414;34252;35666;0,0396456008523524;3,96
2012;"0186";"Män";0;501;4773;5274;0,0949943117178612;9,5
2012;"0186";"Kvinnor";0;498;5507;6005;0,0829308909242298;8,29
2012;"0187";"Män";0;55;1042;1097;0,0501367365542388;5,01
2012;"0187";"Kvinnor";0;58;1249;1307;0,0443764345830145;4,44
2012;"0188";"Män";0;232;9569;9801;0,0236710539740843;2,37
2012;"0188";"Kvinnor";0;293;9741;10034;0,029200717560295;2,92
2012;"0191";"Män";0;169;15117;15286;0,0110558681146147;1,11
2012;"0191";"Kvinnor";0;261;11366;11627;0,0224477509245721;2,24
2012;"0192";"Män";0;76;3131;3207;0,0236981602743997;2,37
2012;"0192";"Kvinnor";0;97;3127;3224;0,0300868486352357;3,01
2012;"0305";"Män";0;32;2331;2363;0,0135421074904782;1,35
2012;"0305";"Kvinnor";0;67;2204;2271;0,0295024218405989;2,95
2012;"0319";"Män";0;12;1282;1294;0,00927357032457496;0,93
2012;"0319";"Kvinnor";0;22;1011;1033;0,021297192642788;2,13
2012;"0330";"Män";0;36;1704;1740;0,0206896551724138;2,07
2012;"0330";"Kvinnor";0;52;1627;1679;0,0309708159618821;3,1
2012;"0331";"Män";0;140;1646;1786;0,0783874580067189;7,84
2012;"0331";"Kvinnor";0;132;1633;1765;0,0747875354107649;7,48
2012;"0360";"Män";0;52;3344;3396;0,0153121319199058;1,53
2012;"0360";"Kvinnor";0;51;2536;2587;0,0197139543873212;1,97
2012;"0380";"Män";0;1862;41534;43396;0,042907180385289;4,29
2012;"0380";"Kvinnor";0;2335;44374;46709;0,0499903658823781;5
2012;"0381";"Män";0;117;7503;7620;0,0153543307086614;1,54
2012;"0381";"Kvinnor";0;204;6759;6963;0,029297716501508;2,93
2012;"0382";"Män";0;35;5161;5196;0,00673595073133179;0,67
2012;"0382";"Kvinnor";0;51;3837;3888;0,0131172839506173;1,31
2012;"0428";"Män";0;50;1333;1383;0,0361532899493854;3,62
2012;"0428";"Kvinnor";0;107;1179;1286;0,083203732503888;8,32
2012;"0461";"Män";0;35;1110;1145;0,0305676855895196;3,06
2012;"0461";"Kvinnor";0;45;1394;1439;0,0312717164697707;3,13
2012;"0480";"Män";0;296;10354;10650;0,0277934272300469;2,78
2012;"0480";"Kvinnor";0;463;10408;10871;0,0425903780700947;4,26
2012;"0481";"Män";0;30;3191;3221;0,00931387767773983;0,93
2012;"0481";"Kvinnor";0;32;1666;1698;0,0188457008244994;1,88
2012;"0482";"Män";0;33;2660;2693;0,0122539918306721;1,23
2012;"0482";"Kvinnor";0;48;2280;2328;0,0206185567010309;2,06
2012;"0483";"Män";0;361;6341;6702;0,0538645180543121;5,39
2012;"0483";"Kvinnor";0;288;5703;5991;0,0480721081622434;4,81
2012;"0484";"Män";0;580;19375;19955;0,029065397143573;2,91
2012;"0484";"Kvinnor";0;824;18217;19041;0,0432750380757313;4,33
2012;"0486";"Män";0;163;4996;5159;0,0315952704012405;3,16
2012;"0486";"Kvinnor";0;176;4826;5002;0,0351859256297481;3,52
2012;"0488";"Män";0;103;1579;1682;0,0612366230677765;6,12
2012;"0488";"Kvinnor";0;115;1613;1728;0,0665509259259259;6,66
2012;"0509";"Män";0;33;819;852;0,0387323943661972;3,87
2012;"0509";"Kvinnor";0;19;787;806;0,0235732009925558;2,36
2012;"0512";"Män";0;10;648;658;0,0151975683890578;1,52
2012;"0512";"Kvinnor";0;10;428;438;0,0228310502283105;2,28
2012;"0513";"Män";0;27;1677;1704;0,0158450704225352;1,58
2012;"0513";"Kvinnor";0;30;1458;1488;0,0201612903225806;2,02
2012;"0560";"Män";0;2;956;958;0,00208768267223382;0,21
2012;"0560";"Kvinnor";0;8;588;596;0,0134228187919463;1,34
2012;"0561";"Män";0;53;1602;1655;0,03202416918429;3,2
2012;"0561";"Kvinnor";0;54;1341;1395;0,0387096774193548;3,87
2012;"0562";"Män";0;38;5628;5666;0,00670667137310272;0,67
2012;"0562";"Kvinnor";0;46;3496;3542;0,012987012987013;1,3
2012;"0563";"Män";0;17;1418;1435;0,0118466898954704;1,18
2012;"0563";"Kvinnor";0;28;1047;1075;0,026046511627907;2,6
2012;"0580";"Män";0;958;37387;38345;0,024983700612857;2,5
2012;"0580";"Kvinnor";0;1198;32454;33652;0,0355996671817425;3,56
2012;"0581";"Män";0;1017;29023;30040;0,0338548601864181;3,39
2012;"0581";"Kvinnor";0;1305;26966;28271;0,046160376357398;4,62
2012;"0582";"Män";0;60;1897;1957;0,0306591722023505;3,07
2012;"0582";"Kvinnor";0;66;1655;1721;0,0383497966298664;3,83
2012;"0583";"Män";0;193;6719;6912;0,0279224537037037;2,79
2012;"0583";"Kvinnor";0;201;6568;6769;0,0296941941202541;2,97
2012;"0584";"Män";0;59;1562;1621;0,0363972856261567;3,64
2012;"0584";"Kvinnor";0;57;1322;1379;0,0413343002175489;4,13
2012;"0586";"Män";0;78;6205;6283;0,0124144516950501;1,24
2012;"0586";"Kvinnor";0;130;4123;4253;0,0305666588290618;3,06
2012;"0604";"Män";0;14;1351;1365;0,0102564102564103;1,03
2012;"0604";"Kvinnor";0;14;962;976;0,014344262295082;1,43
2012;"0617";"Män";0;52;3273;3325;0,0156390977443609;1,56
2012;"0617";"Kvinnor";0;59;2216;2275;0,0259340659340659;2,59
2012;"0642";"Män";0;18;1275;1293;0,0139211136890951;1,39
2012;"0642";"Kvinnor";0;52;1085;1137;0,0457343887423043;4,57
2012;"0643";"Män";0;35;1796;1831;0,0191152375750956;1,91
2012;"0643";"Kvinnor";0;30;1506;1536;0,01953125;1,95
2012;"0662";"Män";0;87;7670;7757;0,0112156761634653;1,12
2012;"0662";"Kvinnor";0;148;5754;5902;0,0250762453405625;2,51
2012;"0665";"Män";0;34;3059;3093;0,0109925638538636;1,1
2012;"0665";"Kvinnor";0;35;2108;2143;0,0163322445170322;1,63
2012;"0680";"Män";0;1135;32593;33728;0,0336515654648956;3,37
2012;"0680";"Kvinnor";0;1197;28795;29992;0,0399106428380902;3,99
2012;"0682";"Män";0;164;6328;6492;0,0252618607516944;2,53
2012;"0682";"Kvinnor";0;165;4972;5137;0,0321199143468951;3,21
2012;"0683";"Män";0;192;8168;8360;0,0229665071770335;2,3
2012;"0683";"Kvinnor";0;260;7464;7724;0,0336613153806318;3,37
2012;"0684";"Män";0;24;2323;2347;0,0102258201959949;1,02
2012;"0684";"Kvinnor";0;29;1688;1717;0,0168899242865463;1,69
2012;"0685";"Män";0;82;6468;6550;0,0125190839694656;1,25
2012;"0685";"Kvinnor";0;131;4706;4837;0,0270829026255944;2,71
2012;"0686";"Män";0;89;4158;4247;0,0209559689192371;2,1
2012;"0686";"Kvinnor";0;109;4032;4141;0,0263221444095629;2,63
2012;"0687";"Män";0;109;4117;4226;0,0257927117841931;2,58
2012;"0687";"Kvinnor";0;116;3383;3499;0,0331523292369248;3,32
2012;"0760";"Män";0;14;2442;2456;0,00570032573289902;0,57
2012;"0760";"Kvinnor";0;19;1794;1813;0,0104798676227248;1,05
2012;"0761";"Män";0;31;1302;1333;0,0232558139534884;2,33
2012;"0761";"Kvinnor";0;64;1233;1297;0,0493446414803392;4,93
2012;"0763";"Män";0;39;2856;2895;0,0134715025906736;1,35
2012;"0763";"Kvinnor";0;42;2294;2336;0,0179794520547945;1,8
2012;"0764";"Män";0;50;3907;3957;0,0126358352287086;1,26
2012;"0764";"Kvinnor";0;53;3024;3077;0,0172245693857654;1,72
2012;"0765";"Män";0;621;4200;4821;0,128811449906658;12,88
2012;"0765";"Kvinnor";0;679;3425;4104;0,165448343079922;16,54
2012;"0767";"Män";0;51;2834;2885;0,0176776429809359;1,77
2012;"0767";"Kvinnor";0;37;1831;1868;0,0198072805139186;1,98
2012;"0780";"Män";0;834;20760;21594;0,0386218393998333;3,86
2012;"0780";"Kvinnor";0;934;19271;20205;0,0462261816382084;4,62
2012;"0781";"Män";0;510;6505;7015;0,0727013542409123;7,27
2012;"0781";"Kvinnor";0;394;5314;5708;0,0690259285213735;6,9
2012;"0821";"Män";0;7;748;755;0,00927152317880795;0,93
2012;"0821";"Kvinnor";0;10;867;877;0,0114025085518814;1,14
2012;"0834";"Män";0;12;1224;1236;0,00970873786407767;0,97
2012;"0834";"Kvinnor";0;15;951;966;0,015527950310559;1,55
2012;"0840";"Män";0;43;2216;2259;0,0190349712262063;1,9
2012;"0840";"Kvinnor";0;87;2032;2119;0,0410571024067957;4,11
2012;"0860";"Män";0;33;2755;2788;0,0118364418938307;1,18
2012;"0860";"Kvinnor";0;21;2166;2187;0,00960219478737997;0,96
2012;"0861";"Män";0;19;2343;2362;0,00804403048264183;0,8
2012;"0861";"Kvinnor";0;33;1814;1847;0,0178668110449377;1,79
2012;"0862";"Män";0;48;2430;2478;0,0193704600484262;1,94
2012;"0862";"Kvinnor";0;29;1645;1674;0,0173237753882915;1,73
2012;"0880";"Män";0;627;14435;15062;0,0416279378568583;4,16
2012;"0880";"Kvinnor";0;861;14460;15321;0,0561973761503818;5,62
2012;"0881";"Män";0;45;4077;4122;0,0109170305676856;1,09
2012;"0881";"Kvinnor";0;90;3161;3251;0,027683789603199;2,77
2012;"0882";"Män";0;85;7352;7437;0,0114293397875487;1,14
2012;"0882";"Kvinnor";0;146;5529;5675;0,025726872246696;2,57
2012;"0883";"Män";0;133;7323;7456;0,017837982832618;1,78
2012;"0883";"Kvinnor";0;155;7069;7224;0,0214562569213732;2,15
2012;"0884";"Män";0;336;3728;4064;0,0826771653543307;8,27
2012;"0884";"Kvinnor";0;326;2741;3067;0,106292794261493;10,63
2012;"0885";"Män";0;64;1879;1943;0,0329387545033453;3,29
2012;"0885";"Kvinnor";0;81;1661;1742;0,0464982778415614;4,65
2012;"0980";"Män";0;462;11970;12432;0,0371621621621622;3,72
2012;"0980";"Kvinnor";0;558;11382;11940;0,0467336683417085;4,67
2012;"1060";"Män";0;33;3924;3957;0,00833965125094769;0,83
2012;"1060";"Kvinnor";0;53;2167;2220;0,0238738738738739;2,39
2012;"1080";"Män";0;446;14323;14769;0,0301983885164872;3,02
2012;"1080";"Kvinnor";0;497;12900;13397;0,0370978577293424;3,71
2012;"1081";"Män";0;109;5744;5853;0,0186229284127798;1,86
2012;"1081";"Kvinnor";0;139;4299;4438;0,0313204146011717;3,13
2012;"1082";"Män";0;190;5339;5529;0,0343642611683849;3,44
2012;"1082";"Kvinnor";0;292;5443;5735;0,0509154315605929;5,09
2012;"1083";"Män";0;83;2906;2989;0,0277684844429575;2,78
2012;"1083";"Kvinnor";0;78;2381;2459;0,0317202114680765;3,17
2012;"1214";"Män";0;28;1591;1619;0,0172946263125386;1,73
2012;"1214";"Kvinnor";0;32;1588;1620;0,0197530864197531;1,98
2012;"1230";"Män";0;70;3058;3128;0,0223785166240409;2,24
2012;"1230";"Kvinnor";0;57;2235;2292;0,024869109947644;2,49
2012;"1231";"Män";0;86;4720;4806;0,0178942987931752;1,79
2012;"1231";"Kvinnor";0;200;2775;2975;0,0672268907563025;6,72
2012;"1233";"Män";0;275;3298;3573;0,0769661349006437;7,7
2012;"1233";"Kvinnor";0;218;3684;3902;0,0558687852383393;5,59
2012;"1256";"Män";0;55;2215;2270;0,0242290748898678;2,42
2012;"1256";"Kvinnor";0;67;1612;1679;0,0399047051816557;3,99
2012;"1257";"Män";0;13;1837;1850;0,00702702702702703;0,7
2012;"1257";"Kvinnor";0;30;1539;1569;0,0191204588910134;1,91
2012;"1260";"Män";0;9;2447;2456;0,00366449511400651;0,37
2012;"1260";"Kvinnor";0;12;1903;1915;0,00626631853785901;0,63
2012;"1261";"Män";0;112;3269;3381;0,0331262939958592;3,31
2012;"1261";"Kvinnor";0;204;3268;3472;0,0587557603686636;5,88
2012;"1262";"Män";0;83;2185;2268;0,0365961199294533;3,66
2012;"1262";"Kvinnor";0;100;2591;2691;0,0371609067261241;3,72
2012;"1263";"Män";0;88;3377;3465;0,0253968253968254;2,54
2012;"1263";"Kvinnor";0;114;2666;2780;0,0410071942446043;4,1
2012;"1264";"Män";0;73;1830;1903;0,0383604834471886;3,84
2012;"1264";"Kvinnor";0;72;1660;1732;0,0415704387990762;4,16
2012;"1265";"Män";0;46;2789;2835;0,0162257495590829;1,62
2012;"1265";"Kvinnor";0;59;2339;2398;0,024603836530442;2,46
2012;"1266";"Män";0;36;2315;2351;0,0153126329221608;1,53
2012;"1266";"Kvinnor";0;53;2236;2289;0,0231542158147663;2,32
2012;"1267";"Män";0;51;1780;1831;0,0278536318951393;2,79
2012;"1267";"Kvinnor";0;65;2311;2376;0,0273569023569024;2,74
2012;"1270";"Män";0;84;2407;2491;0,0337213970293055;3,37
2012;"1270";"Kvinnor";0;85;1937;2022;0,0420375865479723;4,2
2012;"1272";"Män";0;31;2399;2430;0,0127572016460905;1,28
2012;"1272";"Kvinnor";0;40;1811;1851;0,0216099405726634;2,16
2012;"1273";"Män";0;31;2189;2220;0,013963963963964;1,4
2012;"1273";"Kvinnor";0;44;1809;1853;0,0237452779276848;2,37
2012;"1275";"Män";0;11;1745;1756;0,00626423690205011;0,63
2012;"1275";"Kvinnor";0;14;1138;1152;0,0121527777777778;1,22
2012;"1276";"Män";0;48;2715;2763;0,0173724212812161;1,74
2012;"1276";"Kvinnor";0;50;2190;2240;0,0223214285714286;2,23
2012;"1277";"Män";0;23;2787;2810;0,00818505338078292;0,82
2012;"1277";"Kvinnor";0;130;2391;2521;0,0515668385561285;5,16
2012;"1278";"Män";0;106;3065;3171;0,0334279407127089;3,34
2012;"1278";"Kvinnor";0;156;2634;2790;0,0559139784946237;5,59
2012;"1280";"Män";0;5166;74935;80101;0,0644935768592152;6,45
2012;"1280";"Kvinnor";0;5231;67470;72701;0,0719522427476926;7,2
2012;"1281";"Män";0;866;31037;31903;0,0271447826223239;2,71
2012;"1281";"Kvinnor";0;1266;29789;31055;0,0407663822250845;4,08
2012;"1282";"Män";0;290;7010;7300;0,0397260273972603;3,97
2012;"1282";"Kvinnor";0;250;5912;6162;0,0405712431028887;4,06
2012;"1283";"Män";0;1919;30522;32441;0,0591535402731112;5,92
2012;"1283";"Kvinnor";0;2322;27551;29873;0,0777290529909952;7,77
2012;"1284";"Män";0;114;3529;3643;0,0312928904748833;3,13
2012;"1284";"Kvinnor";0;168;3442;3610;0,0465373961218837;4,65
2012;"1285";"Män";0;143;5162;5305;0,0269557021677663;2,7
2012;"1285";"Kvinnor";0;158;4487;4645;0,0340150699677072;3,4
2012;"1286";"Män";0;201;5118;5319;0,0377890580936266;3,78
2012;"1286";"Kvinnor";0;271;5568;5839;0,0464120568590512;4,64
2012;"1287";"Män";0;97;6138;6235;0,0155573376102646;1,56
2012;"1287";"Kvinnor";0;213;6050;6263;0,0340092607376657;3,4
2012;"1290";"Män";0;498;16489;16987;0,0293165361747218;2,93
2012;"1290";"Kvinnor";0;652;16905;17557;0,0371361849974369;3,71
2012;"1291";"Män";0;108;3241;3349;0,032248432367871;3,22
2012;"1291";"Kvinnor";0;151;3129;3280;0,0460365853658537;4,6
2012;"1292";"Män";0;173;7511;7684;0,0225143154606976;2,25
2012;"1292";"Kvinnor";0;314;7993;8307;0,0377994462501505;3,78
2012;"1293";"Män";0;216;9653;9869;0,0218867159793292;2,19
2012;"1293";"Kvinnor";0;246;8419;8665;0,0283900750144259;2,84
2012;"1315";"Män";0;34;2472;2506;0,0135674381484437;1,36
2012;"1315";"Kvinnor";0;40;1832;1872;0,0213675213675214;2,14
2012;"1380";"Män";0;805;21458;22263;0,0361586488793065;3,62
2012;"1380";"Kvinnor";0;1058;19874;20932;0,0505446206764762;5,05
2012;"1381";"Män";0;154;3961;4115;0,0374240583232078;3,74
2012;"1381";"Kvinnor";0;149;3470;3619;0,0411715943630837;4,12
2012;"1382";"Män";0;282;9199;9481;0,0297436979221601;2,97
2012;"1382";"Kvinnor";0;386;8029;8415;0,0458704693998812;4,59
2012;"1383";"Män";0;460;13317;13777;0,0333889816360601;3,34
2012;"1383";"Kvinnor";0;785;11801;12586;0,0623708882885746;6,24
2012;"1384";"Män";0;502;9851;10353;0,048488360861586;4,85
2012;"1384";"Kvinnor";0;866;10846;11712;0,0739412568306011;7,39
2012;"1401";"Män";0;370;6303;6673;0,0554473250412109;5,54
2012;"1401";"Kvinnor";0;204;5734;5938;0,0343550016840687;3,44
2012;"1402";"Män";0;247;5435;5682;0,0434706089405139;4,35
2012;"1402";"Kvinnor";0;413;4707;5120;0,0806640625;8,07
2012;"1407";"Män";0;21;1540;1561;0,0134529147982063;1,35
2012;"1407";"Kvinnor";0;45;1491;1536;0,029296875;2,93
2012;"1415";"Män";0;92;6386;6478;0,0142019141710404;1,42
2012;"1415";"Kvinnor";0;207;4266;4473;0,0462776659959759;4,63
2012;"1419";"Män";0;35;2166;2201;0,0159018627896411;1,59
2012;"1419";"Kvinnor";0;66;2131;2197;0,0300409649522076;3
2012;"1421";"Män";0;26;2392;2418;0,010752688172043;1,08
2012;"1421";"Kvinnor";0;40;2029;2069;0,0193330111164814;1,93
2012;"1427";"Män";0;33;1904;1937;0,0170366546205472;1,7
2012;"1427";"Kvinnor";0;53;1723;1776;0,0298423423423423;2,98
2012;"1430";"Män";0;67;1816;1883;0,0355815188528943;3,56
2012;"1430";"Kvinnor";0;54;1605;1659;0,0325497287522604;3,25
2012;"1435";"Män";0;79;2410;2489;0,0317396544797107;3,17
2012;"1435";"Kvinnor";0;105;1956;2061;0,0509461426491994;5,09
2012;"1438";"Män";0;9;1029;1038;0,00867052023121387;0,87
2012;"1438";"Kvinnor";0;12;761;773;0,0155239327296248;1,55
2012;"1439";"Män";0;13;959;972;0,0133744855967078;1,34
2012;"1439";"Kvinnor";0;13;841;854;0,0152224824355972;1,52
2012;"1440";"Män";0;67;3088;3155;0,0212361331220285;2,12
2012;"1440";"Kvinnor";0;86;3116;3202;0,0268582136164897;2,69
2012;"1441";"Män";0;160;3826;3986;0,0401404917210236;4,01
2012;"1441";"Kvinnor";0;184;4476;4660;0,0394849785407725;3,95
2012;"1442";"Män";0;38;2443;2481;0,0153164046755341;1,53
2012;"1442";"Kvinnor";0;34;1706;1740;0,0195402298850575;1,95
2012;"1443";"Män";0;64;1178;1242;0,0515297906602254;5,15
2012;"1443";"Kvinnor";0;49;996;1045;0,0468899521531101;4,69
2012;"1444";"Män";0;2;774;776;0,00257731958762887;0,26
2012;"1444";"Kvinnor";0;13;732;745;0,0174496644295302;1,74
2012;"1445";"Män";0;47;1034;1081;0,0434782608695652;4,35
2012;"1445";"Kvinnor";0;47;806;853;0,0550996483001172;5,51
2012;"1446";"Män";0;25;1678;1703;0,0146799765120376;1,47
2012;"1446";"Kvinnor";0;25;1155;1180;0,0211864406779661;2,12
2012;"1447";"Män";0;5;1000;1005;0,00497512437810945;0,5
2012;"1447";"Kvinnor";0;9;758;767;0,0117340286831812;1,17
2012;"1452";"Män";0;78;3296;3374;0,023117960877297;2,31
2012;"1452";"Kvinnor";0;118;2100;2218;0,0532010820559062;5,32
2012;"1460";"Män";0;40;1941;1981;0,0201918223119637;2,02
2012;"1460";"Kvinnor";0;73;1701;1774;0,0411499436302142;4,11
2012;"1461";"Män";0;13;1427;1440;0,00902777777777778;0,9
2012;"1461";"Kvinnor";0;47;1337;1384;0,0339595375722543;3,4
2012;"1462";"Män";0;25;1800;1825;0,0136986301369863;1,37
2012;"1462";"Kvinnor";0;29;1778;1807;0,0160486995019369;1,6
2012;"1463";"Män";0;186;5217;5403;0,0344253192670738;3,44
2012;"1463";"Kvinnor";0;255;5143;5398;0,0472397184142275;4,72
2012;"1465";"Män";0;226;1681;1907;0,118510749868904;11,85
2012;"1465";"Kvinnor";0;144;1501;1645;0,0875379939209726;8,75
2012;"1466";"Män";0;17;2089;2106;0,00807217473884141;0,81
2012;"1466";"Kvinnor";0;15;1497;1512;0,00992063492063492;0,99
2012;"1470";"Män";0;62;4531;4593;0,0134988025255824;1,35
2012;"1470";"Kvinnor";0;71;2699;2770;0,0256317689530686;2,56
2012;"1471";"Män";0;25;3174;3199;0,00781494216942795;0,78
2012;"1471";"Kvinnor";0;35;2288;2323;0,0150667240637107;1,51
2012;"1472";"Män";0;25;1828;1853;0,0134916351861846;1,35
2012;"1472";"Kvinnor";0;20;1597;1617;0,0123685837971552;1,24
2012;"1473";"Män";0;15;1619;1634;0,00917992656058752;0,92
2012;"1473";"Kvinnor";0;26;1302;1328;0,019578313253012;1,96
2012;"1480";"Män";0;7537;154623;162160;0,0464787863838185;4,65
2012;"1480";"Kvinnor";0;9155;134147;143302;0,0638860588128568;6,39
2012;"1481";"Män";0;690;17461;18151;0,0380144344664206;3,8
2012;"1481";"Kvinnor";0;962;15805;16767;0,0573746048786306;5,74
2012;"1482";"Män";0;244;7509;7753;0,0314716883786921;3,15
2012;"1482";"Kvinnor";0;224;7088;7312;0,0306345733041575;3,06
2012;"1484";"Män";0;64;3078;3142;0,0203691915977085;2,04
2012;"1484";"Kvinnor";0;86;2430;2516;0,034181240063593;3,42
2012;"1485";"Män";0;340;10475;10815;0,0314378178455848;3,14
2012;"1485";"Kvinnor";0;600;10775;11375;0,0527472527472527;5,27
2012;"1486";"Män";0;117;2823;2940;0,0397959183673469;3,98
2012;"1486";"Kvinnor";0;338;2822;3160;0,106962025316456;10,7
2012;"1487";"Män";0;142;5698;5840;0,0243150684931507;2,43
2012;"1487";"Kvinnor";0;161;6059;6220;0,0258842443729904;2,59
2012;"1488";"Män";0;235;12400;12635;0,0185991294024535;1,86
2012;"1488";"Kvinnor";0;457;11902;12359;0,0369771017072579;3,7
2012;"1489";"Män";0;202;5923;6125;0,0329795918367347;3,3
2012;"1489";"Kvinnor";0;293;6766;7059;0,0415072956509421;4,15
2012;"1490";"Män";0;2023;23691;25714;0,0786730963677374;7,87
2012;"1490";"Kvinnor";0;2603;22536;25139;0,103544293726879;10,35
2012;"1491";"Män";0;266;4245;4511;0,0589669696297938;5,9
2012;"1491";"Kvinnor";0;371;3390;3761;0,0986439776655145;9,86
2012;"1492";"Män";0;46;2117;2163;0,0212667591308368;2,13
2012;"1492";"Kvinnor";0;72;1917;1989;0,0361990950226244;3,62
2012;"1493";"Män";0;92;4289;4381;0,0209997717416115;2,1
2012;"1493";"Kvinnor";0;98;4092;4190;0,0233890214797136;2,34
2012;"1494";"Män";0;239;8454;8693;0,0274933854825722;2,75
2012;"1494";"Kvinnor";0;286;7320;7606;0,0376018932421772;3,76
2012;"1495";"Män";0;116;3988;4104;0,0282651072124756;2,83
2012;"1495";"Kvinnor";0;134;3690;3824;0,0350418410041841;3,5
2012;"1496";"Män";0;323;15869;16192;0,0199481225296443;1,99
2012;"1496";"Kvinnor";0;475;13158;13633;0,0348419276754933;3,48
2012;"1497";"Män";0;23;1260;1283;0,0179267342166797;1,79
2012;"1497";"Kvinnor";0;34;1328;1362;0,0249632892804699;2,5
2012;"1498";"Män";0;45;2296;2341;0,0192225544639043;1,92
2012;"1498";"Kvinnor";0;60;1837;1897;0,0316288877174486;3,16
2012;"1499";"Män";0;192;6336;6528;0,0294117647058824;2,94
2012;"1499";"Kvinnor";0;181;5504;5685;0,0318381706244503;3,18
2012;"1715";"Män";0;30;1670;1700;0,0176470588235294;1,76
2012;"1715";"Kvinnor";0;32;1356;1388;0,0230547550432277;2,31
2012;"1730";"Män";0;21;1434;1455;0,0144329896907217;1,44
2012;"1730";"Kvinnor";0;118;1628;1746;0,0675830469644903;6,76
2012;"1737";"Män";0;37;2382;2419;0,0152955766845804;1,53
2012;"1737";"Kvinnor";0;53;2392;2445;0,0216768916155419;2,17
2012;"1760";"Män";0;1;577;578;0,00173010380622837;0,17
2012;"1760";"Kvinnor";0;4;473;477;0,00838574423480084;0,84
2012;"1761";"Män";0;31;1940;1971;0,0157280568239472;1,57
2012;"1761";"Kvinnor";0;41;1741;1782;0,0230078563411897;2,3
2012;"1762";"Män";0;25;773;798;0,031328320802005;3,13
2012;"1762";"Kvinnor";0;30;619;649;0,0462249614791988;4,62
2012;"1763";"Män";0;19;1051;1070;0,0177570093457944;1,78
2012;"1763";"Kvinnor";0;26;1232;1258;0,0206677265500795;2,07
2012;"1764";"Män";0;12;1728;1740;0,00689655172413793;0,69
2012;"1764";"Kvinnor";0;13;1144;1157;0,0112359550561798;1,12
2012;"1765";"Män";0;38;1853;1891;0,0200951877313591;2,01
2012;"1765";"Kvinnor";0;102;1752;1854;0,0550161812297735;5,5
2012;"1766";"Män";0;169;2511;2680;0,0630597014925373;6,31
2012;"1766";"Kvinnor";0;131;2166;2297;0,0570309098824554;5,7
2012;"1780";"Män";0;843;22782;23625;0,0356825396825397;3,57
2012;"1780";"Kvinnor";0;1051;21376;22427;0,0468631560173006;4,69
2012;"1781";"Män";0;58;4482;4540;0,0127753303964758;1,28
2012;"1781";"Kvinnor";0;97;3324;3421;0,028354282373575;2,84
2012;"1782";"Män";0;18;1887;1905;0,0094488188976378;0,94
2012;"1782";"Kvinnor";0;23;1687;1710;0,0134502923976608;1,35
2012;"1783";"Män";0;14;2445;2459;0,00569337128914193;0,57
2012;"1783";"Kvinnor";0;33;1795;1828;0,0180525164113786;1,81
2012;"1784";"Män";0;78;5080;5158;0,0151221403644824;1,51
2012;"1784";"Kvinnor";0;133;4424;4557;0,0291858678955453;2,92
2012;"1785";"Män";0;36;3168;3204;0,0112359550561798;1,12
2012;"1785";"Kvinnor";0;60;2170;2230;0,0269058295964126;2,69
2012;"1814";"Män";0;8;886;894;0,00894854586129754;0,89
2012;"1814";"Kvinnor";0;11;825;836;0,0131578947368421;1,32
2012;"1860";"Män";0;14;1369;1383;0,0101229211858279;1,01
2012;"1860";"Kvinnor";0;14;920;934;0,0149892933618844;1,5
2012;"1861";"Män";0;79;3836;3915;0,0201787994891443;2,02
2012;"1861";"Kvinnor";0;60;2730;2790;0,021505376344086;2,15
2012;"1862";"Män";0;7;1449;1456;0,00480769230769231;0,48
2012;"1862";"Kvinnor";0;23;1126;1149;0,0200174064403829;2
2012;"1863";"Män";0;12;1362;1374;0,00873362445414847;0,87
2012;"1863";"Kvinnor";0;29;1025;1054;0,0275142314990512;2,75
2012;"1864";"Män";0;5;765;770;0,00649350649350649;0,65
2012;"1864";"Kvinnor";0;8;700;708;0,0112994350282486;1,13
2012;"1880";"Män";0;1235;33362;34597;0,0356967367112755;3,57
2012;"1880";"Kvinnor";0;1534;31292;32826;0,0467312496192043;4,67
2012;"1881";"Män";0;109;3474;3583;0,0304214345520514;3,04
2012;"1881";"Kvinnor";0;86;3189;3275;0,0262595419847328;2,63
2012;"1882";"Män";0;27;1954;1981;0,0136294800605755;1,36
2012;"1882";"Kvinnor";0;47;1462;1509;0,0311464546056991;3,11
2012;"1883";"Män";0;139;7122;7261;0,0191433686819997;1,91
2012;"1883";"Kvinnor";0;187;6320;6507;0,028738281850315;2,87
2012;"1884";"Män";0;33;1482;1515;0,0217821782178218;2,18
2012;"1884";"Kvinnor";0;41;1384;1425;0,0287719298245614;2,88
2012;"1885";"Män";0;68;4913;4981;0,0136518771331058;1,37
2012;"1885";"Kvinnor";0;74;4396;4470;0,0165548098434004;1,66
2012;"1904";"Män";0;14;802;816;0,017156862745098;1,72
2012;"1904";"Kvinnor";0;8;609;617;0,0129659643435981;1,3
2012;"1907";"Män";0;14;1544;1558;0,00898587933247754;0,9
2012;"1907";"Kvinnor";0;23;1165;1188;0,0193602693602694;1,94
2012;"1960";"Män";0;6;1145;1151;0,0052128583840139;0,52
2012;"1960";"Kvinnor";0;15;968;983;0,0152594099694812;1,53
2012;"1961";"Män";0;28;2399;2427;0,011536876802637;1,15
2012;"1961";"Kvinnor";0;24;2259;2283;0,0105124835742444;1,05
2012;"1962";"Män";0;16;782;798;0,0200501253132832;2,01
2012;"1962";"Kvinnor";0;17;637;654;0,0259938837920489;2,6
2012;"1980";"Män";0;1147;33476;34623;0,0331282673367415;3,31
2012;"1980";"Kvinnor";0;1562;28859;30421;0,0513461095953453;5,13
2012;"1981";"Män";0;83;3588;3671;0,0226096431490057;2,26
2012;"1981";"Kvinnor";0;147;3336;3483;0,0422049956933678;4,22
2012;"1982";"Män";0;31;3436;3467;0,0089414479376983;0,89
2012;"1982";"Kvinnor";0;46;2697;2743;0,016769959897922;1,68
2012;"1983";"Män";0;77;5477;5554;0,0138638818869283;1,39
2012;"1983";"Kvinnor";0;119;4442;4561;0,0260907695680772;2,61
2012;"1984";"Män";0;23;2742;2765;0,00831826401446655;0,83
2012;"1984";"Kvinnor";0;38;2250;2288;0,0166083916083916;1,66
2012;"2021";"Män";0;12;1290;1302;0,00921658986175115;0,92
2012;"2021";"Kvinnor";0;22;1048;1070;0,0205607476635514;2,06
2012;"2023";"Män";0;56;2711;2767;0,020238525478858;2,02
2012;"2023";"Kvinnor";0;68;2461;2529;0,0268880980624753;2,69
2012;"2026";"Män";0;19;1187;1206;0,0157545605306799;1,58
2012;"2026";"Kvinnor";0;15;1250;1265;0,0118577075098814;1,19
2012;"2029";"Män";0;90;3168;3258;0,0276243093922652;2,76
2012;"2029";"Kvinnor";0;104;2725;2829;0,0367621067515023;3,68
2012;"2031";"Män";0;67;1684;1751;0,038263849229012;3,83
2012;"2031";"Kvinnor";0;69;1557;1626;0,0424354243542435;4,24
2012;"2034";"Män";0;31;985;1016;0,030511811023622;3,05
2012;"2034";"Kvinnor";0;20;872;892;0,0224215246636771;2,24
2012;"2039";"Män";0;15;1355;1370;0,0109489051094891;1,09
2012;"2039";"Kvinnor";0;22;1259;1281;0,0171740827478532;1,72
2012;"2061";"Män";0;24;1768;1792;0,0133928571428571;1,34
2012;"2061";"Kvinnor";0;29;1197;1226;0,0236541598694943;2,37
2012;"2062";"Män";0;100;4823;4923;0,0203128173877717;2,03
2012;"2062";"Kvinnor";0;148;4381;4529;0,0326782954294546;3,27
2012;"2080";"Män";0;713;11236;11949;0,0596702652941669;5,97
2012;"2080";"Kvinnor";0;684;12384;13068;0,0523415977961433;5,23
2012;"2081";"Män";0;238;14050;14288;0,0166573348264278;1,67
2012;"2081";"Kvinnor";0;428;10168;10596;0,0403926009815025;4,04
2012;"2082";"Män";0;21;1565;1586;0,0132408575031526;1,32
2012;"2082";"Kvinnor";0;30;1592;1622;0,0184956843403206;1,85
2012;"2083";"Män";0;68;3252;3320;0,0204819277108434;2,05
2012;"2083";"Kvinnor";0;63;2689;2752;0,0228924418604651;2,29
2012;"2084";"Män";0;89;5172;5261;0,0169169359437369;1,69
2012;"2084";"Kvinnor";0;128;3856;3984;0,0321285140562249;3,21
2012;"2085";"Män";0;87;6407;6494;0,013396981829381;1,34
2012;"2085";"Kvinnor";0;109;5101;5210;0,0209213051823416;2,09
2012;"2101";"Män";0;10;946;956;0,0104602510460251;1,05
2012;"2101";"Kvinnor";0;15;905;920;0,016304347826087;1,63
2012;"2104";"Män";0;14;2103;2117;0,00661313179026925;0,66
2012;"2104";"Kvinnor";0;24;1535;1559;0,0153944836433611;1,54
2012;"2121";"Män";0;23;2758;2781;0,00827040632865876;0,83
2012;"2121";"Kvinnor";0;43;1845;1888;0,0227754237288136;2,28
2012;"2132";"Män";0;9;1408;1417;0,0063514467184192;0,64
2012;"2132";"Kvinnor";0;11;1211;1222;0,00900163666121113;0,9
2012;"2161";"Män";0;131;3751;3882;0,0337454920144256;3,37
2012;"2161";"Kvinnor";0;213;3187;3400;0,0626470588235294;6,26
2012;"2180";"Män";0;710;20900;21610;0,032855159648311;3,29
2012;"2180";"Kvinnor";0;954;19285;20239;0,047136716240921;4,71
2012;"2181";"Män";0;95;9376;9471;0,0100306197867173;1
2012;"2181";"Kvinnor";0;139;6475;6614;0,0210160266102207;2,1
2012;"2182";"Män";0;125;4930;5055;0,0247279920870425;2,47
2012;"2182";"Kvinnor";0;170;4088;4258;0,0399248473461719;3,99
2012;"2183";"Män";0;139;4993;5132;0,0270849571317225;2,71
2012;"2183";"Kvinnor";0;198;5000;5198;0,0380915736821855;3,81
2012;"2184";"Män";0;183;8117;8300;0,0220481927710843;2,2
2012;"2184";"Kvinnor";0;252;7160;7412;0,0339989206691851;3,4
2012;"2260";"Män";0;45;2069;2114;0,021286660359508;2,13
2012;"2260";"Kvinnor";0;61;1654;1715;0,0355685131195335;3,56
2012;"2262";"Män";0;35;2852;2887;0,0121233113959127;1,21
2012;"2262";"Kvinnor";0;27;1985;2012;0,0134194831013916;1,34
2012;"2280";"Män";0;164;4420;4584;0,0357766143106457;3,58
2012;"2280";"Kvinnor";0;242;4427;4669;0,0518312272435211;5,18
2012;"2281";"Män";0;671;23402;24073;0,0278735512815187;2,79
2012;"2281";"Kvinnor";0;952;20823;21775;0,0437198622273249;4,37
2012;"2282";"Män";0;39;3772;3811;0,0102335345053792;1,02
2012;"2282";"Kvinnor";0;49;3063;3112;0,015745501285347;1,57
2012;"2283";"Män";0;101;3636;3737;0,027027027027027;2,7
2012;"2283";"Kvinnor";0;111;3393;3504;0,0316780821917808;3,17
2012;"2284";"Män";0;227;12770;12997;0,0174655689774563;1,75
2012;"2284";"Kvinnor";0;334;10583;10917;0,0305944856645599;3,06
2012;"2303";"Män";0;5;1137;1142;0,00437828371278459;0,44
2012;"2303";"Kvinnor";0;10;967;977;0,0102354145342886;1,02
2012;"2305";"Män";0;10;987;997;0,0100300902708124;1
2012;"2305";"Kvinnor";0;15;920;935;0,0160427807486631;1,6
2012;"2309";"Män";0;23;2179;2202;0,0104450499545867;1,04
2012;"2309";"Kvinnor";0;18;1971;1989;0,00904977375565611;0,9
2012;"2313";"Män";0;17;2477;2494;0,00681635926222935;0,68
2012;"2313";"Kvinnor";0;38;2032;2070;0,0183574879227053;1,84
2012;"2321";"Män";0;91;2415;2506;0,0363128491620112;3,63
2012;"2321";"Kvinnor";0;101;2268;2369;0,042634022794428;4,26
2012;"2326";"Män";0;12;1253;1265;0,00948616600790514;0,95
2012;"2326";"Kvinnor";0;9;1146;1155;0,00779220779220779;0,78
2012;"2361";"Män";0;31;2346;2377;0,0130416491375684;1,3
2012;"2361";"Kvinnor";0;32;2047;2079;0,0153920153920154;1,54
2012;"2380";"Män";0;647;14630;15277;0,0423512469725731;4,24
2012;"2380";"Kvinnor";0;681;14914;15595;0,0436678422571337;4,37
2012;"2401";"Män";0;13;1059;1072;0,0121268656716418;1,21
2012;"2401";"Kvinnor";0;21;972;993;0,0211480362537764;2,11
2012;"2403";"Män";0;2;300;302;0,00662251655629139;0,66
2012;"2403";"Kvinnor";0;5;305;310;0,0161290322580645;1,61
2012;"2404";"Män";0;12;1273;1285;0,00933852140077821;0,93
2012;"2404";"Kvinnor";0;18;906;924;0,0194805194805195;1,95
2012;"2409";"Män";0;11;1081;1092;0,0100732600732601;1,01
2012;"2409";"Kvinnor";0;9;1049;1058;0,00850661625708885;0,85
2012;"2417";"Män";0;13;900;913;0,0142387732749179;1,42
2012;"2417";"Kvinnor";0;34;756;790;0,0430379746835443;4,3
2012;"2418";"Män";0;7;648;655;0,0106870229007634;1,07
2012;"2418";"Kvinnor";0;17;572;589;0,0288624787775891;2,89
2012;"2421";"Män";0;13;1254;1267;0,0102604577742699;1,03
2012;"2421";"Kvinnor";0;16;1125;1141;0,014022787028922;1,4
2012;"2422";"Män";0;1;524;525;0,0019047619047619;0,19
2012;"2422";"Kvinnor";0;7;473;480;0,0145833333333333;1,46
2012;"2425";"Män";0;2;509;511;0,00391389432485323;0,39
2012;"2425";"Kvinnor";0;7;478;485;0,0144329896907217;1,44
2012;"2460";"Män";0;4;1266;1270;0,0031496062992126;0,31
2012;"2460";"Kvinnor";0;11;1080;1091;0,0100824931255729;1,01
2012;"2462";"Män";0;36;1116;1152;0,03125;3,12
2012;"2462";"Kvinnor";0;35;1137;1172;0,0298634812286689;2,99
2012;"2463";"Män";0;2;465;467;0,00428265524625268;0,43
2012;"2463";"Kvinnor";0;8;453;461;0,017353579175705;1,74
2012;"2480";"Män";0;977;28774;29751;0,0328392322947128;3,28
2012;"2480";"Kvinnor";0;1101;26823;27924;0,0394284486463257;3,94
2012;"2481";"Män";0;43;2828;2871;0,014977359804946;1,5
2012;"2481";"Kvinnor";0;63;2623;2686;0,0234549516008935;2,35
2012;"2482";"Män";0;381;16466;16847;0,0226153024277319;2,26
2012;"2482";"Kvinnor";0;489;13616;14105;0,0346685572492024;3,47
2012;"2505";"Män";0;16;1359;1375;0,0116363636363636;1,16
2012;"2505";"Kvinnor";0;34;1224;1258;0,027027027027027;2,7
2012;"2506";"Män";0;7;782;789;0,00887198986058302;0,89
2012;"2506";"Kvinnor";0;13;630;643;0,0202177293934681;2,02
2012;"2510";"Män";0;22;1112;1134;0,0194003527336861;1,94
2012;"2510";"Kvinnor";0;42;840;882;0,0476190476190476;4,76
2012;"2513";"Män";0;0;707;707;0;0
2012;"2513";"Kvinnor";0;20;622;642;0,0311526479750779;3,12
2012;"2514";"Män";0;65;3283;3348;0,0194145758661888;1,94
2012;"2514";"Kvinnor";0;104;2898;3002;0,0346435709526982;3,46
2012;"2518";"Män";0;9;794;803;0,0112079701120797;1,12
2012;"2518";"Kvinnor";0;15;686;701;0,021398002853067;2,14
2012;"2521";"Män";0;36;1071;1107;0,032520325203252;3,25
2012;"2521";"Kvinnor";0;21;1016;1037;0,0202507232401157;2,03
2012;"2523";"Män";0;56;5174;5230;0,0107074569789675;1,07
2012;"2523";"Kvinnor";0;80;3875;3955;0,0202275600505689;2,02
2012;"2560";"Män";0;6;1455;1461;0,00410677618069815;0,41
2012;"2560";"Kvinnor";0;22;1344;1366;0,0161054172767204;1,61
2012;"2580";"Män";0;690;20185;20875;0,0330538922155689;3,31
2012;"2580";"Kvinnor";0;882;16810;17692;0,0498530409224508;4,99
2012;"2581";"Män";0;174;8273;8447;0,0205990292411507;2,06
2012;"2581";"Kvinnor";0;284;7139;7423;0,0382594638286407;3,83
2012;"2582";"Män";0;70;5149;5219;0,013412531136233;1,34
2012;"2582";"Kvinnor";0;90;4616;4706;0,0191245218869528;1,91
2012;"2583";"Män";0;31;1577;1608;0,0192786069651741;1,93
2012;"2583";"Kvinnor";0;34;1593;1627;0,0208973570989551;2,09
2012;"2584";"Män";0;145;7032;7177;0,0202034276159955;2,02
2012;"2584";"Kvinnor";0;321;5279;5600;0,0573214285714286;5,73
2012;"9999";"Män";0;1221;159886;161107;0,00757881408008342;0,76
2012;"9999";"Kvinnor";0;1704;175415;177119;0,00962065052309464;0,96
2013;"0114";"Män";0;188;7317;7505;0,0250499666888741;2,5
2013;"0114";"Kvinnor";0;235;6386;6621;0,0354931279262951;3,55
2013;"0115";"Män";0;131;3801;3932;0,0333163784333672;3,33
2013;"0115";"Kvinnor";0;113;3733;3846;0,0293811752470099;2,94
2013;"0117";"Män";0;167;4476;4643;0,0359681240577213;3,6
2013;"0117";"Kvinnor";0;204;4594;4798;0,0425177157148812;4,25
2013;"0120";"Män";0;198;5058;5256;0,0376712328767123;3,77
2013;"0120";"Kvinnor";0;227;4846;5073;0,0447466982061896;4,47
2013;"0123";"Män";0;332;12805;13137;0,0252721321458476;2,53
2013;"0123";"Kvinnor";0;477;8873;9350;0,0510160427807487;5,1
2013;"0125";"Män";0;132;3913;4045;0,0326328800988875;3,26
2013;"0125";"Kvinnor";0;139;3567;3706;0,0375067458175931;3,75
2013;"0126";"Män";0;443;20624;21067;0,0210281482887929;2,1
2013;"0126";"Kvinnor";0;487;21112;21599;0,0225473401546368;2,25
2013;"0127";"Män";0;411;11638;12049;0,034110714582123;3,41
2013;"0127";"Kvinnor";0;450;8931;9381;0,0479692996482251;4,8
2013;"0128";"Män";0;33;1101;1134;0,0291005291005291;2,91
2013;"0128";"Kvinnor";0;41;1441;1482;0,0276653171390014;2,77
2013;"0136";"Män";0;230;13953;14183;0,0162165973348375;1,62
2013;"0136";"Kvinnor";0;333;10299;10632;0,0313205417607223;3,13
2013;"0138";"Män";0;193;4998;5191;0,0371797341552687;3,72
2013;"0138";"Kvinnor";0;197;4520;4717;0,0417638329446682;4,18
2013;"0139";"Män";0;53;4667;4720;0,011228813559322;1,12
2013;"0139";"Kvinnor";0;57;3044;3101;0,018381167365366;1,84
2013;"0140";"Män";0;22;1279;1301;0,0169100691775557;1,69
2013;"0140";"Kvinnor";0;15;902;917;0,0163576881134133;1,64
2013;"0160";"Män";0;513;11192;11705;0,0438274241777018;4,38
2013;"0160";"Kvinnor";0;776;10107;10883;0,0713038684186346;7,13
2013;"0162";"Män";0;174;6645;6819;0,0255169379674439;2,55
2013;"0162";"Kvinnor";0;265;10634;10899;0,0243141572621341;2,43
2013;"0163";"Män";0;318;12839;13157;0,0241696435357604;2,42
2013;"0163";"Kvinnor";0;497;11332;11829;0,0420153859159692;4,2
2013;"0180";"Män";0;30910;288696;319606;0,0967128276690675;9,67
2013;"0180";"Kvinnor";0;34616;261471;296087;0,116911583419738;11,69
2013;"0181";"Män";0;529;24636;25165;0,0210212596860719;2,1
2013;"0181";"Kvinnor";0;545;18874;19419;0,0280652968741954;2,81
2013;"0182";"Män";0;898;15366;16264;0,0552139695031972;5,52
2013;"0182";"Kvinnor";0;1339;14551;15890;0,0842668344870988;8,43
2013;"0183";"Män";0;277;10050;10327;0,0268228914495981;2,68
2013;"0183";"Kvinnor";0;247;8426;8673;0,0284791882854837;2,85
2013;"0184";"Män";0;1573;35802;37375;0,0420869565217391;4,21
2013;"0184";"Kvinnor";0;1477;34135;35612;0,0414747837807481;4,15
2013;"0186";"Män";0;480;4729;5209;0,0921482050297562;9,21
2013;"0186";"Kvinnor";0;490;5595;6085;0,0805258833196385;8,05
2013;"0187";"Män";0;54;1064;1118;0,0483005366726297;4,83
2013;"0187";"Kvinnor";0;60;1303;1363;0,0440205429200293;4,4
2013;"0188";"Män";0;224;9668;9892;0,0226445612616256;2,26
2013;"0188";"Kvinnor";0;271;9765;10036;0,0270027899561578;2,7
2013;"0191";"Män";0;171;15507;15678;0,0109070034443169;1,09
2013;"0191";"Kvinnor";0;266;11605;11871;0,0224075478055766;2,24
2013;"0192";"Män";0;68;3092;3160;0,0215189873417722;2,15
2013;"0192";"Kvinnor";0;103;3133;3236;0,0318294190358467;3,18
2013;"0305";"Män";0;39;2447;2486;0,0156878519710378;1,57
2013;"0305";"Kvinnor";0;72;2274;2346;0,030690537084399;3,07
2013;"0319";"Män";0;13;1206;1219;0,0106644790812141;1,07
2013;"0319";"Kvinnor";0;16;992;1008;0,0158730158730159;1,59
2013;"0330";"Män";0;42;1727;1769;0,0237422272470322;2,37
2013;"0330";"Kvinnor";0;45;1681;1726;0,026071842410197;2,61
2013;"0331";"Män";0;119;1691;1810;0,0657458563535912;6,57
2013;"0331";"Kvinnor";0;129;1685;1814;0,0711135611907387;7,11
2013;"0360";"Män";0;60;3272;3332;0,0180072028811525;1,8
2013;"0360";"Kvinnor";0;42;2521;2563;0,0163870464299649;1,64
2013;"0380";"Män";0;1808;42668;44476;0,0406511376922385;4,07
2013;"0380";"Kvinnor";0;2303;44975;47278;0,0487118744447735;4,87
2013;"0381";"Män";0;125;7591;7716;0,0162001036806636;1,62
2013;"0381";"Kvinnor";0;205;6850;7055;0,0290574060949681;2,91
2013;"0382";"Män";0;35;5230;5265;0,00664767331433998;0,66
2013;"0382";"Kvinnor";0;46;3873;3919;0,0117376881857617;1,17
2013;"0428";"Män";0;63;1301;1364;0,0461876832844575;4,62
2013;"0428";"Kvinnor";0;118;1171;1289;0,0915438324282389;9,15
2013;"0461";"Män";0;28;1124;1152;0,0243055555555556;2,43
2013;"0461";"Kvinnor";0;59;1455;1514;0,0389696169088507;3,9
2013;"0480";"Män";0;304;10564;10868;0,027972027972028;2,8
2013;"0480";"Kvinnor";0;457;10532;10989;0,0415870415870416;4,16
2013;"0481";"Män";0;23;3259;3282;0,00700792199878123;0,7
2013;"0481";"Kvinnor";0;28;1657;1685;0,0166172106824926;1,66
2013;"0482";"Män";0;38;2671;2709;0,0140273163528977;1,4
2013;"0482";"Kvinnor";0;53;2351;2404;0,0220465890183028;2,2
2013;"0483";"Män";0;328;6389;6717;0,0488313235075182;4,88
2013;"0483";"Kvinnor";0;249;5774;6023;0,0413415241573966;4,13
2013;"0484";"Män";0;583;19411;19994;0,0291587476242873;2,92
2013;"0484";"Kvinnor";0;826;18577;19403;0,0425707364840489;4,26
2013;"0486";"Män";0;130;5023;5153;0,0252280225111585;2,52
2013;"0486";"Kvinnor";0;181;4938;5119;0,0353584684508693;3,54
2013;"0488";"Män";0;108;1544;1652;0,0653753026634383;6,54
2013;"0488";"Kvinnor";0;108;1563;1671;0,0646319569120287;6,46
2013;"0509";"Män";0;32;825;857;0,0373395565927655;3,73
2013;"0509";"Kvinnor";0;18;748;766;0,0234986945169713;2,35
2013;"0512";"Män";0;14;640;654;0,0214067278287462;2,14
2013;"0512";"Kvinnor";0;16;438;454;0,0352422907488987;3,52
2013;"0513";"Män";0;29;1605;1634;0,0177478580171359;1,77
2013;"0513";"Kvinnor";0;33;1429;1462;0,0225718194254446;2,26
2013;"0560";"Män";0;2;923;925;0,00216216216216216;0,22
2013;"0560";"Kvinnor";0;6;603;609;0,00985221674876847;0,99
2013;"0561";"Män";0;54;1604;1658;0,0325693606755127;3,26
2013;"0561";"Kvinnor";0;54;1332;1386;0,038961038961039;3,9
2013;"0562";"Män";0;42;5453;5495;0,00764331210191083;0,76
2013;"0562";"Kvinnor";0;46;3474;3520;0,0130681818181818;1,31
2013;"0563";"Män";0;17;1381;1398;0,0121602288984263;1,22
2013;"0563";"Kvinnor";0;29;1068;1097;0,0264357338195077;2,64
2013;"0580";"Män";0;897;38028;38925;0,0230443159922929;2,3
2013;"0580";"Kvinnor";0;1104;33236;34340;0,0321490972626674;3,21
2013;"0581";"Män";0;1002;29403;30405;0,0329551060680809;3,3
2013;"0581";"Kvinnor";0;1333;27239;28572;0,0466540669186616;4,67
2013;"0582";"Män";0;59;1882;1941;0,0303967027305513;3,04
2013;"0582";"Kvinnor";0;63;1660;1723;0,036564132327336;3,66
2013;"0583";"Män";0;178;6892;7070;0,0251768033946252;2,52
2013;"0583";"Kvinnor";0;203;6692;6895;0,0294416243654822;2,94
2013;"0584";"Män";0;62;1520;1582;0,0391908975979772;3,92
2013;"0584";"Kvinnor";0;59;1285;1344;0,0438988095238095;4,39
2013;"0586";"Män";0;81;6415;6496;0,0124692118226601;1,25
2013;"0586";"Kvinnor";0;113;4245;4358;0,025929325378614;2,59
2013;"0604";"Män";0;14;1333;1347;0,0103934669636229;1,04
2013;"0604";"Kvinnor";0;19;1014;1033;0,0183930300096805;1,84
2013;"0617";"Män";0;54;3216;3270;0,0165137614678899;1,65
2013;"0617";"Kvinnor";0;61;2236;2297;0,0265563778841968;2,66
2013;"0642";"Män";0;16;1324;1340;0,0119402985074627;1,19
2013;"0642";"Kvinnor";0;49;1101;1150;0,0426086956521739;4,26
2013;"0643";"Män";0;33;1768;1801;0,0183231538034425;1,83
2013;"0643";"Kvinnor";0;34;1490;1524;0,0223097112860892;2,23
2013;"0662";"Män";0;92;7566;7658;0,0120135805693393;1,2
2013;"0662";"Kvinnor";0;142;5789;5931;0,0239419996627887;2,39
2013;"0665";"Män";0;30;3021;3051;0,00983284169124877;0,98
2013;"0665";"Kvinnor";0;30;2104;2134;0,014058106841612;1,41
2013;"0680";"Män";0;1097;32680;33777;0,0324777215264825;3,25
2013;"0680";"Kvinnor";0;1179;28809;29988;0,0393157262905162;3,93
2013;"0682";"Män";0;127;6279;6406;0,0198251639088355;1,98
2013;"0682";"Kvinnor";0;139;5020;5159;0,0269432060476837;2,69
2013;"0683";"Män";0;254;8113;8367;0,0303573562806263;3,04
2013;"0683";"Kvinnor";0;344;7523;7867;0,0437269607220033;4,37
2013;"0684";"Män";0;20;2268;2288;0,00874125874125874;0,87
2013;"0684";"Kvinnor";0;35;1701;1736;0,0201612903225806;2,02
2013;"0685";"Män";0;84;6450;6534;0,0128558310376492;1,29
2013;"0685";"Kvinnor";0;125;4609;4734;0,0264047317279256;2,64
2013;"0686";"Män";0;82;4176;4258;0,0192578675434476;1,93
2013;"0686";"Kvinnor";0;111;4268;4379;0,025348253025805;2,53
2013;"0687";"Män";0;110;4123;4233;0,0259862981337113;2,6
2013;"0687";"Kvinnor";0;112;3256;3368;0,0332541567695962;3,33
2013;"0760";"Män";0;14;2432;2446;0,00572363041700736;0,57
2013;"0760";"Kvinnor";0;17;1763;1780;0,00955056179775281;0,96
2013;"0761";"Män";0;17;1182;1199;0,0141784820683903;1,42
2013;"0761";"Kvinnor";0;58;1180;1238;0,0468497576736672;4,68
2013;"0763";"Män";0;43;2579;2622;0,0163996948893974;1,64
2013;"0763";"Kvinnor";0;42;2265;2307;0,0182054616384915;1,82
2013;"0764";"Män";0;47;3868;3915;0,0120051085568327;1,2
2013;"0764";"Kvinnor";0;54;2980;3034;0,017798286090969;1,78
2013;"0765";"Män";0;582;4167;4749;0,122552116234997;12,26
2013;"0765";"Kvinnor";0;617;3559;4176;0,147749042145594;14,77
2013;"0767";"Män";0;57;2738;2795;0,0203935599284437;2,04
2013;"0767";"Kvinnor";0;41;1746;1787;0,0229434806939004;2,29
2013;"0780";"Män";0;855;21006;21861;0,0391107451626184;3,91
2013;"0780";"Kvinnor";0;946;19332;20278;0,0466515435447283;4,67
2013;"0781";"Män";0;496;6374;6870;0,072197962154294;7,22
2013;"0781";"Kvinnor";0;364;5280;5644;0,0644932671863926;6,45
2013;"0821";"Män";0;7;691;698;0,0100286532951289;1
2013;"0821";"Kvinnor";0;9;832;841;0,0107015457788347;1,07
2013;"0834";"Män";0;13;1199;1212;0,0107260726072607;1,07
2013;"0834";"Kvinnor";0;13;931;944;0,013771186440678;1,38
2013;"0840";"Män";0;41;2242;2283;0,0179588261060009;1,8
2013;"0840";"Kvinnor";0;86;2018;2104;0,0408745247148289;4,09
2013;"0860";"Män";0;25;2704;2729;0,00916086478563576;0,92
2013;"0860";"Kvinnor";0;30;2134;2164;0,0138632162661738;1,39
2013;"0861";"Män";0;22;2361;2383;0,00923206042803189;0,92
2013;"0861";"Kvinnor";0;27;1848;1875;0,0144;1,44
2013;"0862";"Män";0;46;2405;2451;0,0187678498572011;1,88
2013;"0862";"Kvinnor";0;37;1606;1643;0,0225197808886184;2,25
2013;"0880";"Män";0;650;14656;15306;0,0424670064027179;4,25
2013;"0880";"Kvinnor";0;874;14695;15569;0,0561371957094226;5,61
2013;"0881";"Män";0;44;3908;3952;0,0111336032388664;1,11
2013;"0881";"Kvinnor";0;81;3213;3294;0,0245901639344262;2,46
2013;"0882";"Män";0;90;7437;7527;0,0119569549621363;1,2
2013;"0882";"Kvinnor";0;158;5799;5957;0,0265234178277657;2,65
2013;"0883";"Män";0;136;7198;7334;0,0185437687482956;1,85
2013;"0883";"Kvinnor";0;170;6967;7137;0,0238195320162533;2,38
2013;"0884";"Män";0;326;3635;3961;0,0823024488765463;8,23
2013;"0884";"Kvinnor";0;300;2739;3039;0,0987166831194472;9,87
2013;"0885";"Män";0;62;1923;1985;0,0312342569269521;3,12
2013;"0885";"Kvinnor";0;79;1666;1745;0,0452722063037249;4,53
2013;"0980";"Män";0;483;11870;12353;0,0390998138104104;3,91
2013;"0980";"Kvinnor";0;528;11372;11900;0,0443697478991597;4,44
2013;"1060";"Män";0;28;4000;4028;0,00695134061569017;0,7
2013;"1060";"Kvinnor";0;45;2156;2201;0,0204452521581099;2,04
2013;"1080";"Män";0;437;14295;14732;0,0296633179473255;2,97
2013;"1080";"Kvinnor";0;484;12933;13417;0,0360736379220392;3,61
2013;"1081";"Män";0;117;5713;5830;0,0200686106346484;2,01
2013;"1081";"Kvinnor";0;150;4309;4459;0,0336398295581969;3,36
2013;"1082";"Män";0;204;5338;5542;0,0368098159509202;3,68
2013;"1082";"Kvinnor";0;299;5572;5871;0,0509282916027934;5,09
2013;"1083";"Män";0;78;2970;3048;0,0255905511811024;2,56
2013;"1083";"Kvinnor";0;74;2437;2511;0,0294703305455994;2,95
2013;"1214";"Män";0;28;1605;1633;0,0171463563992652;1,71
2013;"1214";"Kvinnor";0;24;1600;1624;0,0147783251231527;1,48
2013;"1230";"Män";0;86;3117;3203;0,0268498282859819;2,68
2013;"1230";"Kvinnor";0;62;2221;2283;0,0271572492334647;2,72
2013;"1231";"Män";0;80;4570;4650;0,0172043010752688;1,72
2013;"1231";"Kvinnor";0;197;2749;2946;0,0668703326544467;6,69
2013;"1233";"Män";0;260;3357;3617;0,071882775781034;7,19
2013;"1233";"Kvinnor";0;202;3684;3886;0,0519814719505919;5,2
2013;"1256";"Män";0;55;2193;2248;0,0244661921708185;2,45
2013;"1256";"Kvinnor";0;72;1603;1675;0,0429850746268657;4,3
2013;"1257";"Män";0;14;1798;1812;0,00772626931567329;0,77
2013;"1257";"Kvinnor";0;28;1553;1581;0,0177103099304238;1,77
2013;"1260";"Män";0;8;2335;2343;0,00341442594963722;0,34
2013;"1260";"Kvinnor";0;13;1929;1942;0,00669412976313079;0,67
2013;"1261";"Män";0;101;3340;3441;0,029351932577739;2,94
2013;"1261";"Kvinnor";0;195;3371;3566;0,0546831183398766;5,47
2013;"1262";"Män";0;93;2155;2248;0,0413701067615658;4,14
2013;"1262";"Kvinnor";0;105;2643;2748;0,0382096069868996;3,82
2013;"1263";"Män";0;74;3385;3459;0,0213934663197456;2,14
2013;"1263";"Kvinnor";0;104;2660;2764;0,0376266280752533;3,76
2013;"1264";"Män";0;67;1827;1894;0,0353748680042239;3,54
2013;"1264";"Kvinnor";0;69;1629;1698;0,0406360424028269;4,06
2013;"1265";"Män";0;55;2830;2885;0,0190641247833622;1,91
2013;"1265";"Kvinnor";0;56;2385;2441;0,022941417451864;2,29
2013;"1266";"Män";0;39;2294;2333;0,0167166738105444;1,67
2013;"1266";"Kvinnor";0;52;2283;2335;0,0222698072805139;2,23
2013;"1267";"Män";0;46;1773;1819;0,0252886201209456;2,53
2013;"1267";"Kvinnor";0;69;2289;2358;0,0292620865139949;2,93
2013;"1270";"Män";0;69;2369;2438;0,0283018867924528;2,83
2013;"1270";"Kvinnor";0;80;1979;2059;0,0388538125303545;3,89
2013;"1272";"Män";0;28;2299;2327;0,0120326600773528;1,2
2013;"1272";"Kvinnor";0;40;1760;1800;0,0222222222222222;2,22
2013;"1273";"Män";0;34;2080;2114;0,0160832544938505;1,61
2013;"1273";"Kvinnor";0;44;1759;1803;0,0244037714919578;2,44
2013;"1275";"Män";0;12;1719;1731;0,00693240901213172;0,69
2013;"1275";"Kvinnor";0;11;1163;1174;0,00936967632027257;0,94
2013;"1276";"Män";0;83;2606;2689;0,030866493120119;3,09
2013;"1276";"Kvinnor";0;63;2090;2153;0,0292614955875523;2,93
2013;"1277";"Män";0;26;2816;2842;0,0091484869809993;0,91
2013;"1277";"Kvinnor";0;107;2465;2572;0,041601866251944;4,16
2013;"1278";"Män";0;103;3121;3224;0,0319478908188586;3,19
2013;"1278";"Kvinnor";0;160;2603;2763;0,0579080709373869;5,79
2013;"1280";"Män";0;5100;75869;80969;0,0629870691252208;6,3
2013;"1280";"Kvinnor";0;5425;68553;73978;0,0733326123982806;7,33
2013;"1281";"Män";0;831;31530;32361;0,0256790581255215;2,57
2013;"1281";"Kvinnor";0;1250;29940;31190;0,0400769477396601;4,01
2013;"1282";"Män";0;279;7187;7466;0,0373694079828556;3,74
2013;"1282";"Kvinnor";0;259;6064;6323;0,0409615688755338;4,1
2013;"1283";"Män";0;1929;31092;33021;0,0584173707640592;5,84
2013;"1283";"Kvinnor";0;2281;27905;30186;0,0755648313787849;7,56
2013;"1284";"Män";0;109;3611;3720;0,0293010752688172;2,93
2013;"1284";"Kvinnor";0;143;3538;3681;0,0388481390926379;3,88
2013;"1285";"Män";0;143;5159;5302;0,0269709543568465;2,7
2013;"1285";"Kvinnor";0;152;4571;4723;0,0321829345754817;3,22
2013;"1286";"Män";0;196;5178;5374;0,0364719017491626;3,65
2013;"1286";"Kvinnor";0;278;5597;5875;0,0473191489361702;4,73
2013;"1287";"Män";0;104;6044;6148;0,0169160702667534;1,69
2013;"1287";"Kvinnor";0;213;6001;6214;0,0342774380431284;3,43
2013;"1290";"Män";0;495;16447;16942;0,0292173297131389;2,92
2013;"1290";"Kvinnor";0;634;16416;17050;0,0371847507331378;3,72
2013;"1291";"Män";0;109;3225;3334;0,0326934613077385;3,27
2013;"1291";"Kvinnor";0;153;3218;3371;0,0453871254820528;4,54
2013;"1292";"Män";0;177;7479;7656;0,0231191222570533;2,31
2013;"1292";"Kvinnor";0;301;7846;8147;0,0369461151344053;3,69
2013;"1293";"Män";0;220;9586;9806;0,0224352437283296;2,24
2013;"1293";"Kvinnor";0;236;8405;8641;0,0273116537437797;2,73
2013;"1315";"Män";0;33;2407;2440;0,0135245901639344;1,35
2013;"1315";"Kvinnor";0;39;1765;1804;0,0216186252771619;2,16
2013;"1380";"Män";0;752;21593;22345;0,0336540613112553;3,37
2013;"1380";"Kvinnor";0;962;20263;21225;0,0453239104829211;4,53
2013;"1381";"Män";0;151;3866;4017;0,0375902414737366;3,76
2013;"1381";"Kvinnor";0;140;3439;3579;0,0391170718077675;3,91
2013;"1382";"Män";0;287;9141;9428;0,0304412388629614;3,04
2013;"1382";"Kvinnor";0;409;8370;8779;0,0465884497095341;4,66
2013;"1383";"Män";0;462;13393;13855;0,0333453626849513;3,33
2013;"1383";"Kvinnor";0;781;11982;12763;0,0611925095980569;6,12
2013;"1384";"Män";0;489;9793;10282;0,0475588406924723;4,76
2013;"1384";"Kvinnor";0;860;11024;11884;0,0723662066644228;7,24
2013;"1401";"Män";0;379;6464;6843;0,0553850650299576;5,54
2013;"1401";"Kvinnor";0;232;5708;5940;0,0390572390572391;3,91
2013;"1402";"Män";0;255;5448;5703;0,0447133087848501;4,47
2013;"1402";"Kvinnor";0;425;4799;5224;0,0813552833078101;8,14
2013;"1407";"Män";0;27;1560;1587;0,0170132325141777;1,7
2013;"1407";"Kvinnor";0;54;1509;1563;0,0345489443378119;3,45
2013;"1415";"Män";0;95;6457;6552;0,0144993894993895;1,45
2013;"1415";"Kvinnor";0;218;4327;4545;0,047964796479648;4,8
2013;"1419";"Män";0;33;2128;2161;0,015270708005553;1,53
2013;"1419";"Kvinnor";0;70;2151;2221;0,0315173345339937;3,15
2013;"1421";"Män";0;21;2304;2325;0,00903225806451613;0,9
2013;"1421";"Kvinnor";0;30;1978;2008;0,0149402390438247;1,49
2013;"1427";"Män";0;34;1927;1961;0,0173380928097909;1,73
2013;"1427";"Kvinnor";0;53;1742;1795;0,0295264623955432;2,95
2013;"1430";"Män";0;68;1729;1797;0,0378408458542014;3,78
2013;"1430";"Kvinnor";0;57;1509;1566;0,0363984674329502;3,64
2013;"1435";"Män";0;71;2476;2547;0,027875932469572;2,79
2013;"1435";"Kvinnor";0;102;2034;2136;0,047752808988764;4,78
2013;"1438";"Män";0;8;1078;1086;0,00736648250460405;0,74
2013;"1438";"Kvinnor";0;12;751;763;0,0157273918741809;1,57
2013;"1439";"Män";0;12;948;960;0,0125;1,25
2013;"1439";"Kvinnor";0;13;845;858;0,0151515151515152;1,52
2013;"1440";"Män";0;78;3063;3141;0,0248328557784145;2,48
2013;"1440";"Kvinnor";0;111;3158;3269;0,0339553380238605;3,4
2013;"1441";"Män";0;157;3877;4034;0,0389191869112543;3,89
2013;"1441";"Kvinnor";0;180;4426;4606;0,0390794615718628;3,91
2013;"1442";"Män";0;46;2464;2510;0,0183266932270916;1,83
2013;"1442";"Kvinnor";0;27;1694;1721;0,0156885531667635;1,57
2013;"1443";"Män";0;57;1190;1247;0,0457097032878909;4,57
2013;"1443";"Kvinnor";0;47;1017;1064;0,0441729323308271;4,42
2013;"1444";"Män";0;3;718;721;0,00416088765603329;0,42
2013;"1444";"Kvinnor";0;11;731;742;0,0148247978436658;1,48
2013;"1445";"Män";0;48;1023;1071;0,0448179271708683;4,48
2013;"1445";"Kvinnor";0;43;796;839;0,0512514898688915;5,13
2013;"1446";"Män";0;23;1788;1811;0,0127001656543346;1,27
2013;"1446";"Kvinnor";0;23;1155;1178;0,0195246179966044;1,95
2013;"1447";"Män";0;8;976;984;0,00813008130081301;0,81
2013;"1447";"Kvinnor";0;10;722;732;0,0136612021857923;1,37
2013;"1452";"Män";0;68;3284;3352;0,0202863961813842;2,03
2013;"1452";"Kvinnor";0;118;2100;2218;0,0532010820559062;5,32
2013;"1460";"Män";0;41;1939;1980;0,0207070707070707;2,07
2013;"1460";"Kvinnor";0;80;1736;1816;0,0440528634361234;4,41
2013;"1461";"Män";0;18;1402;1420;0,0126760563380282;1,27
2013;"1461";"Kvinnor";0;46;1288;1334;0,0344827586206897;3,45
2013;"1462";"Män";0;27;1780;1807;0,0149418926397344;1,49
2013;"1462";"Kvinnor";0;29;1802;1831;0,0158383397050792;1,58
2013;"1463";"Män";0;191;5203;5394;0,0354097144975899;3,54
2013;"1463";"Kvinnor";0;246;4992;5238;0,0469644902634593;4,7
2013;"1465";"Män";0;215;1530;1745;0,123209169054441;12,32
2013;"1465";"Kvinnor";0;139;1447;1586;0,0876418663303909;8,76
2013;"1466";"Män";0;11;2066;2077;0,00529610014443909;0,53
2013;"1466";"Kvinnor";0;15;1474;1489;0,010073875083949;1,01
2013;"1470";"Män";0;64;4395;4459;0,0143529939448307;1,44
2013;"1470";"Kvinnor";0;77;2707;2784;0,0276580459770115;2,77
2013;"1471";"Män";0;23;3125;3148;0,00730622617534943;0,73
2013;"1471";"Kvinnor";0;37;2227;2264;0,0163427561837456;1,63
2013;"1472";"Män";0;27;1744;1771;0,0152456239412761;1,52
2013;"1472";"Kvinnor";0;25;1536;1561;0,0160153747597694;1,6
2013;"1473";"Män";0;14;1615;1629;0,00859422958870473;0,86
2013;"1473";"Kvinnor";0;27;1282;1309;0,0206264323911383;2,06
2013;"1480";"Män";0;7306;157067;164373;0,0444476890973578;4,44
2013;"1480";"Kvinnor";0;8933;136004;144937;0,0616336753210015;6,16
2013;"1481";"Män";0;681;18029;18710;0,0363976483164083;3,64
2013;"1481";"Kvinnor";0;962;16022;16984;0,0566415449835139;5,66
2013;"1482";"Män";0;257;7546;7803;0,0329360502370883;3,29
2013;"1482";"Kvinnor";0;221;7172;7393;0,0298931421615041;2,99
2013;"1484";"Män";0;58;3077;3135;0,0185007974481659;1,85
2013;"1484";"Kvinnor";0;81;2411;2492;0,0325040128410915;3,25
2013;"1485";"Män";0;334;10560;10894;0,0306590783917753;3,07
2013;"1485";"Kvinnor";0;602;10729;11331;0,0531285852969729;5,31
2013;"1486";"Män";0;118;2881;2999;0,0393464488162721;3,93
2013;"1486";"Kvinnor";0;321;2913;3234;0,0992578849721707;9,93
2013;"1487";"Män";0;143;5670;5813;0,0246000344056425;2,46
2013;"1487";"Kvinnor";0;152;6079;6231;0,0243941582410528;2,44
2013;"1488";"Män";0;269;12266;12535;0,021459912245712;2,15
2013;"1488";"Kvinnor";0;477;11776;12253;0,0389292418183302;3,89
2013;"1489";"Män";0;224;5914;6138;0,0364939719778429;3,65
2013;"1489";"Kvinnor";0;283;6860;7143;0,0396192076158477;3,96
2013;"1490";"Män";0;1972;24004;25976;0,0759162303664921;7,59
2013;"1490";"Kvinnor";0;2523;22642;25165;0,100258295251341;10,03
2013;"1491";"Män";0;254;4260;4514;0,0562693841382366;5,63
2013;"1491";"Kvinnor";0;366;3420;3786;0,0966719492868463;9,67
2013;"1492";"Män";0;38;2097;2135;0,0177985948477752;1,78
2013;"1492";"Kvinnor";0;63;1917;1980;0,0318181818181818;3,18
2013;"1493";"Män";0;98;4255;4353;0,0225132092809557;2,25
2013;"1493";"Kvinnor";0;119;4035;4154;0,0286470871449206;2,86
2013;"1494";"Män";0;234;8056;8290;0,028226779252111;2,82
2013;"1494";"Kvinnor";0;297;7297;7594;0,0391098235449039;3,91
2013;"1495";"Män";0;98;3982;4080;0,0240196078431373;2,4
2013;"1495";"Kvinnor";0;116;3586;3702;0,031334413830362;3,13
2013;"1496";"Män";0;342;16376;16718;0,0204569924632133;2,05
2013;"1496";"Kvinnor";0;474;13445;13919;0,0340541705582298;3,41
2013;"1497";"Män";0;23;1298;1321;0,0174110522331567;1,74
2013;"1497";"Kvinnor";0;27;1273;1300;0,0207692307692308;2,08
2013;"1498";"Män";0;41;2260;2301;0,0178183398522382;1,78
2013;"1498";"Kvinnor";0;62;1799;1861;0,0333154218162278;3,33
2013;"1499";"Män";0;269;6240;6509;0,0413273928406821;4,13
2013;"1499";"Kvinnor";0;259;5389;5648;0,045856940509915;4,59
2013;"1715";"Män";0;29;1634;1663;0,0174383644016837;1,74
2013;"1715";"Kvinnor";0;26;1354;1380;0,0188405797101449;1,88
2013;"1730";"Män";0;15;1462;1477;0,010155721056195;1,02
2013;"1730";"Kvinnor";0;121;1637;1758;0,0688282138794084;6,88
2013;"1737";"Män";0;42;2404;2446;0,0171708912510221;1,72
2013;"1737";"Kvinnor";0;47;2416;2463;0,0190824198132359;1,91
2013;"1760";"Män";0;3;561;564;0,00531914893617021;0,53
2013;"1760";"Kvinnor";0;6;468;474;0,0126582278481013;1,27
2013;"1761";"Män";0;34;1976;2010;0,0169154228855721;1,69
2013;"1761";"Kvinnor";0;40;1752;1792;0,0223214285714286;2,23
2013;"1762";"Män";0;21;742;763;0,0275229357798165;2,75
2013;"1762";"Kvinnor";0;26;591;617;0,0421393841166937;4,21
2013;"1763";"Män";0;18;1013;1031;0,017458777885548;1,75
2013;"1763";"Kvinnor";0;22;1249;1271;0,017309205350118;1,73
2013;"1764";"Män";0;13;1770;1783;0,00729108244531688;0,73
2013;"1764";"Kvinnor";0;15;1150;1165;0,0128755364806867;1,29
2013;"1765";"Män";0;27;1805;1832;0,0147379912663755;1,47
2013;"1765";"Kvinnor";0;93;1750;1843;0,0504612045577862;5,05
2013;"1766";"Män";0;160;2502;2662;0,0601051840721262;6,01
2013;"1766";"Kvinnor";0;129;2095;2224;0,0580035971223022;5,8
2013;"1780";"Män";0;831;22673;23504;0,03535568413887;3,54
2013;"1780";"Kvinnor";0;1086;21652;22738;0,0477614565924883;4,78
2013;"1781";"Män";0;66;4453;4519;0,0146050011064395;1,46
2013;"1781";"Kvinnor";0;97;3298;3395;0,0285714285714286;2,86
2013;"1782";"Män";0;16;1904;1920;0,00833333333333333;0,83
2013;"1782";"Kvinnor";0;22;1677;1699;0,012948793407887;1,29
2013;"1783";"Män";0;15;2378;2393;0,00626828249059758;0,63
2013;"1783";"Kvinnor";0;35;1801;1836;0,0190631808278867;1,91
2013;"1784";"Män";0;83;5207;5290;0,0156899810964083;1,57
2013;"1784";"Kvinnor";0;128;4492;4620;0,0277056277056277;2,77
2013;"1785";"Män";0;33;3064;3097;0,0106554730384243;1,07
2013;"1785";"Kvinnor";0;58;2197;2255;0,0257206208425721;2,57
2013;"1814";"Män";0;9;882;891;0,0101010101010101;1,01
2013;"1814";"Kvinnor";0;15;906;921;0,0162866449511401;1,63
2013;"1860";"Män";0;14;1259;1273;0,0109976433621367;1,1
2013;"1860";"Kvinnor";0;13;824;837;0,015531660692951;1,55
2013;"1861";"Män";0;75;3854;3929;0,0190888266734538;1,91
2013;"1861";"Kvinnor";0;56;2812;2868;0,0195258019525802;1,95
2013;"1862";"Män";0;6;1421;1427;0,00420462508759636;0,42
2013;"1862";"Kvinnor";0;20;1119;1139;0,0175592625109745;1,76
2013;"1863";"Män";0;13;1371;1384;0,00939306358381503;0,94
2013;"1863";"Kvinnor";0;26;1029;1055;0,0246445497630332;2,46
2013;"1864";"Män";0;12;786;798;0,0150375939849624;1,5
2013;"1864";"Kvinnor";0;11;700;711;0,0154711673699015;1,55
2013;"1880";"Män";0;1194;33383;34577;0,0345316250686873;3,45
2013;"1880";"Kvinnor";0;1546;31844;33390;0,0463012878107218;4,63
2013;"1881";"Män";0;103;3423;3526;0,0292115711854793;2,92
2013;"1881";"Kvinnor";0;80;3214;3294;0,0242865816636308;2,43
2013;"1882";"Män";0;27;1982;2009;0,0134395221503235;1,34
2013;"1882";"Kvinnor";0;44;1459;1503;0,0292747837658017;2,93
2013;"1883";"Män";0;139;7128;7267;0,0191275629558277;1,91
2013;"1883";"Kvinnor";0;185;6226;6411;0,0288566526282951;2,89
2013;"1884";"Män";0;36;1457;1493;0,0241125251172137;2,41
2013;"1884";"Kvinnor";0;42;1398;1440;0,0291666666666667;2,92
2013;"1885";"Män";0;74;4896;4970;0,0148893360160966;1,49
2013;"1885";"Kvinnor";0;67;4463;4530;0,0147902869757174;1,48
2013;"1904";"Män";0;14;831;845;0,0165680473372781;1,66
2013;"1904";"Kvinnor";0;6;595;601;0,00998336106489185;1
2013;"1907";"Män";0;14;1442;1456;0,00961538461538462;0,96
2013;"1907";"Kvinnor";0;24;1127;1151;0,0208514335360556;2,09
2013;"1960";"Män";0;7;1119;1126;0,00621669626998224;0,62
2013;"1960";"Kvinnor";0;12;968;980;0,0122448979591837;1,22
2013;"1961";"Män";0;31;2355;2386;0,0129924559932942;1,3
2013;"1961";"Kvinnor";0;22;2247;2269;0,00969590127809608;0,97
2013;"1962";"Män";0;12;817;829;0,014475271411339;1,45
2013;"1962";"Kvinnor";0;17;641;658;0,0258358662613982;2,58
2013;"1980";"Män";0;1123;34243;35366;0,031753661708986;3,18
2013;"1980";"Kvinnor";0;1477;29465;30942;0,0477344709456402;4,77
2013;"1981";"Män";0;79;3544;3623;0,0218051338669611;2,18
2013;"1981";"Kvinnor";0;143;3369;3512;0,0407175398633257;4,07
2013;"1982";"Män";0;32;3422;3454;0,00926462072958888;0,93
2013;"1982";"Kvinnor";0;48;2699;2747;0,0174736075718966;1,75
2013;"1983";"Män";0;78;5599;5677;0,0137396512242382;1,37
2013;"1983";"Kvinnor";0;116;4553;4669;0,0248447204968944;2,48
2013;"1984";"Män";0;20;2762;2782;0,00718907260963336;0,72
2013;"1984";"Kvinnor";0;40;2220;2260;0,0176991150442478;1,77
2013;"2021";"Män";0;13;1269;1282;0,0101404056162246;1,01
2013;"2021";"Kvinnor";0;23;1045;1068;0,0215355805243446;2,15
2013;"2023";"Män";0;59;2683;2742;0,0215171407731583;2,15
2013;"2023";"Kvinnor";0;70;2462;2532;0,0276461295418641;2,76
2013;"2026";"Män";0;17;1179;1196;0,0142140468227425;1,42
2013;"2026";"Kvinnor";0;11;1224;1235;0,00890688259109312;0,89
2013;"2029";"Män";0;92;3151;3243;0,0283687943262411;2,84
2013;"2029";"Kvinnor";0;97;2782;2879;0,0336922542549496;3,37
2013;"2031";"Män";0;61;1622;1683;0,0362448009506833;3,62
2013;"2031";"Kvinnor";0;77;1534;1611;0,047796399751707;4,78
2013;"2034";"Män";0;27;993;1020;0,0264705882352941;2,65
2013;"2034";"Kvinnor";0;21;911;932;0,0225321888412017;2,25
2013;"2039";"Män";0;19;1357;1376;0,0138081395348837;1,38
2013;"2039";"Kvinnor";0;19;1194;1213;0,0156636438582028;1,57
2013;"2061";"Män";0;13;1711;1724;0,00754060324825986;0,75
2013;"2061";"Kvinnor";0;21;1186;1207;0,0173985086992543;1,74
2013;"2062";"Män";0;90;4746;4836;0,0186104218362283;1,86
2013;"2062";"Kvinnor";0;148;4431;4579;0,0323214675693383;3,23
2013;"2080";"Män";0;677;11091;11768;0,0575288919102651;5,75
2013;"2080";"Kvinnor";0;719;12359;13078;0,054977825355559;5,5
2013;"2081";"Män";0;182;14059;14241;0,0127800014043958;1,28
2013;"2081";"Kvinnor";0;407;10208;10615;0,0383419689119171;3,83
2013;"2082";"Män";0;21;1506;1527;0,0137524557956778;1,38
2013;"2082";"Kvinnor";0;33;1594;1627;0,0202827289489859;2,03
2013;"2083";"Män";0;51;3165;3216;0,0158582089552239;1,59
2013;"2083";"Kvinnor";0;61;2658;2719;0,0224347186465612;2,24
2013;"2084";"Män";0;112;5067;5179;0,0216257964858081;2,16
2013;"2084";"Kvinnor";0;110;3794;3904;0,0281762295081967;2,82
2013;"2085";"Män";0;74;6641;6715;0,0110201042442293;1,1
2013;"2085";"Kvinnor";0;100;5272;5372;0,0186150409530901;1,86
2013;"2101";"Män";0;9;926;935;0,00962566844919786;0,96
2013;"2101";"Kvinnor";0;12;827;839;0,0143027413587604;1,43
2013;"2104";"Män";0;13;2085;2098;0,00619637750238322;0,62
2013;"2104";"Kvinnor";0;26;1522;1548;0,0167958656330749;1,68
2013;"2121";"Män";0;24;2695;2719;0,00882677454946672;0,88
2013;"2121";"Kvinnor";0;42;1801;1843;0,0227889310906131;2,28
2013;"2132";"Män";0;12;1410;1422;0,00843881856540084;0,84
2013;"2132";"Kvinnor";0;23;1209;1232;0,0186688311688312;1,87
2013;"2161";"Män";0;133;3652;3785;0,0351387054161163;3,51
2013;"2161";"Kvinnor";0;186;3195;3381;0,0550133096716948;5,5
2013;"2180";"Män";0;726;20786;21512;0,0337486054295277;3,37
2013;"2180";"Kvinnor";0;938;19711;20649;0,0454259286163979;4,54
2013;"2181";"Män";0;75;9230;9305;0,00806018269747448;0,81
2013;"2181";"Kvinnor";0;121;6612;6733;0,0179711866924105;1,8
2013;"2182";"Män";0;118;4785;4903;0,0240668978176627;2,41
2013;"2182";"Kvinnor";0;178;4004;4182;0,0425633668101387;4,26
2013;"2183";"Män";0;136;5014;5150;0,0264077669902913;2,64
2013;"2183";"Kvinnor";0;199;4903;5102;0,0390043120344963;3,9
2013;"2184";"Män";0;167;7885;8052;0,0207401887729757;2,07
2013;"2184";"Kvinnor";0;218;6958;7176;0,0303790412486065;3,04
2013;"2260";"Män";0;52;2026;2078;0,0250240615976901;2,5
2013;"2260";"Kvinnor";0;63;1496;1559;0,040410519563823;4,04
2013;"2262";"Män";0;34;2864;2898;0,0117322291235335;1,17
2013;"2262";"Kvinnor";0;25;1983;2008;0,0124501992031873;1,25
2013;"2280";"Män";0;165;4386;4551;0,036255767963085;3,63
2013;"2280";"Kvinnor";0;213;4491;4704;0,045280612244898;4,53
2013;"2281";"Män";0;665;23361;24026;0,0276783484558395;2,77
2013;"2281";"Kvinnor";0;946;20959;21905;0,043186487103401;4,32
2013;"2282";"Män";0;41;3758;3799;0,0107923137667807;1,08
2013;"2282";"Kvinnor";0;52;3052;3104;0,0167525773195876;1,68
2013;"2283";"Män";0;85;3659;3744;0,0227029914529915;2,27
2013;"2283";"Kvinnor";0;119;3332;3451;0,0344827586206897;3,45
2013;"2284";"Män";0;220;12824;13044;0,0168659920269856;1,69
2013;"2284";"Kvinnor";0;317;10540;10857;0,0291977526020079;2,92
2013;"2303";"Män";0;6;1157;1163;0,00515907136715391;0,52
2013;"2303";"Kvinnor";0;13;927;940;0,0138297872340426;1,38
2013;"2305";"Män";0;20;1018;1038;0,0192678227360308;1,93
2013;"2305";"Kvinnor";0;18;915;933;0,0192926045016077;1,93
2013;"2309";"Män";0;30;2217;2247;0,0133511348464619;1,34
2013;"2309";"Kvinnor";0;16;1974;1990;0,00804020100502513;0,8
2013;"2313";"Män";0;19;2469;2488;0,00763665594855305;0,76
2013;"2313";"Kvinnor";0;39;2012;2051;0,0190151145782545;1,9
2013;"2321";"Män";0;78;2447;2525;0,0308910891089109;3,09
2013;"2321";"Kvinnor";0;93;2284;2377;0,0391249474127051;3,91
2013;"2326";"Män";0;15;1323;1338;0,0112107623318386;1,12
2013;"2326";"Kvinnor";0;8;1153;1161;0,00689061154177433;0,69
2013;"2361";"Män";0;30;2357;2387;0,0125680770842061;1,26
2013;"2361";"Kvinnor";0;29;2091;2120;0,0136792452830189;1,37
2013;"2380";"Män";0;646;14696;15342;0,0421066353800026;4,21
2013;"2380";"Kvinnor";0;655;15017;15672;0,0417942827973456;4,18
2013;"2401";"Män";0;13;1020;1033;0,0125847047434656;1,26
2013;"2401";"Kvinnor";0;15;946;961;0,0156087408949011;1,56
2013;"2403";"Män";0;1;324;325;0,00307692307692308;0,31
2013;"2403";"Kvinnor";0;4;315;319;0,0125391849529781;1,25
2013;"2404";"Män";0;12;1259;1271;0,00944138473642801;0,94
2013;"2404";"Kvinnor";0;20;875;895;0,0223463687150838;2,23
2013;"2409";"Män";0;10;1049;1059;0,00944287063267233;0,94
2013;"2409";"Kvinnor";0;6;1046;1052;0,00570342205323194;0,57
2013;"2417";"Män";0;14;847;861;0,016260162601626;1,63
2013;"2417";"Kvinnor";0;32;743;775;0,0412903225806452;4,13
2013;"2418";"Män";0;5;657;662;0,00755287009063444;0,76
2013;"2418";"Kvinnor";0;16;567;583;0,0274442538593482;2,74
2013;"2421";"Män";0;12;1258;1270;0,0094488188976378;0,94
2013;"2421";"Kvinnor";0;18;1105;1123;0,0160284951024043;1,6
2013;"2422";"Män";0;1;487;488;0,00204918032786885;0,2
2013;"2422";"Kvinnor";0;7;462;469;0,0149253731343284;1,49
2013;"2425";"Män";0;2;494;496;0,00403225806451613;0,4
2013;"2425";"Kvinnor";0;10;467;477;0,0209643605870021;2,1
2013;"2460";"Män";0;7;1280;1287;0,00543900543900544;0,54
2013;"2460";"Kvinnor";0;14;1089;1103;0,0126926563916591;1,27
2013;"2462";"Män";0;38;1114;1152;0,0329861111111111;3,3
2013;"2462";"Kvinnor";0;32;1137;1169;0,0273738237810094;2,74
2013;"2463";"Män";0;1;466;467;0,00214132762312634;0,21
2013;"2463";"Kvinnor";0;10;421;431;0,0232018561484919;2,32
2013;"2480";"Män";0;1019;29063;30082;0,0338740775214414;3,39
2013;"2480";"Kvinnor";0;1147;26978;28125;0,0407822222222222;4,08
2013;"2481";"Män";0;45;2813;2858;0,0157452764170749;1,57
2013;"2481";"Kvinnor";0;59;2622;2681;0,0220067139127191;2,2
2013;"2482";"Män";0;356;16535;16891;0,0210763128293174;2,11
2013;"2482";"Kvinnor";0;468;13603;14071;0,0332598962404946;3,33
2013;"2505";"Män";0;10;1365;1375;0,00727272727272727;0,73
2013;"2505";"Kvinnor";0;32;1230;1262;0,0253565768621236;2,54
2013;"2506";"Män";0;7;779;786;0,0089058524173028;0,89
2013;"2506";"Kvinnor";0;16;620;636;0,0251572327044025;2,52
2013;"2510";"Män";0;25;1080;1105;0,0226244343891403;2,26
2013;"2510";"Kvinnor";0;50;834;884;0,0565610859728507;5,66
2013;"2513";"Män";0;4;745;749;0,00534045393858478;0,53
2013;"2513";"Kvinnor";0;22;649;671;0,0327868852459016;3,28
2013;"2514";"Män";0;66;3167;3233;0,0204144757191463;2,04
2013;"2514";"Kvinnor";0;109;2813;2922;0,0373032169746749;3,73
2013;"2518";"Män";0;14;745;759;0,0184453227931489;1,84
2013;"2518";"Kvinnor";0;17;682;699;0,0243204577968526;2,43
2013;"2521";"Män";0;35;1226;1261;0,0277557494052339;2,78
2013;"2521";"Kvinnor";0;23;1083;1106;0,0207956600361664;2,08
2013;"2523";"Män";0;59;5159;5218;0,0113070141816788;1,13
2013;"2523";"Kvinnor";0;74;3876;3950;0,0187341772151899;1,87
2013;"2560";"Män";0;5;1465;1470;0,00340136054421769;0,34
2013;"2560";"Kvinnor";0;22;1317;1339;0,0164301717699776;1,64
2013;"2580";"Män";0;732;20562;21294;0,0343758805297267;3,44
2013;"2580";"Kvinnor";0;935;17132;18067;0,0517518126971827;5,18
2013;"2581";"Män";0;185;8280;8465;0,0218546958062611;2,19
2013;"2581";"Kvinnor";0;283;7105;7388;0,0383053600433135;3,83
2013;"2582";"Män";0;65;5314;5379;0,0120840304889385;1,21
2013;"2582";"Kvinnor";0;94;4555;4649;0,0202194020219402;2,02
2013;"2583";"Män";0;32;1483;1515;0,0211221122112211;2,11
2013;"2583";"Kvinnor";0;38;1564;1602;0,0237203495630462;2,37
2013;"2584";"Män";0;134;7103;7237;0,0185159596517894;1,85
2013;"2584";"Kvinnor";0;314;5346;5660;0,0554770318021201;5,55
2013;"9999";"Män";0;1588;163674;165262;0,0096089845215476;0,96
2013;"9999";"Kvinnor";0;2026;180685;182711;0,011088549676812;1,11
2014;"0114";"Män";0;165;7300;7465;0,0221031480241125;2,21
2014;"0114";"Kvinnor";0;231;6419;6650;0,0347368421052632;3,47
2014;"0115";"Män";0;132;3780;3912;0,0337423312883436;3,37
2014;"0115";"Kvinnor";0;105;3691;3796;0,0276606954689146;2,77
2014;"0117";"Män";0;174;4540;4714;0,0369113279592703;3,69
2014;"0117";"Kvinnor";0;194;4788;4982;0,0389401846647933;3,89
2014;"0120";"Män";0;210;5154;5364;0,0391498881431767;3,91
2014;"0120";"Kvinnor";0;213;4983;5196;0,0409930715935335;4,1
2014;"0123";"Män";0;328;13156;13484;0,0243251260753486;2,43
2014;"0123";"Kvinnor";0;443;8985;9428;0,0469876962240136;4,7
2014;"0125";"Män";0;121;3969;4090;0,0295843520782396;2,96
2014;"0125";"Kvinnor";0;138;3652;3790;0,0364116094986807;3,64
2014;"0126";"Män";0;442;20598;21040;0,0210076045627376;2,1
2014;"0126";"Kvinnor";0;514;21477;21991;0,0233731981265063;2,34
2014;"0127";"Män";0;403;11744;12147;0,0331769161109739;3,32
2014;"0127";"Kvinnor";0;445;9158;9603;0,0463396855149432;4,63
2014;"0128";"Män";0;39;1127;1166;0,0334476843910806;3,34
2014;"0128";"Kvinnor";0;40;1437;1477;0,02708192281652;2,71
2014;"0136";"Män";0;247;14056;14303;0,0172691043836957;1,73
2014;"0136";"Kvinnor";0;375;10459;10834;0,0346132545689496;3,46
2014;"0138";"Män";0;198;5086;5284;0,0374716124148372;3,75
2014;"0138";"Kvinnor";0;186;4635;4821;0,0385812072184194;3,86
2014;"0139";"Män";0;55;4819;4874;0,0112843660237998;1,13
2014;"0139";"Kvinnor";0;52;3142;3194;0,0162805259862242;1,63
2014;"0140";"Män";0;19;1296;1315;0,0144486692015209;1,44
2014;"0140";"Kvinnor";0;17;932;949;0,017913593256059;1,79
2014;"0160";"Män";0;499;11643;12142;0,0410970186130786;4,11
2014;"0160";"Kvinnor";0;771;10434;11205;0,0688085676037483;6,88
2014;"0162";"Män";0;192;6666;6858;0,0279965004374453;2,8
2014;"0162";"Kvinnor";0;269;10837;11106;0,0242211417251936;2,42
2014;"0163";"Män";0;318;12739;13057;0,0243547522401777;2,44
2014;"0163";"Kvinnor";0;487;11417;11904;0,0409106182795699;4,09
2014;"0180";"Män";0;30881;294856;325737;0,0948034764242318;9,48
2014;"0180";"Kvinnor";0;35823;265029;300852;0,1190718359858;11,91
2014;"0181";"Män";0;500;24687;25187;0,0198515106999643;1,99
2014;"0181";"Kvinnor";0;521;18731;19252;0,027062123415749;2,71
2014;"0182";"Män";0;922;15605;16527;0,0557874992436619;5,58
2014;"0182";"Kvinnor";0;1251;14816;16067;0,077861455156532;7,79
2014;"0183";"Män";0;275;11350;11625;0,0236559139784946;2,37
2014;"0183";"Kvinnor";0;245;9852;10097;0,0242646330593246;2,43
2014;"0184";"Män";0;1457;37099;38556;0,0377891897499741;3,78
2014;"0184";"Kvinnor";0;1480;36417;37897;0,0390532232102805;3,91
2014;"0186";"Män";0;444;4780;5224;0,0849923430321593;8,5
2014;"0186";"Kvinnor";0;454;5613;6067;0,074831053238833;7,48
2014;"0187";"Män";0;58;1050;1108;0,0523465703971119;5,23
2014;"0187";"Kvinnor";0;64;1320;1384;0,046242774566474;4,62
2014;"0188";"Män";0;234;9710;9944;0,0235317779565567;2,35
2014;"0188";"Kvinnor";0;262;9799;10061;0,026041148991154;2,6
2014;"0191";"Män";0;170;15410;15580;0,0109114249037227;1,09
2014;"0191";"Kvinnor";0;272;11598;11870;0,0229149115417018;2,29
2014;"0192";"Män";0;70;3027;3097;0,0226025185663545;2,26
2014;"0192";"Kvinnor";0;116;3065;3181;0,036466519962276;3,65
2014;"0305";"Män";0;45;2457;2502;0,0179856115107914;1,8
2014;"0305";"Kvinnor";0;53;2269;2322;0,0228251507321275;2,28
2014;"0319";"Män";0;11;1158;1169;0,00940975192472198;0,94
2014;"0319";"Kvinnor";0;17;1024;1041;0,0163304514889529;1,63
2014;"0330";"Män";0;41;1804;1845;0,0222222222222222;2,22
2014;"0330";"Kvinnor";0;49;1723;1772;0,0276523702031603;2,77
2014;"0331";"Män";0;129;1722;1851;0,0696920583468395;6,97
2014;"0331";"Kvinnor";0;124;1680;1804;0,0687361419068736;6,87
2014;"0360";"Män";0;62;3218;3280;0,0189024390243902;1,89
2014;"0360";"Kvinnor";0;54;2538;2592;0,0208333333333333;2,08
2014;"0380";"Män";0;1769;43164;44933;0,0393697282620791;3,94
2014;"0380";"Kvinnor";0;2282;45450;47732;0,0478085980055309;4,78
2014;"0381";"Män";0;127;7884;8011;0,0158532018474597;1,59
2014;"0381";"Kvinnor";0;203;6926;7129;0,0284752419694207;2,85
2014;"0382";"Män";0;38;5345;5383;0,00705926063533346;0,71
2014;"0382";"Kvinnor";0;52;3806;3858;0,0134784862623121;1,35
2014;"0428";"Män";0;64;1319;1383;0,0462762111352133;4,63
2014;"0428";"Kvinnor";0;119;1177;1296;0,091820987654321;9,18
2014;"0461";"Män";0;29;1099;1128;0,025709219858156;2,57
2014;"0461";"Kvinnor";0;53;1450;1503;0,0352628077178975;3,53
2014;"0480";"Män";0;304;10478;10782;0,0281951400482285;2,82
2014;"0480";"Kvinnor";0;469;10588;11057;0,042416568689518;4,24
2014;"0481";"Män";0;25;3138;3163;0,00790388871324692;0,79
2014;"0481";"Kvinnor";0;29;1680;1709;0,0169689877121123;1,7
2014;"0482";"Män";0;34;2638;2672;0,0127245508982036;1,27
2014;"0482";"Kvinnor";0;60;2324;2384;0,0251677852348993;2,52
2014;"0483";"Män";0;303;6499;6802;0,0445457218465157;4,45
2014;"0483";"Kvinnor";0;241;5910;6151;0,0391806210372297;3,92
2014;"0484";"Män";0;624;19327;19951;0,031276627737958;3,13
2014;"0484";"Kvinnor";0;861;18884;19745;0,0436059761965054;4,36
2014;"0486";"Män";0;123;4972;5095;0,0241413150147203;2,41
2014;"0486";"Kvinnor";0;179;4882;5061;0,0353685042481723;3,54
2014;"0488";"Män";0;100;1616;1716;0,0582750582750583;5,83
2014;"0488";"Kvinnor";0;96;1578;1674;0,0573476702508961;5,73
2014;"0509";"Män";0;29;787;816;0,0355392156862745;3,55
2014;"0509";"Kvinnor";0;22;733;755;0,0291390728476821;2,91
2014;"0512";"Män";0;14;632;646;0,021671826625387;2,17
2014;"0512";"Kvinnor";0;13;420;433;0,0300230946882217;3
2014;"0513";"Män";0;30;1594;1624;0,0184729064039409;1,85
2014;"0513";"Kvinnor";0;34;1420;1454;0,0233837689133425;2,34
2014;"0560";"Män";0;6;973;979;0,00612870275791624;0,61
2014;"0560";"Kvinnor";0;11;619;630;0,0174603174603175;1,75
2014;"0561";"Män";0;51;1588;1639;0,0311165344722392;3,11
2014;"0561";"Kvinnor";0;53;1267;1320;0,0401515151515152;4,02
2014;"0562";"Män";0;44;5370;5414;0,00812707794606576;0,81
2014;"0562";"Kvinnor";0;54;3557;3611;0,0149543062863473;1,5
2014;"0563";"Män";0;16;1379;1395;0,0114695340501792;1,15
2014;"0563";"Kvinnor";0;29;1088;1117;0,0259623992837959;2,6
2014;"0580";"Män";0;918;39015;39933;0,0229885057471264;2,3
2014;"0580";"Kvinnor";0;1145;34127;35272;0,0324620095259696;3,25
2014;"0581";"Män";0;979;29246;30225;0,0323904052936311;3,24
2014;"0581";"Kvinnor";0;1339;27189;28528;0,0469363432417274;4,69
2014;"0582";"Män";0;54;1875;1929;0,0279937791601866;2,8
2014;"0582";"Kvinnor";0;52;1716;1768;0,0294117647058824;2,94
2014;"0583";"Män";0;179;6986;7165;0,0249825540823447;2,5
2014;"0583";"Kvinnor";0;200;6819;7019;0,0284940874768486;2,85
2014;"0584";"Män";0;61;1482;1543;0,0395333765392093;3,95
2014;"0584";"Kvinnor";0;54;1269;1323;0,0408163265306122;4,08
2014;"0586";"Män";0;68;6329;6397;0,0106299828044396;1,06
2014;"0586";"Kvinnor";0;98;4300;4398;0,0222828558435653;2,23
2014;"0604";"Män";0;14;1343;1357;0,0103168754605748;1,03
2014;"0604";"Kvinnor";0;18;944;962;0,0187110187110187;1,87
2014;"0617";"Män";0;49;3251;3300;0,0148484848484848;1,48
2014;"0617";"Kvinnor";0;59;2271;2330;0,0253218884120172;2,53
2014;"0642";"Män";0;15;1360;1375;0,0109090909090909;1,09
2014;"0642";"Kvinnor";0;55;1112;1167;0,0471293916023993;4,71
2014;"0643";"Män";0;34;1731;1765;0,0192634560906516;1,93
2014;"0643";"Kvinnor";0;32;1531;1563;0,0204734484964811;2,05
2014;"0662";"Män";0;87;7505;7592;0,0114594309799789;1,15
2014;"0662";"Kvinnor";0;138;5730;5868;0,0235173824130879;2,35
2014;"0665";"Män";0;34;2971;3005;0,0113144758735441;1,13
2014;"0665";"Kvinnor";0;40;2026;2066;0,0193610842207164;1,94
2014;"0680";"Män";0;1086;33124;34210;0,0317451037708272;3,17
2014;"0680";"Kvinnor";0;1221;29163;30384;0,0401856240126382;4,02
2014;"0682";"Män";0;124;6420;6544;0,0189486552567237;1,89
2014;"0682";"Kvinnor";0;127;5222;5349;0,0237427556552627;2,37
2014;"0683";"Män";0;156;8327;8483;0,018389720617706;1,84
2014;"0683";"Kvinnor";0;232;7616;7848;0,0295616717635066;2,96
2014;"0684";"Män";0;25;2252;2277;0,0109793588054458;1,1
2014;"0684";"Kvinnor";0;23;1714;1737;0,0132412204951065;1,32
2014;"0685";"Män";0;72;6512;6584;0,0109356014580802;1,09
2014;"0685";"Kvinnor";0;121;4732;4853;0,0249330311147744;2,49
2014;"0686";"Män";0;65;4208;4273;0,015211794991809;1,52
2014;"0686";"Kvinnor";0;100;4259;4359;0,0229410415232852;2,29
2014;"0687";"Män";0;109;4082;4191;0,0260081126222859;2,6
2014;"0687";"Kvinnor";0;116;3267;3383;0,0342890925214307;3,43
2014;"0760";"Män";0;17;2495;2512;0,00676751592356688;0,68
2014;"0760";"Kvinnor";0;16;1790;1806;0,008859357696567;0,89
2014;"0761";"Män";0;7;1161;1168;0,00599315068493151;0,6
2014;"0761";"Kvinnor";0;35;1132;1167;0,0299914310197087;3
2014;"0763";"Män";0;39;2644;2683;0,0145359672008945;1,45
2014;"0763";"Kvinnor";0;46;2242;2288;0,0201048951048951;2,01
2014;"0764";"Män";0;47;3889;3936;0,0119410569105691;1,19
2014;"0764";"Kvinnor";0;57;2952;3009;0,0189431704885344;1,89
2014;"0765";"Män";0;818;4215;5033;0,162527319690046;16,25
2014;"0765";"Kvinnor";0;873;3672;4545;0,192079207920792;19,21
2014;"0767";"Män";0;48;2804;2852;0,0168302945301543;1,68
2014;"0767";"Kvinnor";0;40;1760;1800;0,0222222222222222;2,22
2014;"0780";"Män";0;829;21213;22042;0,0376100172398149;3,76
2014;"0780";"Kvinnor";0;913;19648;20561;0,0444044550362336;4,44
2014;"0781";"Män";0;481;6391;6872;0,0699941792782305;7
2014;"0781";"Kvinnor";0;383;5223;5606;0,0683196575098109;6,83
2014;"0821";"Män";0;6;684;690;0,00869565217391304;0,87
2014;"0821";"Kvinnor";0;9;843;852;0,0105633802816901;1,06
2014;"0834";"Män";0;13;1248;1261;0,0103092783505155;1,03
2014;"0834";"Kvinnor";0;11;960;971;0,0113285272914521;1,13
2014;"0840";"Män";0;35;2261;2296;0,0152439024390244;1,52
2014;"0840";"Kvinnor";0;88;2131;2219;0,0396575033799009;3,97
2014;"0860";"Män";0;23;2569;2592;0,00887345679012346;0,89
2014;"0860";"Kvinnor";0;26;2148;2174;0,0119595216191352;1,2
2014;"0861";"Män";0;17;2335;2352;0,00722789115646259;0,72
2014;"0861";"Kvinnor";0;27;1879;1906;0,0141657922350472;1,42
2014;"0862";"Män";0;40;2466;2506;0,0159616919393456;1,6
2014;"0862";"Kvinnor";0;40;1638;1678;0,0238379022646007;2,38
2014;"0880";"Män";0;634;14709;15343;0,0413217754024637;4,13
2014;"0880";"Kvinnor";0;832;14748;15580;0,0534017971758665;5,34
2014;"0881";"Män";0;48;3817;3865;0,0124191461836999;1,24
2014;"0881";"Kvinnor";0;72;3145;3217;0,0223811004041032;2,24
2014;"0882";"Män";0;84;7660;7744;0,0108471074380165;1,08
2014;"0882";"Kvinnor";0;162;5777;5939;0,0272773194140428;2,73
2014;"0883";"Män";0;137;7255;7392;0,0185335497835498;1,85
2014;"0883";"Kvinnor";0;171;7033;7204;0,0237368128817324;2,37
2014;"0884";"Män";0;325;3672;3997;0,0813109832374281;8,13
2014;"0884";"Kvinnor";0;313;2804;3117;0,100417067693295;10,04
2014;"0885";"Män";0;60;1891;1951;0,0307534597642235;3,08
2014;"0885";"Kvinnor";0;77;1630;1707;0,0451083772700644;4,51
2014;"0980";"Män";0;446;11995;12441;0,0358492082630014;3,58
2014;"0980";"Kvinnor";0;533;11484;12017;0,0443538320712324;4,44
2014;"1060";"Män";0;31;4019;4050;0,00765432098765432;0,77
2014;"1060";"Kvinnor";0;45;2147;2192;0,020529197080292;2,05
2014;"1080";"Män";0;420;14315;14735;0,0285035629453682;2,85
2014;"1080";"Kvinnor";0;485;12939;13424;0,0361293206197855;3,61
2014;"1081";"Män";0;121;5546;5667;0,0213516851949885;2,14
2014;"1081";"Kvinnor";0;127;4236;4363;0,0291084116433647;2,91
2014;"1082";"Män";0;198;5355;5553;0,0356564019448947;3,57
2014;"1082";"Kvinnor";0;290;5584;5874;0,0493701055498808;4,94
2014;"1083";"Män";0;82;3038;3120;0,0262820512820513;2,63
2014;"1083";"Kvinnor";0;75;2443;2518;0,0297855440826052;2,98
2014;"1214";"Män";0;25;1602;1627;0,0153657037492317;1,54
2014;"1214";"Kvinnor";0;29;1636;1665;0,0174174174174174;1,74
2014;"1230";"Män";0;112;3050;3162;0,0354206198608476;3,54
2014;"1230";"Kvinnor";0;73;2353;2426;0,0300906842539159;3,01
2014;"1231";"Män";0;82;4524;4606;0,0178028658271819;1,78
2014;"1231";"Kvinnor";0;178;2825;3003;0,0592740592740593;5,93
2014;"1233";"Män";0;207;3389;3596;0,0575639599555061;5,76
2014;"1233";"Kvinnor";0;183;3709;3892;0,0470195272353546;4,7
2014;"1256";"Män";0;53;2160;2213;0,0239493899683687;2,39
2014;"1256";"Kvinnor";0;65;1606;1671;0,0388988629563136;3,89
2014;"1257";"Män";0;13;1653;1666;0,0078031212484994;0,78
2014;"1257";"Kvinnor";0;35;1474;1509;0,023194168323393;2,32
2014;"1260";"Män";0;12;2437;2449;0,00489995916700694;0,49
2014;"1260";"Kvinnor";0;20;1875;1895;0,0105540897097625;1,06
2014;"1261";"Män";0;104;3391;3495;0,0297567954220315;2,98
2014;"1261";"Kvinnor";0;187;3355;3542;0,0527950310559006;5,28
2014;"1262";"Män";0;79;2238;2317;0,0340958135520069;3,41
2014;"1262";"Kvinnor";0;101;2697;2798;0,0360972122944961;3,61
2014;"1263";"Män";0;69;3409;3478;0,0198389879240943;1,98
2014;"1263";"Kvinnor";0;93;2623;2716;0,0342415316642121;3,42
2014;"1264";"Män";0;64;1830;1894;0,0337909186906019;3,38
2014;"1264";"Kvinnor";0;64;1715;1779;0,0359752670039348;3,6
2014;"1265";"Män";0;46;2770;2816;0,0163352272727273;1,63
2014;"1265";"Kvinnor";0;60;2449;2509;0,0239139099242726;2,39
2014;"1266";"Män";0;35;2347;2382;0,0146935348446683;1,47
2014;"1266";"Kvinnor";0;52;2233;2285;0,0227571115973742;2,28
2014;"1267";"Män";0;46;1777;1823;0,0252331321996709;2,52
2014;"1267";"Kvinnor";0;71;2286;2357;0,0301230377598642;3,01
2014;"1270";"Män";0;66;2410;2476;0,0266558966074313;2,67
2014;"1270";"Kvinnor";0;79;2045;2124;0,0371939736346516;3,72
2014;"1272";"Män";0;30;2270;2300;0,0130434782608696;1,3
2014;"1272";"Kvinnor";0;40;1721;1761;0,0227143668370244;2,27
2014;"1273";"Män";0;34;2151;2185;0,0155606407322654;1,56
2014;"1273";"Kvinnor";0;47;1850;1897;0,0247759620453347;2,48
2014;"1275";"Män";0;14;1728;1742;0,00803673938002296;0,8
2014;"1275";"Kvinnor";0;11;1150;1161;0,00947459086993971;0,95
2014;"1276";"Män";0;84;2575;2659;0,0315908236179015;3,16
2014;"1276";"Kvinnor";0;64;2077;2141;0,0298925735637553;2,99
2014;"1277";"Män";0;26;2861;2887;0,00900588846553516;0,9
2014;"1277";"Kvinnor";0;105;2466;2571;0,0408401400233372;4,08
2014;"1278";"Män";0;81;3028;3109;0,0260533933740753;2,61
2014;"1278";"Kvinnor";0;131;2597;2728;0,0480205278592375;4,8
2014;"1280";"Män";0;4963;77309;82272;0,060324290159471;6,03
2014;"1280";"Kvinnor";0;5295;69780;75075;0,0705294705294705;7,05
2014;"1281";"Män";0;802;31998;32800;0,0244512195121951;2,45
2014;"1281";"Kvinnor";0;1210;30878;32088;0,037708800797806;3,77
2014;"1282";"Män";0;265;7284;7549;0,0351039872830839;3,51
2014;"1282";"Kvinnor";0;255;6087;6342;0,0402081362346263;4,02
2014;"1283";"Män";0;1641;31698;33339;0,0492216323225052;4,92
2014;"1283";"Kvinnor";0;2056;28649;30705;0,0669597785376974;6,7
2014;"1284";"Män";0;114;3711;3825;0,0298039215686275;2,98
2014;"1284";"Kvinnor";0;149;3517;3666;0,0406437534097109;4,06
2014;"1285";"Män";0;149;5117;5266;0,0282947208507406;2,83
2014;"1285";"Kvinnor";0;160;4640;4800;0,0333333333333333;3,33
2014;"1286";"Män";0;180;5343;5523;0,0325909831613254;3,26
2014;"1286";"Kvinnor";0;265;5620;5885;0,0450297366185217;4,5
2014;"1287";"Män";0;117;6018;6135;0,0190709046454768;1,91
2014;"1287";"Kvinnor";0;204;5966;6170;0,033063209076175;3,31
2014;"1290";"Män";0;497;16637;17134;0,0290066534376094;2,9
2014;"1290";"Kvinnor";0;661;16847;17508;0,037754169522504;3,78
2014;"1291";"Män";0;112;3273;3385;0,0330871491875923;3,31
2014;"1291";"Kvinnor";0;154;3294;3448;0,0446635730858469;4,47
2014;"1292";"Män";0;187;7588;7775;0,0240514469453376;2,41
2014;"1292";"Kvinnor";0;300;7918;8218;0,0365052324166464;3,65
2014;"1293";"Män";0;234;9581;9815;0,023841059602649;2,38
2014;"1293";"Kvinnor";0;245;8460;8705;0,0281447443997702;2,81
2014;"1315";"Män";0;36;2362;2398;0,0150125104253545;1,5
2014;"1315";"Kvinnor";0;39;1763;1802;0,0216426193118757;2,16
2014;"1380";"Män";0;713;21773;22486;0,0317086186960776;3,17
2014;"1380";"Kvinnor";0;890;20662;21552;0,0412954714179658;4,13
2014;"1381";"Män";0;143;3913;4056;0,0352564102564103;3,53
2014;"1381";"Kvinnor";0;139;3448;3587;0,0387510454418734;3,88
2014;"1382";"Män";0;272;9159;9431;0,0288410560916128;2,88
2014;"1382";"Kvinnor";0;394;8556;8950;0,0440223463687151;4,4
2014;"1383";"Män";0;472;13522;13994;0,0337287408889524;3,37
2014;"1383";"Kvinnor";0;767;12325;13092;0,0585853956614727;5,86
2014;"1384";"Män";0;505;9843;10348;0,0488017008117511;4,88
2014;"1384";"Kvinnor";0;862;10994;11856;0,0727058029689609;7,27
2014;"1401";"Män";0;399;6686;7085;0,0563161609033169;5,63
2014;"1401";"Kvinnor";0;236;5680;5916;0,0398918187964841;3,99
2014;"1402";"Män";0;268;5232;5500;0,0487272727272727;4,87
2014;"1402";"Kvinnor";0;444;4834;5278;0,0841227737779462;8,41
2014;"1407";"Män";0;30;1613;1643;0,0182592818015825;1,83
2014;"1407";"Kvinnor";0;51;1543;1594;0,0319949811794228;3,2
2014;"1415";"Män";0;87;6544;6631;0,0131201930327251;1,31
2014;"1415";"Kvinnor";0;208;4350;4558;0,0456340500219394;4,56
2014;"1419";"Män";0;37;2219;2256;0,0164007092198582;1,64
2014;"1419";"Kvinnor";0;62;2163;2225;0,0278651685393258;2,79
2014;"1421";"Män";0;23;2261;2284;0,0100700525394046;1,01
2014;"1421";"Kvinnor";0;33;1956;1989;0,0165912518853695;1,66
2014;"1427";"Män";0;29;1905;1934;0,014994829369183;1,5
2014;"1427";"Kvinnor";0;49;1725;1774;0,0276211950394589;2,76
2014;"1430";"Män";0;73;1777;1850;0,0394594594594595;3,95
2014;"1430";"Kvinnor";0;55;1542;1597;0,0344395742016281;3,44
2014;"1435";"Män";0;80;2500;2580;0,0310077519379845;3,1
2014;"1435";"Kvinnor";0;132;2045;2177;0,0606338998621957;6,06
2014;"1438";"Män";0;10;1074;1084;0,00922509225092251;0,92
2014;"1438";"Kvinnor";0;12;741;753;0,0159362549800797;1,59
2014;"1439";"Män";0;4;1011;1015;0,00394088669950739;0,39
2014;"1439";"Kvinnor";0;7;836;843;0,00830367734282325;0,83
2014;"1440";"Män";0;86;3002;3088;0,0278497409326425;2,78
2014;"1440";"Kvinnor";0;107;3159;3266;0,0327617881200245;3,28
2014;"1441";"Män";0;146;3984;4130;0,0353510895883777;3,54
2014;"1441";"Kvinnor";0;177;4878;5055;0,0350148367952522;3,5
2014;"1442";"Män";0;41;2472;2513;0,0163151611619578;1,63
2014;"1442";"Kvinnor";0;21;1716;1737;0,0120898100172712;1,21
2014;"1443";"Män";0;62;1191;1253;0,0494812450119713;4,95
2014;"1443";"Kvinnor";0;46;1026;1072;0,042910447761194;4,29
2014;"1444";"Män";0;2;721;723;0,00276625172890733;0,28
2014;"1444";"Kvinnor";0;16;712;728;0,021978021978022;2,2
2014;"1445";"Män";0;38;1033;1071;0,0354808590102708;3,55
2014;"1445";"Kvinnor";0;42;826;868;0,0483870967741935;4,84
2014;"1446";"Män";0;23;1842;1865;0,0123324396782842;1,23
2014;"1446";"Kvinnor";0;21;1125;1146;0,0183246073298429;1,83
2014;"1447";"Män";0;10;953;963;0,0103842159916926;1,04
2014;"1447";"Kvinnor";0;13;720;733;0,0177353342428377;1,77
2014;"1452";"Män";0;68;3224;3292;0,0206561360874848;2,07
2014;"1452";"Kvinnor";0;110;2109;2219;0,0495718792248761;4,96
2014;"1460";"Män";0;35;1935;1970;0,0177664974619289;1,78
2014;"1460";"Kvinnor";0;76;1749;1825;0,0416438356164384;4,16
2014;"1461";"Män";0;20;1397;1417;0,0141143260409315;1,41
2014;"1461";"Kvinnor";0;66;1265;1331;0,0495867768595041;4,96
2014;"1462";"Män";0;28;1784;1812;0,0154525386313466;1,55
2014;"1462";"Kvinnor";0;17;1765;1782;0,00953984287317621;0,95
2014;"1463";"Män";0;182;5216;5398;0,0337161911819192;3,37
2014;"1463";"Kvinnor";0;243;4985;5228;0,0464804896710023;4,65
2014;"1465";"Män";0;185;1537;1722;0,107433217189315;10,74
2014;"1465";"Kvinnor";0;129;1436;1565;0,0824281150159744;8,24
2014;"1466";"Män";0;14;2067;2081;0,0067275348390197;0,67
2014;"1466";"Kvinnor";0;15;1494;1509;0,0099403578528827;0,99
2014;"1470";"Män";0;62;4102;4164;0,0148895292987512;1,49
2014;"1470";"Kvinnor";0;66;2579;2645;0,024952741020794;2,5
2014;"1471";"Män";0;32;3039;3071;0,0104200586128297;1,04
2014;"1471";"Kvinnor";0;31;2211;2242;0,0138269402319358;1,38
2014;"1472";"Män";0;26;1648;1674;0,015531660692951;1,55
2014;"1472";"Kvinnor";0;24;1525;1549;0,0154938670109748;1,55
2014;"1473";"Män";0;11;1599;1610;0,00683229813664596;0,68
2014;"1473";"Kvinnor";0;28;1263;1291;0,0216886134779241;2,17
2014;"1480";"Män";0;7287;157473;164760;0,0442279679533867;4,42
2014;"1480";"Kvinnor";0;8879;136691;145570;0,0609947104485814;6,1
2014;"1481";"Män";0;712;18983;19695;0,0361513074384361;3,62
2014;"1481";"Kvinnor";0;909;16351;17260;0,0526651216685979;5,27
2014;"1482";"Män";0;235;7530;7765;0,03026400515132;3,03
2014;"1482";"Kvinnor";0;183;7330;7513;0,024357779848263;2,44
2014;"1484";"Män";0;48;3028;3076;0,0156046814044213;1,56
2014;"1484";"Kvinnor";0;78;2491;2569;0,0303620085636434;3,04
2014;"1485";"Män";0;329;10526;10855;0,0303086135421465;3,03
2014;"1485";"Kvinnor";0;566;10728;11294;0,0501151053656809;5,01
2014;"1486";"Män";0;87;2818;2905;0,0299483648881239;2,99
2014;"1486";"Kvinnor";0;279;2893;3172;0,0879571248423707;8,8
2014;"1487";"Män";0;156;5708;5864;0,0266030013642565;2,66
2014;"1487";"Kvinnor";0;176;6070;6246;0,0281780339417227;2,82
2014;"1488";"Män";0;270;12458;12728;0,0212130735386549;2,12
2014;"1488";"Kvinnor";0;450;12011;12461;0,0361126715351898;3,61
2014;"1489";"Män";0;217;6020;6237;0,0347923681257015;3,48
2014;"1489";"Kvinnor";0;303;7016;7319;0,0413990982374641;4,14
2014;"1490";"Män";0;1995;23929;25924;0,0769557167103842;7,7
2014;"1490";"Kvinnor";0;2475;22674;25149;0,0984134558034117;9,84
2014;"1491";"Män";0;264;4331;4595;0,0574537540805223;5,75
2014;"1491";"Kvinnor";0;381;3396;3777;0,10087370929309;10,09
2014;"1492";"Män";0;34;2134;2168;0,0156826568265683;1,57
2014;"1492";"Kvinnor";0;59;1921;1980;0,0297979797979798;2,98
2014;"1493";"Män";0;95;4224;4319;0,0219958323686038;2,2
2014;"1493";"Kvinnor";0;126;3946;4072;0,030943025540275;3,09
2014;"1494";"Män";0;223;8243;8466;0,0263406567446256;2,63
2014;"1494";"Kvinnor";0;300;7357;7657;0,0391798354446911;3,92
2014;"1495";"Män";0;94;3989;4083;0,0230222875336762;2,3
2014;"1495";"Kvinnor";0;123;3545;3668;0,0335332606324973;3,35
2014;"1496";"Män";0;365;16369;16734;0,0218118800047807;2,18
2014;"1496";"Kvinnor";0;473;13647;14120;0,0334985835694051;3,35
2014;"1497";"Män";0;22;1292;1314;0,0167427701674277;1,67
2014;"1497";"Kvinnor";0;26;1273;1299;0,0200153964588145;2
2014;"1498";"Män";0;42;2287;2329;0,0180334907685702;1,8
2014;"1498";"Kvinnor";0;55;1792;1847;0,0297780184082296;2,98
2014;"1499";"Män";0;225;6105;6330;0,0355450236966825;3,55
2014;"1499";"Kvinnor";0;224;5268;5492;0,0407865986890022;4,08
2014;"1715";"Män";0;32;1623;1655;0,0193353474320242;1,93
2014;"1715";"Kvinnor";0;28;1366;1394;0,0200860832137733;2,01
2014;"1730";"Män";0;14;1500;1514;0,00924702774108322;0,92
2014;"1730";"Kvinnor";0;115;1729;1844;0,0623644251626898;6,24
2014;"1737";"Män";0;40;2393;2433;0,0164406083025072;1,64
2014;"1737";"Kvinnor";0;51;2399;2450;0,0208163265306122;2,08
2014;"1760";"Män";0;1;542;543;0,00184162062615101;0,18
2014;"1760";"Kvinnor";0;5;446;451;0,0110864745011086;1,11
2014;"1761";"Män";0;34;1902;1936;0,0175619834710744;1,76
2014;"1761";"Kvinnor";0;44;1674;1718;0,0256111757857974;2,56
2014;"1762";"Män";0;17;757;774;0,0219638242894057;2,2
2014;"1762";"Kvinnor";0;22;573;595;0,0369747899159664;3,7
2014;"1763";"Män";0;18;1001;1019;0,0176643768400393;1,77
2014;"1763";"Kvinnor";0;23;1245;1268;0,0181388012618297;1,81
2014;"1764";"Män";0;6;1709;1715;0,00349854227405248;0,35
2014;"1764";"Kvinnor";0;15;1122;1137;0,0131926121372032;1,32
2014;"1765";"Män";0;23;1780;1803;0,0127565169162507;1,28
2014;"1765";"Kvinnor";0;94;1677;1771;0,0530773574251835;5,31
2014;"1766";"Män";0;154;2453;2607;0,0590717299578059;5,91
2014;"1766";"Kvinnor";0;128;2065;2193;0,0583675330597355;5,84
2014;"1780";"Män";0;800;22927;23727;0,0337168626459308;3,37
2014;"1780";"Kvinnor";0;1038;22028;23066;0,0450013006156247;4,5
2014;"1781";"Män";0;69;4443;4512;0,0152925531914894;1,53
2014;"1781";"Kvinnor";0;94;3393;3487;0,0269572698594781;2,7
2014;"1782";"Män";0;19;1860;1879;0,010111761575306;1,01
2014;"1782";"Kvinnor";0;33;1651;1684;0,0195961995249406;1,96
2014;"1783";"Män";0;14;2357;2371;0,00590468156895825;0,59
2014;"1783";"Kvinnor";0;36;1771;1807;0,0199225235196458;1,99
2014;"1784";"Män";0;86;5196;5282;0,0162817114729269;1,63
2014;"1784";"Kvinnor";0;133;4424;4557;0,0291858678955453;2,92
2014;"1785";"Män";0;30;2920;2950;0,0101694915254237;1,02
2014;"1785";"Kvinnor";0;54;2177;2231;0,0242043926490363;2,42
2014;"1814";"Män";0;13;863;876;0,0148401826484018;1,48
2014;"1814";"Kvinnor";0;11;912;923;0,0119176598049837;1,19
2014;"1860";"Män";0;17;1202;1219;0,0139458572600492;1,39
2014;"1860";"Kvinnor";0;12;774;786;0,0152671755725191;1,53
2014;"1861";"Män";0;53;3977;4030;0,013151364764268;1,32
2014;"1861";"Kvinnor";0;52;2919;2971;0,0175025244025581;1,75
2014;"1862";"Män";0;5;1472;1477;0,003385240352065;0,34
2014;"1862";"Kvinnor";0;19;1122;1141;0,0166520595968449;1,67
2014;"1863";"Män";0;14;1367;1381;0,0101375814627082;1,01
2014;"1863";"Kvinnor";0;23;1037;1060;0,0216981132075472;2,17
2014;"1864";"Män";0;6;774;780;0,00769230769230769;0,77
2014;"1864";"Kvinnor";0;8;706;714;0,0112044817927171;1,12
2014;"1880";"Män";0;1181;33836;35017;0,0337264757117971;3,37
2014;"1880";"Kvinnor";0;1488;32433;33921;0,0438666312903511;4,39
2014;"1881";"Män";0;96;3487;3583;0,026793190064192;2,68
2014;"1881";"Kvinnor";0;79;3191;3270;0,0241590214067278;2,42
2014;"1882";"Män";0;28;2057;2085;0,0134292565947242;1,34
2014;"1882";"Kvinnor";0;45;1490;1535;0,0293159609120521;2,93
2014;"1883";"Män";0;140;7046;7186;0,0194823267464514;1,95
2014;"1883";"Kvinnor";0;170;6251;6421;0,0264756268494004;2,65
2014;"1884";"Män";0;26;1428;1454;0,0178817056396149;1,79
2014;"1884";"Kvinnor";0;59;1365;1424;0,0414325842696629;4,14
2014;"1885";"Män";0;80;4797;4877;0,016403526758253;1,64
2014;"1885";"Kvinnor";0;69;4419;4488;0,0153743315508021;1,54
2014;"1904";"Män";0;8;845;853;0,00937866354044549;0,94
2014;"1904";"Kvinnor";0;8;579;587;0,0136286201022147;1,36
2014;"1907";"Män";0;13;1428;1441;0,00902151283830673;0,9
2014;"1907";"Kvinnor";0;22;1109;1131;0,0194518125552608;1,95
2014;"1960";"Män";0;10;1099;1109;0,00901713255184851;0,9
2014;"1960";"Kvinnor";0;11;967;978;0,0112474437627812;1,12
2014;"1961";"Män";0;36;2277;2313;0,0155642023346304;1,56
2014;"1961";"Kvinnor";0;24;2223;2247;0,0106809078771696;1,07
2014;"1962";"Män";0;13;850;863;0,015063731170336;1,51
2014;"1962";"Kvinnor";0;15;648;663;0,0226244343891403;2,26
2014;"1980";"Män";0;1024;34137;35161;0,0291231762464094;2,91
2014;"1980";"Kvinnor";0;1365;30122;31487;0,0433512243147966;4,34
2014;"1981";"Män";0;81;3534;3615;0,0224066390041494;2,24
2014;"1981";"Kvinnor";0;143;3284;3427;0,0417274584184418;4,17
2014;"1982";"Män";0;34;3415;3449;0,00985792983473471;0,99
2014;"1982";"Kvinnor";0;49;2731;2780;0,0176258992805755;1,76
2014;"1983";"Män";0;85;5726;5811;0,0146274307348133;1,46
2014;"1983";"Kvinnor";0;96;4732;4828;0,019884009942005;1,99
2014;"1984";"Män";0;22;2746;2768;0,00794797687861272;0,79
2014;"1984";"Kvinnor";0;36;2171;2207;0,0163117353874037;1,63
2014;"2021";"Män";0;11;1231;1242;0,00885668276972625;0,89
2014;"2021";"Kvinnor";0;20;1056;1076;0,0185873605947955;1,86
2014;"2023";"Män";0;54;2695;2749;0,0196435067297199;1,96
2014;"2023";"Kvinnor";0;65;2393;2458;0,0264442636289666;2,64
2014;"2026";"Män";0;19;1208;1227;0,0154849225753871;1,55
2014;"2026";"Kvinnor";0;13;1218;1231;0,0105605199025183;1,06
2014;"2029";"Män";0;87;3160;3247;0,0267939636587619;2,68
2014;"2029";"Kvinnor";0;80;2871;2951;0,0271094544222298;2,71
2014;"2031";"Män";0;58;1644;1702;0,0340775558166862;3,41
2014;"2031";"Kvinnor";0;73;1568;1641;0,04448507007922;4,45
2014;"2034";"Män";0;28;1029;1057;0,0264900662251656;2,65
2014;"2034";"Kvinnor";0;18;895;913;0,0197152245345016;1,97
2014;"2039";"Män";0;12;1338;1350;0,00888888888888889;0,89
2014;"2039";"Kvinnor";0;17;1188;1205;0,0141078838174274;1,41
2014;"2061";"Män";0;15;1625;1640;0,00914634146341463;0,91
2014;"2061";"Kvinnor";0;21;1151;1172;0,0179180887372014;1,79
2014;"2062";"Män";0;88;4849;4937;0,0178245898318817;1,78
2014;"2062";"Kvinnor";0;156;4528;4684;0,0333048676345004;3,33
2014;"2080";"Män";0;725;11124;11849;0,0611865980251498;6,12
2014;"2080";"Kvinnor";0;681;12652;13333;0,0510762769069227;5,11
2014;"2081";"Män";0;154;13964;14118;0,0109080606318175;1,09
2014;"2081";"Kvinnor";0;387;10316;10703;0,0361580865177987;3,62
2014;"2082";"Män";0;20;1441;1461;0,0136892539356605;1,37
2014;"2082";"Kvinnor";0;31;1538;1569;0,0197578075207138;1,98
2014;"2083";"Män";0;46;3183;3229;0,0142458965624032;1,42
2014;"2083";"Kvinnor";0;67;2678;2745;0,024408014571949;2,44
2014;"2084";"Män";0;108;5014;5122;0,0210855134713003;2,11
2014;"2084";"Kvinnor";0;119;3843;3962;0,0300353356890459;3
2014;"2085";"Män";0;72;6472;6544;0,0110024449877751;1,1
2014;"2085";"Kvinnor";0;88;5046;5134;0,0171406310868718;1,71
2014;"2101";"Män";0;10;888;898;0,0111358574610245;1,11
2014;"2101";"Kvinnor";0;11;836;847;0,012987012987013;1,3
2014;"2104";"Män";0;13;2027;2040;0,00637254901960784;0,64
2014;"2104";"Kvinnor";0;27;1535;1562;0,0172855313700384;1,73
2014;"2121";"Män";0;18;2782;2800;0,00642857142857143;0,64
2014;"2121";"Kvinnor";0;41;1850;1891;0,0216816499206769;2,17
2014;"2132";"Män";0;14;1417;1431;0,00978336827393431;0,98
2014;"2132";"Kvinnor";0;20;1250;1270;0,015748031496063;1,57
2014;"2161";"Män";0;128;3677;3805;0,0336399474375821;3,36
2014;"2161";"Kvinnor";0;185;3205;3390;0,0545722713864307;5,46
2014;"2180";"Män";0;692;21127;21819;0,0317154773362666;3,17
2014;"2180";"Kvinnor";0;935;19916;20851;0,0448419740060429;4,48
2014;"2181";"Män";0;74;9188;9262;0,00798963506801987;0,8
2014;"2181";"Kvinnor";0;116;6721;6837;0,0169665057773877;1,7
2014;"2182";"Män";0;119;4656;4775;0,0249214659685864;2,49
2014;"2182";"Kvinnor";0;173;3970;4143;0,0417571807868694;4,18
2014;"2183";"Män";0;125;4938;5063;0,0246889196128777;2,47
2014;"2183";"Kvinnor";0;163;4936;5099;0,0319670523632085;3,2
2014;"2184";"Män";0;172;7722;7894;0,0217887002786927;2,18
2014;"2184";"Kvinnor";0;218;7254;7472;0,0291755888650964;2,92
2014;"2260";"Män";0;53;1958;2011;0,026355047240179;2,64
2014;"2260";"Kvinnor";0;63;1428;1491;0,0422535211267606;4,23
2014;"2262";"Män";0;30;2832;2862;0,010482180293501;1,05
2014;"2262";"Kvinnor";0;29;1972;2001;0,0144927536231884;1,45
2014;"2280";"Män";0;172;4278;4450;0,0386516853932584;3,87
2014;"2280";"Kvinnor";0;214;4435;4649;0,0460314046031405;4,6
2014;"2281";"Män";0;604;23265;23869;0,0253047886379823;2,53
2014;"2281";"Kvinnor";0;894;21141;22035;0,040571817562968;4,06
2014;"2282";"Män";0;39;3787;3826;0,0101934134866702;1,02
2014;"2282";"Kvinnor";0;66;3118;3184;0,0207286432160804;2,07
2014;"2283";"Män";0;80;3607;3687;0,021697857336588;2,17
2014;"2283";"Kvinnor";0;116;3341;3457;0,0335551055828753;3,36
2014;"2284";"Män";0;245;12856;13101;0,0187008625295779;1,87
2014;"2284";"Kvinnor";0;325;10606;10931;0,0297319549903943;2,97
2014;"2303";"Män";0;7;1130;1137;0,00615655233069481;0,62
2014;"2303";"Kvinnor";0;11;927;938;0,011727078891258;1,17
2014;"2305";"Män";0;19;1029;1048;0,0181297709923664;1,81
2014;"2305";"Kvinnor";0;15;911;926;0,0161987041036717;1,62
2014;"2309";"Män";0;26;2278;2304;0,0112847222222222;1,13
2014;"2309";"Kvinnor";0;18;1935;1953;0,00921658986175115;0,92
2014;"2313";"Män";0;20;2424;2444;0,00818330605564648;0,82
2014;"2313";"Kvinnor";0;33;1998;2031;0,0162481536189069;1,62
2014;"2321";"Män";0;64;2463;2527;0,0253264740799367;2,53
2014;"2321";"Kvinnor";0;91;2201;2292;0,0397033158813264;3,97
2014;"2326";"Män";0;14;1329;1343;0,0104244229337305;1,04
2014;"2326";"Kvinnor";0;9;1109;1118;0,00805008944543828;0,81
2014;"2361";"Män";0;15;2388;2403;0,00624219725343321;0,62
2014;"2361";"Kvinnor";0;21;2112;2133;0,00984528832630099;0,98
2014;"2380";"Män";0;604;14779;15383;0,039264122732887;3,93
2014;"2380";"Kvinnor";0;625;15098;15723;0,0397506837117598;3,98
2014;"2401";"Män";0;12;978;990;0,0121212121212121;1,21
2014;"2401";"Kvinnor";0;19;907;926;0,0205183585313175;2,05
2014;"2403";"Män";0;0;315;315;0;0
2014;"2403";"Kvinnor";0;5;316;321;0,0155763239875389;1,56
2014;"2404";"Män";0;15;1243;1258;0,0119236883942766;1,19
2014;"2404";"Kvinnor";0;20;873;893;0,0223964165733483;2,24
2014;"2409";"Män";0;12;1093;1105;0,0108597285067873;1,09
2014;"2409";"Kvinnor";0;9;1032;1041;0,00864553314121038;0,86
2014;"2417";"Män";0;15;821;836;0,0179425837320574;1,79
2014;"2417";"Kvinnor";0;26;724;750;0,0346666666666667;3,47
2014;"2418";"Män";0;3;632;635;0,0047244094488189;0,47
2014;"2418";"Kvinnor";0;20;559;579;0,0345423143350604;3,45
2014;"2421";"Män";0;13;1243;1256;0,0103503184713376;1,04
2014;"2421";"Kvinnor";0;21;1125;1146;0,0183246073298429;1,83
2014;"2422";"Män";0;2;477;479;0,00417536534446764;0,42
2014;"2422";"Kvinnor";0;6;434;440;0,0136363636363636;1,36
2014;"2425";"Män";0;3;524;527;0,00569259962049336;0,57
2014;"2425";"Kvinnor";0;10;474;484;0,0206611570247934;2,07
2014;"2460";"Män";0;5;1217;1222;0,00409165302782324;0,41
2014;"2460";"Kvinnor";0;17;1049;1066;0,0159474671669794;1,59
2014;"2462";"Män";0;34;1064;1098;0,0309653916211293;3,1
2014;"2462";"Kvinnor";0;32;1160;1192;0,0268456375838926;2,68
2014;"2463";"Män";0;1;457;458;0,00218340611353712;0,22
2014;"2463";"Kvinnor";0;10;424;434;0,0230414746543779;2,3
2014;"2480";"Män";0;1013;29190;30203;0,0335397145978876;3,35
2014;"2480";"Kvinnor";0;1116;27167;28283;0,039458331860128;3,95
2014;"2481";"Män";0;44;2748;2792;0,0157593123209169;1,58
2014;"2481";"Kvinnor";0;57;2570;2627;0,0216977540921203;2,17
2014;"2482";"Män";0;332;16472;16804;0,019757200666508;1,98
2014;"2482";"Kvinnor";0;464;13545;14009;0,0331215647084017;3,31
2014;"2505";"Män";0;16;1340;1356;0,0117994100294985;1,18
2014;"2505";"Kvinnor";0;33;1225;1258;0,0262321144674086;2,62
2014;"2506";"Män";0;6;781;787;0,00762388818297332;0,76
2014;"2506";"Kvinnor";0;16;605;621;0,0257648953301127;2,58
2014;"2510";"Män";0;25;1007;1032;0,0242248062015504;2,42
2014;"2510";"Kvinnor";0;45;857;902;0,0498891352549889;4,99
2014;"2513";"Män";0;4;715;719;0,00556328233657858;0,56
2014;"2513";"Kvinnor";0;16;651;667;0,0239880059970015;2,4
2014;"2514";"Män";0;64;3119;3183;0,0201068174677977;2,01
2014;"2514";"Kvinnor";0;109;2816;2925;0,0372649572649573;3,73
2014;"2518";"Män";0;16;721;737;0,0217096336499322;2,17
2014;"2518";"Kvinnor";0;19;672;691;0,0274963820549928;2,75
2014;"2521";"Män";0;31;1363;1394;0,0222381635581062;2,22
2014;"2521";"Kvinnor";0;23;1068;1091;0,0210815765352887;2,11
2014;"2523";"Män";0;59;5308;5367;0,0109931060182597;1,1
2014;"2523";"Kvinnor";0;67;3967;4034;0,0166088249876054;1,66
2014;"2560";"Män";0;4;1412;1416;0,00282485875706215;0,28
2014;"2560";"Kvinnor";0;20;1343;1363;0,0146735143066764;1,47
2014;"2580";"Män";0;710;20555;21265;0,0333881965671291;3,34
2014;"2580";"Kvinnor";0;913;17384;18297;0,0498988905285019;4,99
2014;"2581";"Män";0;188;8427;8615;0,0218224027858387;2,18
2014;"2581";"Kvinnor";0;286;7223;7509;0,0380876281795179;3,81
2014;"2582";"Män";0;68;5394;5462;0,0124496521420725;1,24
2014;"2582";"Kvinnor";0;116;4586;4702;0,024670353041259;2,47
2014;"2583";"Män";0;32;1461;1493;0,0214333556597455;2,14
2014;"2583";"Kvinnor";0;41;1538;1579;0,025965801139962;2,6
2014;"2584";"Män";0;122;7155;7277;0,0167651504740965;1,68
2014;"2584";"Kvinnor";0;293;5532;5825;0,0503004291845494;5,03
2014;"9999";"Män";0;1669;163911;165580;0,0100797197729194;1,01
2014;"9999";"Kvinnor";0;2201;177370;179571;0,0122569902712576;1,23
2015;"0114";"Män";0;153;7304;7457;0,0205176344374413;2,05
2015;"0114";"Kvinnor";0;228;6442;6670;0,0341829085457271;3,42
2015;"0115";"Män";0;94;3941;4035;0,0232961586121437;2,33
2015;"0115";"Kvinnor";0;94;3714;3808;0,0246848739495798;2,47
2015;"0117";"Män";0;163;4676;4839;0,0336846455879314;3,37
2015;"0117";"Kvinnor";0;200;4804;5004;0,0399680255795364;4
2015;"0120";"Män";0;196;5310;5506;0,0355975299673084;3,56
2015;"0120";"Kvinnor";0;244;5122;5366;0,0454714871412598;4,55
2015;"0123";"Män";0;416;13365;13781;0,0301864886437849;3,02
2015;"0123";"Kvinnor";0;527;9243;9770;0,0539406345957011;5,39
2015;"0125";"Män";0;132;4049;4181;0,0315713944032528;3,16
2015;"0125";"Kvinnor";0;148;3695;3843;0,0385115794951861;3,85
2015;"0126";"Män";0;626;21175;21801;0,0287142791615064;2,87
2015;"0126";"Kvinnor";0;541;21903;22444;0,0241044377116379;2,41
2015;"0127";"Män";0;392;12192;12584;0,0311506675143039;3,12
2015;"0127";"Kvinnor";0;416;9500;9916;0,0419524001613554;4,2
2015;"0128";"Män";0;45;1168;1213;0,0370981038746908;3,71
2015;"0128";"Kvinnor";0;41;1482;1523;0,0269205515430072;2,69
2015;"0136";"Män";0;232;14456;14688;0,0157952069716776;1,58
2015;"0136";"Kvinnor";0;333;10787;11120;0,0299460431654676;2,99
2015;"0138";"Män";0;186;5237;5423;0,0342983588419694;3,43
2015;"0138";"Kvinnor";0;204;4715;4919;0,0414718438707054;4,15
2015;"0139";"Män";0;54;4907;4961;0,0108849022374521;1,09
2015;"0139";"Kvinnor";0;52;3226;3278;0,0158633312995729;1,59
2015;"0140";"Män";0;18;1257;1275;0,0141176470588235;1,41
2015;"0140";"Kvinnor";0;20;963;983;0,0203458799593082;2,03
2015;"0160";"Män";0;478;11743;12221;0,0391130022093118;3,91
2015;"0160";"Kvinnor";0;764;10586;11350;0,0673127753303965;6,73
2015;"0162";"Män";0;177;6657;6834;0,0258999122036874;2,59
2015;"0162";"Kvinnor";0;265;10524;10789;0,0245620539438317;2,46
2015;"0163";"Män";0;321;12517;12838;0,025003894687646;2,5
2015;"0163";"Kvinnor";0;487;11196;11683;0,0416844988444749;4,17
2015;"0180";"Män";0;31069;302523;333592;0,0931347274514976;9,31
2015;"0180";"Kvinnor";0;36426;272859;309285;0,117774867840341;11,78
2015;"0181";"Män";0;511;25310;25821;0,0197900933348825;1,98
2015;"0181";"Kvinnor";0;548;19148;19696;0,0278229082047116;2,78
2015;"0182";"Män";0;1003;15587;16590;0,0604581072935503;6,05
2015;"0182";"Kvinnor";0;1279;14871;16150;0,0791950464396285;7,92
2015;"0183";"Män";0;260;11228;11488;0,0226323119777159;2,26
2015;"0183";"Kvinnor";0;238;10137;10375;0,0229397590361446;2,29
2015;"0184";"Män";0;1132;38708;39840;0,0284136546184739;2,84
2015;"0184";"Kvinnor";0;1302;37753;39055;0,0333376008193573;3,33
2015;"0186";"Män";0;442;4722;5164;0,0855925639039504;8,56
2015;"0186";"Kvinnor";0;459;5632;6091;0,0753570842226235;7,54
2015;"0187";"Män";0;65;1094;1159;0,0560828300258844;5,61
2015;"0187";"Kvinnor";0;69;1361;1430;0,0482517482517483;4,83
2015;"0188";"Män";0;213;9703;9916;0,0214804356595401;2,15
2015;"0188";"Kvinnor";0;251;9916;10167;0,0246877151568801;2,47
2015;"0191";"Män";0;174;15747;15921;0,0109289617486339;1,09
2015;"0191";"Kvinnor";0;303;11440;11743;0,0258026058077152;2,58
2015;"0192";"Män";0;70;3053;3123;0,0224143451809158;2,24
2015;"0192";"Kvinnor";0;114;3136;3250;0,0350769230769231;3,51
2015;"0305";"Män";0;44;2480;2524;0,01743264659271;1,74
2015;"0305";"Kvinnor";0;58;2274;2332;0,0248713550600343;2,49
2015;"0319";"Män";0;13;1197;1210;0,0107438016528926;1,07
2015;"0319";"Kvinnor";0;21;1037;1058;0,0198487712665406;1,98
2015;"0330";"Män";0;43;1740;1783;0,0241166573191251;2,41
2015;"0330";"Kvinnor";0;49;1780;1829;0,0267905959540733;2,68
2015;"0331";"Män";0;144;1674;1818;0,0792079207920792;7,92
2015;"0331";"Kvinnor";0;122;1713;1835;0,0664850136239782;6,65
2015;"0360";"Män";0;54;3215;3269;0,0165188130926889;1,65
2015;"0360";"Kvinnor";0;45;2599;2644;0,0170196671709531;1,7
2015;"0380";"Män";0;1831;44372;46203;0,0396294612903924;3,96
2015;"0380";"Kvinnor";0;2312;46447;48759;0,0474168871387846;4,74
2015;"0381";"Män";0;140;8173;8313;0,0168410922651269;1,68
2015;"0381";"Kvinnor";0;226;7098;7324;0,0308574549426543;3,09
2015;"0382";"Män";0;41;5218;5259;0,00779615896558281;0,78
2015;"0382";"Kvinnor";0;47;3760;3807;0,0123456790123457;1,23
2015;"0428";"Män";0;70;1358;1428;0,0490196078431373;4,9
2015;"0428";"Kvinnor";0;120;1190;1310;0,0916030534351145;9,16
2015;"0461";"Män";0;34;1084;1118;0,0304114490161002;3,04
2015;"0461";"Kvinnor";0;47;1437;1484;0,0316711590296496;3,17
2015;"0480";"Män";0;251;10512;10763;0,0233206355105454;2,33
2015;"0480";"Kvinnor";0;383;10738;11121;0,0344393489794083;3,44
2015;"0481";"Män";0;21;3264;3285;0,00639269406392694;0,64
2015;"0481";"Kvinnor";0;25;1821;1846;0,0135427952329361;1,35
2015;"0482";"Män";0;43;2566;2609;0,0164814105021081;1,65
2015;"0482";"Kvinnor";0;53;2325;2378;0,0222876366694701;2,23
2015;"0483";"Män";0;129;6443;6572;0,0196287279367012;1,96
2015;"0483";"Kvinnor";0;183;5834;6017;0,0304138274887818;3,04
2015;"0484";"Män";0;595;19636;20231;0,029410310909001;2,94
2015;"0484";"Kvinnor";0;842;19095;19937;0,0422330340572804;4,22
2015;"0486";"Män";0;139;4918;5057;0,0274866521653154;2,75
2015;"0486";"Kvinnor";0;186;4831;5017;0,0370739485748455;3,71
2015;"0488";"Män";0;102;1677;1779;0,0573355817875211;5,73
2015;"0488";"Kvinnor";0;96;1583;1679;0,0571768910065515;5,72
2015;"0509";"Män";0;34;804;838;0,0405727923627685;4,06
2015;"0509";"Kvinnor";0;20;710;730;0,0273972602739726;2,74
2015;"0512";"Män";0;12;602;614;0,0195439739413681;1,95
2015;"0512";"Kvinnor";0;16;430;446;0,0358744394618834;3,59
2015;"0513";"Män";0;29;1576;1605;0,0180685358255452;1,81
2015;"0513";"Kvinnor";0;31;1410;1441;0,0215128383067314;2,15
2015;"0560";"Män";0;5;968;973;0,00513874614594039;0,51
2015;"0560";"Kvinnor";0;7;592;599;0,011686143572621;1,17
2015;"0561";"Män";0;49;1594;1643;0,0298234936092514;2,98
2015;"0561";"Kvinnor";0;48;1262;1310;0,0366412213740458;3,66
2015;"0562";"Män";0;39;5302;5341;0,0073020033701554;0,73
2015;"0562";"Kvinnor";0;45;3522;3567;0,0126156433978133;1,26
2015;"0563";"Män";0;25;1329;1354;0,0184638109305761;1,85
2015;"0563";"Kvinnor";0;30;1038;1068;0,0280898876404494;2,81
2015;"0580";"Män";0;900;39820;40720;0,0221021611001965;2,21
2015;"0580";"Kvinnor";0;1150;35207;36357;0,0316307726160024;3,16
2015;"0581";"Män";0;964;29718;30682;0,0314190730721596;3,14
2015;"0581";"Kvinnor";0;1256;27781;29037;0,0432551572132107;4,33
2015;"0582";"Män";0;52;1971;2023;0,0257043994068216;2,57
2015;"0582";"Kvinnor";0;55;1776;1831;0,0300382304751502;3
2015;"0583";"Män";0;175;6957;7132;0,0245372966909703;2,45
2015;"0583";"Kvinnor";0;198;6862;7060;0,0280453257790368;2,8
2015;"0584";"Män";0;51;1487;1538;0,0331599479843953;3,32
2015;"0584";"Kvinnor";0;49;1299;1348;0,0363501483679525;3,64
2015;"0586";"Män";0;65;6305;6370;0,0102040816326531;1,02
2015;"0586";"Kvinnor";0;108;4431;4539;0,0237937871777925;2,38
2015;"0604";"Män";0;14;1378;1392;0,0100574712643678;1,01
2015;"0604";"Kvinnor";0;15;970;985;0,0152284263959391;1,52
2015;"0617";"Män";0;42;3301;3343;0,0125635656595872;1,26
2015;"0617";"Kvinnor";0;51;2299;2350;0,0217021276595745;2,17
2015;"0642";"Män";0;14;1374;1388;0,0100864553314121;1,01
2015;"0642";"Kvinnor";0;58;1165;1223;0,0474243663123467;4,74
2015;"0643";"Män";0;27;1791;1818;0,0148514851485149;1,49
2015;"0643";"Kvinnor";0;36;1551;1587;0,0226843100189036;2,27
2015;"0662";"Män";0;83;7506;7589;0,0109368823296877;1,09
2015;"0662";"Kvinnor";0;140;5666;5806;0,0241129865656218;2,41
2015;"0665";"Män";0;39;2987;3026;0,0128883013879709;1,29
2015;"0665";"Kvinnor";0;42;2054;2096;0,0200381679389313;2
2015;"0680";"Män";0;1007;33738;34745;0,0289825874226507;2,9
2015;"0680";"Kvinnor";0;1194;29915;31109;0,0383811758655052;3,84
2015;"0682";"Män";0;111;6468;6579;0,0168718650250798;1,69
2015;"0682";"Kvinnor";0;131;5274;5405;0,0242368177613321;2,42
2015;"0683";"Män";0;152;8383;8535;0,017809021675454;1,78
2015;"0683";"Kvinnor";0;238;7533;7771;0,0306266889718183;3,06
2015;"0684";"Män";0;26;2313;2339;0,0111158614792646;1,11
2015;"0684";"Kvinnor";0;26;1761;1787;0,0145495243424734;1,45
2015;"0685";"Män";0;70;6579;6649;0,0105278989321703;1,05
2015;"0685";"Kvinnor";0;104;4795;4899;0,021228822208614;2,12
2015;"0686";"Män";0;56;4426;4482;0,0124944221329764;1,25
2015;"0686";"Kvinnor";0;100;4367;4467;0,0223863890754421;2,24
2015;"0687";"Män";0;109;4202;4311;0,0252841568081652;2,53
2015;"0687";"Kvinnor";0;109;3394;3503;0,0311161861261776;3,11
2015;"0760";"Män";0;14;2526;2540;0,00551181102362205;0,55
2015;"0760";"Kvinnor";0;16;1781;1797;0,00890372843628269;0,89
2015;"0761";"Män";0;6;1179;1185;0,00506329113924051;0,51
2015;"0761";"Kvinnor";0;35;1148;1183;0,029585798816568;2,96
2015;"0763";"Män";0;37;2675;2712;0,0136430678466077;1,36
2015;"0763";"Kvinnor";0;44;2212;2256;0,0195035460992908;1,95
2015;"0764";"Män";0;51;3880;3931;0,0129737980157721;1,3
2015;"0764";"Kvinnor";0;59;3036;3095;0,0190630048465267;1,91
2015;"0765";"Män";0;903;4346;5249;0,172032768146314;17,2
2015;"0765";"Kvinnor";0;971;3836;4807;0,201997087580612;20,2
2015;"0767";"Män";0;40;2897;2937;0,0136193394620361;1,36
2015;"0767";"Kvinnor";0;39;1763;1802;0,0216426193118757;2,16
2015;"0780";"Män";0;799;21457;22256;0,0359004313443566;3,59
2015;"0780";"Kvinnor";0;966;20048;21014;0,0459693537641572;4,6
2015;"0781";"Män";0;311;6631;6942;0,0447997695188706;4,48
2015;"0781";"Kvinnor";0;218;5435;5653;0,0385635945515655;3,86
2015;"0821";"Män";0;6;726;732;0,00819672131147541;0,82
2015;"0821";"Kvinnor";0;8;856;864;0,00925925925925926;0,93
2015;"0834";"Män";0;11;1208;1219;0,00902378999179656;0,9
2015;"0834";"Kvinnor";0;13;981;994;0,0130784708249497;1,31
2015;"0840";"Män";0;36;2286;2322;0,0155038759689922;1,55
2015;"0840";"Kvinnor";0;89;2249;2338;0,0380667236954662;3,81
2015;"0860";"Män";0;24;2540;2564;0,0093603744149766;0,94
2015;"0860";"Kvinnor";0;26;2146;2172;0,0119705340699816;1,2
2015;"0861";"Män";0;18;2302;2320;0,00775862068965517;0,78
2015;"0861";"Kvinnor";0;27;1869;1896;0,0142405063291139;1,42
2015;"0862";"Män";0;38;2493;2531;0,0150138285262742;1,5
2015;"0862";"Kvinnor";0;35;1644;1679;0,0208457415128052;2,08
2015;"0880";"Män";0;619;15207;15826;0,0391128522684191;3,91
2015;"0880";"Kvinnor";0;814;14886;15700;0,0518471337579618;5,18
2015;"0881";"Män";0;47;3796;3843;0,0122300286234712;1,22
2015;"0881";"Kvinnor";0;70;3045;3115;0,0224719101123595;2,25
2015;"0882";"Män";0;76;7873;7949;0,0095609510630268;0,96
2015;"0882";"Kvinnor";0;155;5770;5925;0,0261603375527426;2,62
2015;"0883";"Män";0;129;7119;7248;0,0177980132450331;1,78
2015;"0883";"Kvinnor";0;166;7022;7188;0,0230940456316082;2,31
2015;"0884";"Män";0;325;3696;4021;0,0808256652573987;8,08
2015;"0884";"Kvinnor";0;340;2788;3128;0,108695652173913;10,87
2015;"0885";"Män";0;57;1898;1955;0,029156010230179;2,92
2015;"0885";"Kvinnor";0;77;1629;1706;0,0451348182883939;4,51
2015;"0980";"Män";0;456;12167;12623;0,0361245345797354;3,61
2015;"0980";"Kvinnor";0;542;11571;12113;0,0447453149508792;4,47
2015;"1060";"Män";0;28;4128;4156;0,00673724735322425;0,67
2015;"1060";"Kvinnor";0;39;2252;2291;0,0170231340026189;1,7
2015;"1080";"Män";0;437;14465;14902;0,0293249228291504;2,93
2015;"1080";"Kvinnor";0;492;13109;13601;0,0361738107492096;3,62
2015;"1081";"Män";0;108;5430;5538;0,019501625135428;1,95
2015;"1081";"Kvinnor";0;121;4172;4293;0,028185418122525;2,82
2015;"1082";"Män";0;192;5517;5709;0,0336311087756174;3,36
2015;"1082";"Kvinnor";0;265;5667;5932;0,0446729602157788;4,47
2015;"1083";"Män";0;63;3060;3123;0,0201729106628242;2,02
2015;"1083";"Kvinnor";0;71;2490;2561;0,027723545490043;2,77
2015;"1214";"Män";0;26;1600;1626;0,015990159901599;1,6
2015;"1214";"Kvinnor";0;29;1675;1704;0,017018779342723;1,7
2015;"1230";"Män";0;97;3206;3303;0,0293672419013018;2,94
2015;"1230";"Kvinnor";0;70;2486;2556;0,0273865414710485;2,74
2015;"1231";"Män";0;71;4489;4560;0,0155701754385965;1,56
2015;"1231";"Kvinnor";0;188;2859;3047;0,0617000328191664;6,17
2015;"1233";"Män";0;174;3558;3732;0,0466237942122186;4,66
2015;"1233";"Kvinnor";0;193;3834;4027;0,0479264961509809;4,79
2015;"1256";"Män";0;51;2213;2264;0,0225265017667845;2,25
2015;"1256";"Kvinnor";0;67;1640;1707;0,0392501464557704;3,93
2015;"1257";"Män";0;12;1711;1723;0,00696459663377829;0,7
2015;"1257";"Kvinnor";0;28;1549;1577;0,0177552314521243;1,78
2015;"1260";"Män";0;13;2502;2515;0,00516898608349901;0,52
2015;"1260";"Kvinnor";0;16;1965;1981;0,00807672892478546;0,81
2015;"1261";"Män";0;108;3433;3541;0,03049985879695;3,05
2015;"1261";"Kvinnor";0;179;3469;3648;0,0490679824561404;4,91
2015;"1262";"Män";0;74;2396;2470;0,0299595141700405;3
2015;"1262";"Kvinnor";0;109;2802;2911;0,037444177258674;3,74
2015;"1263";"Män";0;66;3544;3610;0,0182825484764543;1,83
2015;"1263";"Kvinnor";0;101;2592;2693;0,0375046416635722;3,75
2015;"1264";"Män";0;59;1906;1965;0,0300254452926209;3
2015;"1264";"Kvinnor";0;62;1721;1783;0,0347728547392036;3,48
2015;"1265";"Män";0;41;2728;2769;0,0148067894546768;1,48
2015;"1265";"Kvinnor";0;58;2445;2503;0,0231721933679584;2,32
2015;"1266";"Män";0;40;2315;2355;0,0169851380042463;1,7
2015;"1266";"Kvinnor";0;65;2197;2262;0,028735632183908;2,87
2015;"1267";"Män";0;50;1896;1946;0,025693730729702;2,57
2015;"1267";"Kvinnor";0;69;2344;2413;0,0285951098217986;2,86
2015;"1270";"Män";0;61;2378;2439;0,025010250102501;2,5
2015;"1270";"Kvinnor";0;88;2152;2240;0,0392857142857143;3,93
2015;"1272";"Män";0;31;2197;2228;0,0139138240574506;1,39
2015;"1272";"Kvinnor";0;36;1698;1734;0,0207612456747405;2,08
2015;"1273";"Män";0;32;2103;2135;0,0149882903981265;1,5
2015;"1273";"Kvinnor";0;44;1838;1882;0,0233793836344315;2,34
2015;"1275";"Män";0;10;1745;1755;0,0056980056980057;0,57
2015;"1275";"Kvinnor";0;10;1185;1195;0,00836820083682008;0,84
2015;"1276";"Män";0;78;2655;2733;0,0285400658616905;2,85
2015;"1276";"Kvinnor";0;60;2162;2222;0,027002700270027;2,7
2015;"1277";"Män";0;26;2886;2912;0,00892857142857143;0,89
2015;"1277";"Kvinnor";0;116;2477;2593;0,04473582722715;4,47
2015;"1278";"Män";0;92;3068;3160;0,0291139240506329;2,91
2015;"1278";"Kvinnor";0;123;2641;2764;0,0445007235890014;4,45
2015;"1280";"Män";0;4987;79153;84140;0,059270263845971;5,93
2015;"1280";"Kvinnor";0;5421;72513;77934;0,0695588574948033;6,96
2015;"1281";"Män";0;802;31820;32622;0,0245846361351235;2,46
2015;"1281";"Kvinnor";0;1196;31319;32515;0,0367830232200523;3,68
2015;"1282";"Män";0;240;7703;7943;0,0302152838977716;3,02
2015;"1282";"Kvinnor";0;257;6122;6379;0,0402884464649632;4,03
2015;"1283";"Män";0;1519;32210;33729;0,0450354294524;4,5
2015;"1283";"Kvinnor";0;1992;28922;30914;0,0644368247396002;6,44
2015;"1284";"Män";0;130;3726;3856;0,0337136929460581;3,37
2015;"1284";"Kvinnor";0;178;3575;3753;0,0474287236877165;4,74
2015;"1285";"Män";0;156;5116;5272;0,0295902883156297;2,96
2015;"1285";"Kvinnor";0;135;4804;4939;0,0273334683134238;2,73
2015;"1286";"Män";0;172;5404;5576;0,0308464849354376;3,08
2015;"1286";"Kvinnor";0;259;5759;6018;0,0430375540046527;4,3
2015;"1287";"Män";0;96;6148;6244;0,0153747597693786;1,54
2015;"1287";"Kvinnor";0;190;6027;6217;0,0305613640019302;3,06
2015;"1290";"Män";0;586;16487;17073;0,0343232003748609;3,43
2015;"1290";"Kvinnor";0;676;16618;17294;0,0390887012836822;3,91
2015;"1291";"Män";0;112;3312;3424;0,0327102803738318;3,27
2015;"1291";"Kvinnor";0;128;3303;3431;0,0373069076071116;3,73
2015;"1292";"Män";0;191;7649;7840;0,0243622448979592;2,44
2015;"1292";"Kvinnor";0;295;8093;8388;0,035169289461135;3,52
2015;"1293";"Män";0;203;9842;10045;0,0202090592334495;2,02
2015;"1293";"Kvinnor";0;226;8598;8824;0,0256119673617407;2,56
2015;"1315";"Män";0;32;2366;2398;0,0133444537114262;1,33
2015;"1315";"Kvinnor";0;40;1759;1799;0,0222345747637576;2,22
2015;"1380";"Män";0;694;22221;22915;0,0302858389701069;3,03
2015;"1380";"Kvinnor";0;866;20722;21588;0,0401148786362794;4,01
2015;"1381";"Män";0;142;3969;4111;0,0345414740938944;3,45
2015;"1381";"Kvinnor";0;134;3565;3699;0,0362260070289267;3,62
2015;"1382";"Män";0;275;9291;9566;0,0287476479197157;2,87
2015;"1382";"Kvinnor";0;386;8774;9160;0,0421397379912664;4,21
2015;"1383";"Män";0;451;14115;14566;0,0309625154469312;3,1
2015;"1383";"Kvinnor";0;757;12716;13473;0,0561864469680101;5,62
2015;"1384";"Män";0;498;10061;10559;0,0471635571550336;4,72
2015;"1384";"Kvinnor";0;845;11020;11865;0,0712178676780447;7,12
2015;"1401";"Män";0;372;6873;7245;0,0513457556935818;5,13
2015;"1401";"Kvinnor";0;242;5974;6216;0,0389317889317889;3,89
2015;"1402";"Män";0;293;5337;5630;0,0520426287744227;5,2
2015;"1402";"Kvinnor";0;454;4909;5363;0,0846541115047548;8,47
2015;"1407";"Män";0;28;1663;1691;0,0165582495564755;1,66
2015;"1407";"Kvinnor";0;60;1550;1610;0,0372670807453416;3,73
2015;"1415";"Män";0;106;6753;6859;0,0154541478349614;1,55
2015;"1415";"Kvinnor";0;237;4448;4685;0,0505869797225187;5,06
2015;"1419";"Män";0;43;2086;2129;0,0201972757162987;2,02
2015;"1419";"Kvinnor";0;62;2163;2225;0,0278651685393258;2,79
2015;"1421";"Män";0;25;2257;2282;0,0109553023663453;1,1
2015;"1421";"Kvinnor";0;36;1965;2001;0,0179910044977511;1,8
2015;"1427";"Män";0;27;1888;1915;0,0140992167101828;1,41
2015;"1427";"Kvinnor";0;43;1779;1822;0,0236004390779363;2,36
2015;"1430";"Män";0;80;1709;1789;0,0447177193963108;4,47
2015;"1430";"Kvinnor";0;56;1594;1650;0,0339393939393939;3,39
2015;"1435";"Män";0;91;2523;2614;0,0348125478194338;3,48
2015;"1435";"Kvinnor";0;160;2146;2306;0,0693842150910668;6,94
2015;"1438";"Män";0;8;1064;1072;0,00746268656716418;0,75
2015;"1438";"Kvinnor";0;12;739;751;0,0159786950732357;1,6
2015;"1439";"Män";0;3;1036;1039;0,00288739172281039;0,29
2015;"1439";"Kvinnor";0;8;886;894;0,00894854586129754;0,89
2015;"1440";"Män";0;83;3097;3180;0,0261006289308176;2,61
2015;"1440";"Kvinnor";0;104;3263;3367;0,0308880308880309;3,09
2015;"1441";"Män";0;142;4153;4295;0,0330616996507567;3,31
2015;"1441";"Kvinnor";0;194;5005;5199;0,0373148682438931;3,73
2015;"1442";"Män";0;46;2587;2633;0,017470565894417;1,75
2015;"1442";"Kvinnor";0;27;1752;1779;0,015177065767285;1,52
2015;"1443";"Män";0;63;1204;1267;0,0497237569060773;4,97
2015;"1443";"Kvinnor";0;42;1045;1087;0,0386384544618215;3,86
2015;"1444";"Män";0;4;727;731;0,00547195622435021;0,55
2015;"1444";"Kvinnor";0;17;722;739;0,0230040595399188;2,3
2015;"1445";"Män";0;32;1030;1062;0,0301318267419962;3,01
2015;"1445";"Kvinnor";0;44;825;869;0,0506329113924051;5,06
2015;"1446";"Män";0;20;1717;1737;0,0115141047783535;1,15
2015;"1446";"Kvinnor";0;17;1103;1120;0,0151785714285714;1,52
2015;"1447";"Män";0;10;952;962;0,0103950103950104;1,04
2015;"1447";"Kvinnor";0;8;727;735;0,0108843537414966;1,09
2015;"1452";"Män";0;72;3221;3293;0,0218645611904039;2,19
2015;"1452";"Kvinnor";0;108;2106;2214;0,0487804878048781;4,88
2015;"1460";"Män";0;41;1941;1982;0,020686175580222;2,07
2015;"1460";"Kvinnor";0;74;1733;1807;0,0409518539014942;4,1
2015;"1461";"Män";0;18;1416;1434;0,0125523012552301;1,26
2015;"1461";"Kvinnor";0;63;1260;1323;0,0476190476190476;4,76
2015;"1462";"Män";0;29;1801;1830;0,0158469945355191;1,58
2015;"1462";"Kvinnor";0;23;1851;1874;0,012273212379936;1,23
2015;"1463";"Män";0;181;5237;5418;0,0334071613141381;3,34
2015;"1463";"Kvinnor";0;230;4984;5214;0,0441120061373226;4,41
2015;"1465";"Män";0;187;1565;1752;0,106735159817352;10,67
2015;"1465";"Kvinnor";0;125;1471;1596;0,0783208020050125;7,83
2015;"1466";"Män";0;13;2064;2077;0,00625902744342802;0,63
2015;"1466";"Kvinnor";0;10;1481;1491;0,00670690811535882;0,67
2015;"1470";"Män";0;62;4194;4256;0,0145676691729323;1,46
2015;"1470";"Kvinnor";0;71;2717;2788;0,0254662840746055;2,55
2015;"1471";"Män";0;32;3118;3150;0,0101587301587302;1,02
2015;"1471";"Kvinnor";0;26;2228;2254;0,0115350488021295;1,15
2015;"1472";"Män";0;27;1624;1651;0,0163537250151423;1,64
2015;"1472";"Kvinnor";0;22;1569;1591;0,0138277812696417;1,38
2015;"1473";"Män";0;15;1568;1583;0,00947567909033481;0,95
2015;"1473";"Kvinnor";0;27;1296;1323;0,0204081632653061;2,04
2015;"1480";"Män";0;7239;162749;169988;0,0425853589665153;4,26
2015;"1480";"Kvinnor";0;8972;140166;149138;0,060159047325296;6,02
2015;"1481";"Män";0;704;19538;20242;0,0347791720185752;3,48
2015;"1481";"Kvinnor";0;799;16803;17602;0,045392569026247;4,54
2015;"1482";"Män";0;233;7693;7926;0,0293969215240979;2,94
2015;"1482";"Kvinnor";0;214;7575;7789;0,0274746437283348;2,75
2015;"1484";"Män";0;49;3101;3150;0,0155555555555556;1,56
2015;"1484";"Kvinnor";0;74;2537;2611;0,0283416315587897;2,83
2015;"1485";"Män";0;288;10833;11121;0,0258969517129755;2,59
2015;"1485";"Kvinnor";0;536;10773;11309;0,047395879388098;4,74
2015;"1486";"Män";0;90;2793;2883;0,0312174817898023;3,12
2015;"1486";"Kvinnor";0;307;2815;3122;0,098334401024984;9,83
2015;"1487";"Män";0;143;5786;5929;0,0241187384044527;2,41
2015;"1487";"Kvinnor";0;178;6193;6371;0,0279390990425365;2,79
2015;"1488";"Män";0;272;12588;12860;0,0211508553654743;2,12
2015;"1488";"Kvinnor";0;469;12222;12691;0,0369553226696084;3,7
2015;"1489";"Män";0;216;6195;6411;0,0336920917173608;3,37
2015;"1489";"Kvinnor";0;304;7096;7400;0,0410810810810811;4,11
2015;"1490";"Män";0;2019;24281;26300;0,0767680608365019;7,68
2015;"1490";"Kvinnor";0;2554;22894;25448;0,100361521534109;10,04
2015;"1491";"Män";0;265;4503;4768;0,0555788590604027;5,56
2015;"1491";"Kvinnor";0;384;3489;3873;0,099147947327653;9,91
2015;"1492";"Män";0;35;2127;2162;0,0161887141535615;1,62
2015;"1492";"Kvinnor";0;60;1897;1957;0,0306591722023505;3,07
2015;"1493";"Män";0;90;4282;4372;0,0205855443732845;2,06
2015;"1493";"Kvinnor";0;113;4032;4145;0,0272617611580217;2,73
2015;"1494";"Män";0;205;8323;8528;0,0240384615384615;2,4
2015;"1494";"Kvinnor";0;285;7478;7763;0,0367126111039547;3,67
2015;"1495";"Män";0;81;3979;4060;0,0199507389162562;2
2015;"1495";"Kvinnor";0;113;3569;3682;0,0306898424769147;3,07
2015;"1496";"Män";0;344;16567;16911;0,0203417893678671;2,03
2015;"1496";"Kvinnor";0;487;13770;14257;0,0341586589043978;3,42
2015;"1497";"Män";0;23;1295;1318;0,0174506828528073;1,75
2015;"1497";"Kvinnor";0;27;1308;1335;0,0202247191011236;2,02
2015;"1498";"Män";0;42;2276;2318;0,0181190681622088;1,81
2015;"1498";"Kvinnor";0;52;1805;1857;0,0280021540118471;2,8
2015;"1499";"Män";0;215;6169;6384;0,0336779448621554;3,37
2015;"1499";"Kvinnor";0;242;5338;5580;0,0433691756272401;4,34
2015;"1715";"Män";0;33;1640;1673;0,0197250448296473;1,97
2015;"1715";"Kvinnor";0;28;1364;1392;0,0201149425287356;2,01
2015;"1730";"Män";0;14;1582;1596;0,0087719298245614;0,88
2015;"1730";"Kvinnor";0;113;1753;1866;0,0605573419078242;6,06
2015;"1737";"Män";0;22;2341;2363;0,00931019889970377;0,93
2015;"1737";"Kvinnor";0;48;2401;2449;0,0195998366680278;1,96
2015;"1760";"Män";0;3;509;512;0,005859375;0,59
2015;"1760";"Kvinnor";0;4;447;451;0,00886917960088692;0,89
2015;"1761";"Män";0;33;1896;1929;0,0171073094867807;1,71
2015;"1761";"Kvinnor";0;43;1699;1742;0,0246842709529277;2,47
2015;"1762";"Män";0;17;742;759;0,0223978919631094;2,24
2015;"1762";"Kvinnor";0;17;597;614;0,0276872964169381;2,77
2015;"1763";"Män";0;18;1016;1034;0,0174081237911025;1,74
2015;"1763";"Kvinnor";0;26;1296;1322;0,0196671709531014;1,97
2015;"1764";"Män";0;10;1713;1723;0,00580383052814858;0,58
2015;"1764";"Kvinnor";0;14;1167;1181;0,0118543607112616;1,19
2015;"1765";"Män";0;19;1767;1786;0,0106382978723404;1,06
2015;"1765";"Kvinnor";0;82;1706;1788;0,0458612975391499;4,59
2015;"1766";"Män";0;155;2410;2565;0,0604288499025341;6,04
2015;"1766";"Kvinnor";0;145;2057;2202;0,0658492279745686;6,58
2015;"1780";"Män";0;808;23530;24338;0,0331991124989728;3,32
2015;"1780";"Kvinnor";0;1063;22668;23731;0,0447937297206186;4,48
2015;"1781";"Män";0;63;4366;4429;0,0142244298938812;1,42
2015;"1781";"Kvinnor";0;93;3382;3475;0,0267625899280576;2,68
2015;"1782";"Män";0;22;1821;1843;0,0119370591427021;1,19
2015;"1782";"Kvinnor";0;27;1584;1611;0,0167597765363128;1,68
2015;"1783";"Män";0;16;2401;2417;0,00661977658254034;0,66
2015;"1783";"Kvinnor";0;37;1790;1827;0,0202517788724685;2,03
2015;"1784";"Män";0;79;5161;5240;0,0150763358778626;1,51
2015;"1784";"Kvinnor";0;127;4470;4597;0,0276267130737437;2,76
2015;"1785";"Män";0;28;2928;2956;0,0094722598105548;0,95
2015;"1785";"Kvinnor";0;56;2418;2474;0,0226354082457559;2,26
2015;"1814";"Män";0;14;893;907;0,0154355016538037;1,54
2015;"1814";"Kvinnor";0;12;929;941;0,0127523910733262;1,28
2015;"1860";"Män";0;15;1188;1203;0,0124688279301746;1,25
2015;"1860";"Kvinnor";0;14;798;812;0,0172413793103448;1,72
2015;"1861";"Män";0;52;4036;4088;0,012720156555773;1,27
2015;"1861";"Kvinnor";0;47;3023;3070;0,0153094462540717;1,53
2015;"1862";"Män";0;9;1406;1415;0,00636042402826855;0,64
2015;"1862";"Kvinnor";0;21;1119;1140;0,0184210526315789;1,84
2015;"1863";"Män";0;12;1330;1342;0,00894187779433681;0,89
2015;"1863";"Kvinnor";0;28;1029;1057;0,0264900662251656;2,65
2015;"1864";"Män";0;9;809;818;0,0110024449877751;1,1
2015;"1864";"Kvinnor";0;8;734;742;0,0107816711590297;1,08
2015;"1880";"Män";0;1134;34702;35836;0,031644156713919;3,16
2015;"1880";"Kvinnor";0;1459;33354;34813;0,0419096314595123;4,19
2015;"1881";"Män";0;104;3488;3592;0,0289532293986637;2,9
2015;"1881";"Kvinnor";0;85;3215;3300;0,0257575757575758;2,58
2015;"1882";"Män";0;24;2108;2132;0,0112570356472795;1,13
2015;"1882";"Kvinnor";0;44;1523;1567;0,0280791320995533;2,81
2015;"1883";"Män";0;127;7130;7257;0,0175003444949704;1,75
2015;"1883";"Kvinnor";0;170;6243;6413;0,0265086542959613;2,65
2015;"1884";"Män";0;22;1391;1413;0,0155697098372258;1,56
2015;"1884";"Kvinnor";0;58;1384;1442;0,0402219140083218;4,02
2015;"1885";"Män";0;76;4834;4910;0,0154786150712831;1,55
2015;"1885";"Kvinnor";0;66;4456;4522;0,0145953118089341;1,46
2015;"1904";"Män";0;8;828;836;0,00956937799043062;0,96
2015;"1904";"Kvinnor";0;7;590;597;0,0117252931323283;1,17
2015;"1907";"Män";0;12;1372;1384;0,00867052023121387;0,87
2015;"1907";"Kvinnor";0;16;1130;1146;0,0139616055846422;1,4
2015;"1960";"Män";0;15;1111;1126;0,0133214920071048;1,33
2015;"1960";"Kvinnor";0;12;987;999;0,012012012012012;1,2
2015;"1961";"Män";0;26;2319;2345;0,0110874200426439;1,11
2015;"1961";"Kvinnor";0;21;2231;2252;0,00932504440497336;0,93
2015;"1962";"Män";0;16;832;848;0,0188679245283019;1,89
2015;"1962";"Kvinnor";0;20;685;705;0,0283687943262411;2,84
2015;"1980";"Män";0;1031;34211;35242;0,0292548663526474;2,93
2015;"1980";"Kvinnor";0;1335;30583;31918;0,0418259289429162;4,18
2015;"1981";"Män";0;87;3579;3666;0,0237315875613748;2,37
2015;"1981";"Kvinnor";0;138;3340;3478;0,0396779758481886;3,97
2015;"1982";"Män";0;28;3425;3453;0,00810889081957718;0,81
2015;"1982";"Kvinnor";0;45;2728;2773;0,0162279120086549;1,62
2015;"1983";"Män";0;85;5860;5945;0,0142977291841884;1,43
2015;"1983";"Kvinnor";0;97;4795;4892;0,0198282910874898;1,98
2015;"1984";"Män";0;21;2753;2774;0,00757029560201875;0,76
2015;"1984";"Kvinnor";0;39;2141;2180;0,0178899082568807;1,79
2015;"2021";"Män";0;13;1204;1217;0,0106820049301561;1,07
2015;"2021";"Kvinnor";0;19;1094;1113;0,0170709793351303;1,71
2015;"2023";"Män";0;57;2677;2734;0,020848573518654;2,08
2015;"2023";"Kvinnor";0;57;2399;2456;0,0232084690553746;2,32
2015;"2026";"Män";0;21;1304;1325;0,0158490566037736;1,58
2015;"2026";"Kvinnor";0;18;1214;1232;0,0146103896103896;1,46
2015;"2029";"Män";0;85;3110;3195;0,02660406885759;2,66
2015;"2029";"Kvinnor";0;88;2863;2951;0,0298203998644527;2,98
2015;"2031";"Män";0;57;1653;1710;0,0333333333333333;3,33
2015;"2031";"Kvinnor";0;70;1568;1638;0,0427350427350427;4,27
2015;"2034";"Män";0;33;1112;1145;0,02882096069869;2,88
2015;"2034";"Kvinnor";0;15;905;920;0,016304347826087;1,63
2015;"2039";"Män";0;10;1403;1413;0,00707714083510262;0,71
2015;"2039";"Kvinnor";0;19;1223;1242;0,0152979066022544;1,53
2015;"2061";"Män";0;10;1582;1592;0,00628140703517588;0,63
2015;"2061";"Kvinnor";0;23;1148;1171;0,0196413321947054;1,96
2015;"2062";"Män";0;83;4834;4917;0,016880211511084;1,69
2015;"2062";"Kvinnor";0;152;4416;4568;0,0332749562171629;3,33
2015;"2080";"Män";0;698;11141;11839;0,0589576822366754;5,9
2015;"2080";"Kvinnor";0;636;12811;13447;0,0472967948241243;4,73
2015;"2081";"Män";0;165;14270;14435;0,0114305507447177;1,14
2015;"2081";"Kvinnor";0;402;10462;10864;0,0370029455081001;3,7
2015;"2082";"Män";0;21;1423;1444;0,0145429362880886;1,45
2015;"2082";"Kvinnor";0;29;1565;1594;0,0181932245922208;1,82
2015;"2083";"Män";0;35;3178;3213;0,0108932461873638;1,09
2015;"2083";"Kvinnor";0;64;2698;2762;0,0231716147719044;2,32
2015;"2084";"Män";0;92;5091;5183;0,0177503376422921;1,78
2015;"2084";"Kvinnor";0;113;3876;3989;0,0283279017297568;2,83
2015;"2085";"Män";0;69;6422;6491;0,0106301032198429;1,06
2015;"2085";"Kvinnor";0;86;5093;5179;0,0166055223016026;1,66
2015;"2101";"Män";0;8;901;909;0,0088008800880088;0,88
2015;"2101";"Kvinnor";0;12;845;857;0,014002333722287;1,4
2015;"2104";"Män";0;14;2028;2042;0,00685602350636631;0,69
2015;"2104";"Kvinnor";0;21;1511;1532;0,0137075718015666;1,37
2015;"2121";"Män";0;18;2874;2892;0,00622406639004149;0,62
2015;"2121";"Kvinnor";0;34;1886;1920;0,0177083333333333;1,77
2015;"2132";"Män";0;18;1497;1515;0,0118811881188119;1,19
2015;"2132";"Kvinnor";0;15;1269;1284;0,0116822429906542;1,17
2015;"2161";"Män";0;121;3650;3771;0,032086979581013;3,21
2015;"2161";"Kvinnor";0;175;3244;3419;0,0511845568879789;5,12
2015;"2180";"Män";0;720;21223;21943;0,0328122863783439;3,28
2015;"2180";"Kvinnor";0;929;20248;21177;0,0438683477357511;4,39
2015;"2181";"Män";0;62;9087;9149;0,00677669690676577;0,68
2015;"2181";"Kvinnor";0;107;6833;6940;0,0154178674351585;1,54
2015;"2182";"Män";0;114;4638;4752;0,023989898989899;2,4
2015;"2182";"Kvinnor";0;160;3930;4090;0,039119804400978;3,91
2015;"2183";"Män";0;116;4929;5045;0,0229930624380575;2,3
2015;"2183";"Kvinnor";0;142;4971;5113;0,0277723450029337;2,78
2015;"2184";"Män";0;167;7696;7863;0,0212387129594302;2,12
2015;"2184";"Kvinnor";0;250;7340;7590;0,0329380764163373;3,29
2015;"2260";"Män";0;49;1927;1976;0,0247975708502024;2,48
2015;"2260";"Kvinnor";0;65;1446;1511;0,043017868960953;4,3
2015;"2262";"Män";0;29;2850;2879;0,0100729419937478;1,01
2015;"2262";"Kvinnor";0;27;1974;2001;0,0134932533733133;1,35
2015;"2280";"Män";0;169;4413;4582;0,0368834570056744;3,69
2015;"2280";"Kvinnor";0;222;4507;4729;0,0469443857052231;4,69
2015;"2281";"Män";0;583;23705;24288;0,0240036231884058;2,4
2015;"2281";"Kvinnor";0;830;21576;22406;0,0370436490225832;3,7
2015;"2282";"Män";0;32;3868;3900;0,00820512820512821;0,82
2015;"2282";"Kvinnor";0;57;3184;3241;0,017587164455415;1,76
2015;"2283";"Män";0;77;3601;3678;0,0209352909189777;2,09
2015;"2283";"Kvinnor";0;110;3331;3441;0,03196745132229;3,2
2015;"2284";"Män";0;251;12827;13078;0,0191925370851812;1,92
2015;"2284";"Kvinnor";0;316;10600;10916;0,028948332722609;2,89
2015;"2303";"Män";0;5;1101;1106;0,00452079566003617;0,45
2015;"2303";"Kvinnor";0;10;883;893;0,0111982082866741;1,12
2015;"2305";"Män";0;16;999;1015;0,0157635467980296;1,58
2015;"2305";"Kvinnor";0;21;936;957;0,0219435736677116;2,19
2015;"2309";"Män";0;29;2283;2312;0,0125432525951557;1,25
2015;"2309";"Kvinnor";0;13;1969;1982;0,0065590312815338;0,66
2015;"2313";"Män";0;19;2395;2414;0,00787075393537697;0,79
2015;"2313";"Kvinnor";0;34;1955;1989;0,0170940170940171;1,71
2015;"2321";"Män";0;83;2450;2533;0,0327674694038689;3,28
2015;"2321";"Kvinnor";0;91;2123;2214;0,0411020776874435;4,11
2015;"2326";"Män";0;13;1250;1263;0,0102929532858274;1,03
2015;"2326";"Kvinnor";0;10;1102;1112;0,00899280575539568;0,9
2015;"2361";"Män";0;16;2401;2417;0,00661977658254034;0,66
2015;"2361";"Kvinnor";0;26;2097;2123;0,012246820536976;1,22
2015;"2380";"Män";0;594;15066;15660;0,0379310344827586;3,79
2015;"2380";"Kvinnor";0;642;15284;15926;0,0403114404119051;4,03
2015;"2401";"Män";0;20;974;994;0,0201207243460765;2,01
2015;"2401";"Kvinnor";0;24;868;892;0,0269058295964126;2,69
2015;"2403";"Män";0;0;310;310;0;0
2015;"2403";"Kvinnor";0;5;305;310;0,0161290322580645;1,61
2015;"2404";"Män";0;15;1226;1241;0,0120870265914585;1,21
2015;"2404";"Kvinnor";0;24;852;876;0,0273972602739726;2,74
2015;"2409";"Män";0;11;1033;1044;0,010536398467433;1,05
2015;"2409";"Kvinnor";0;7;993;1000;0,007;0,7
2015;"2417";"Män";0;11;800;811;0,0135635018495684;1,36
2015;"2417";"Kvinnor";0;20;719;739;0,027063599458728;2,71
2015;"2418";"Män";0;3;690;693;0,00432900432900433;0,43
2015;"2418";"Kvinnor";0;16;580;596;0,0268456375838926;2,68
2015;"2421";"Män";0;12;1219;1231;0,00974817221770918;0,97
2015;"2421";"Kvinnor";0;21;1123;1144;0,0183566433566434;1,84
2015;"2422";"Män";0;3;437;440;0,00681818181818182;0,68
2015;"2422";"Kvinnor";0;6;400;406;0,0147783251231527;1,48
2015;"2425";"Män";0;3;504;507;0,00591715976331361;0,59
2015;"2425";"Kvinnor";0;7;470;477;0,0146750524109015;1,47
2015;"2460";"Män";0;6;1254;1260;0,00476190476190476;0,48
2015;"2460";"Kvinnor";0;14;1073;1087;0,0128794848206072;1,29
2015;"2462";"Män";0;30;1042;1072;0,0279850746268657;2,8
2015;"2462";"Kvinnor";0;31;1156;1187;0,0261162594776748;2,61
2015;"2463";"Män";0;1;446;447;0,00223713646532438;0,22
2015;"2463";"Kvinnor";0;10;422;432;0,0231481481481481;2,31
2015;"2480";"Män";0;946;29977;30923;0,0305921159007858;3,06
2015;"2480";"Kvinnor";0;1134;27780;28914;0,0392197551359203;3,92
2015;"2481";"Män";0;44;2710;2754;0,0159767610748003;1,6
2015;"2481";"Kvinnor";0;57;2564;2621;0,0217474246470813;2,17
2015;"2482";"Män";0;348;16704;17052;0,0204081632653061;2,04
2015;"2482";"Kvinnor";0;444;13658;14102;0,0314848957594667;3,15
2015;"2505";"Män";0;14;1349;1363;0,0102714600146735;1,03
2015;"2505";"Kvinnor";0;35;1241;1276;0,0274294670846395;2,74
2015;"2506";"Män";0;4;810;814;0,00491400491400491;0,49
2015;"2506";"Kvinnor";0;13;600;613;0,0212071778140294;2,12
2015;"2510";"Män";0;25;997;1022;0,0244618395303327;2,45
2015;"2510";"Kvinnor";0;45;880;925;0,0486486486486487;4,86
2015;"2513";"Män";0;3;684;687;0,00436681222707424;0,44
2015;"2513";"Kvinnor";0;13;628;641;0,0202808112324493;2,03
2015;"2514";"Män";0;66;3124;3190;0,0206896551724138;2,07
2015;"2514";"Kvinnor";0;112;2790;2902;0,0385940730530668;3,86
2015;"2518";"Män";0;14;703;717;0,0195258019525802;1,95
2015;"2518";"Kvinnor";0;21;715;736;0,0285326086956522;2,85
2015;"2521";"Män";0;29;1025;1054;0,0275142314990512;2,75
2015;"2521";"Kvinnor";0;21;949;970;0,0216494845360825;2,16
2015;"2523";"Män";0;60;5227;5287;0,0113485908832987;1,13
2015;"2523";"Kvinnor";0;76;3903;3979;0,0191002764513697;1,91
2015;"2560";"Män";0;3;1427;1430;0,0020979020979021;0,21
2015;"2560";"Kvinnor";0;26;1388;1414;0,0183875530410184;1,84
2015;"2580";"Män";0;678;20670;21348;0,0317594154019112;3,18
2015;"2580";"Kvinnor";0;896;17590;18486;0,048469111760251;4,85
2015;"2581";"Män";0;165;8419;8584;0,0192218080149115;1,92
2015;"2581";"Kvinnor";0;272;7357;7629;0,0356534277100537;3,57
2015;"2582";"Män";0;61;5323;5384;0,0113298662704309;1,13
2015;"2582";"Kvinnor";0;99;4534;4633;0,0213684437729333;2,14
2015;"2583";"Män";0;33;1444;1477;0,022342586323629;2,23
2015;"2583";"Kvinnor";0;39;1556;1595;0,0244514106583072;2,45
2015;"2584";"Män";0;124;7078;7202;0,0172174396001111;1,72
2015;"2584";"Kvinnor";0;314;5402;5716;0,0549335199440168;5,49
2015;"9999";"Män";0;1657;166715;168372;0,00984130377972585;0,98
2015;"9999";"Kvinnor";0;2178;181934;184112;0,0118297558008169;1,18
2016;"0114";"Män";0;176;7332;7508;0,0234416622269579;2,34
2016;"0114";"Kvinnor";0;242;6602;6844;0,0353594389246055;3,54
2016;"0115";"Män";0;85;4211;4296;0,0197858472998138;1,98
2016;"0115";"Kvinnor";0;93;3678;3771;0,0246618933969769;2,47
2016;"0117";"Män";0;163;4902;5065;0,0321816386969398;3,22
2016;"0117";"Kvinnor";0;191;4779;4970;0,038430583501006;3,84
2016;"0120";"Män";0;205;5509;5714;0,035876793839692;3,59
2016;"0120";"Kvinnor";0;240;5211;5451;0,0440286186020914;4,4
2016;"0123";"Män";0;434;13433;13867;0,0312973245835437;3,13
2016;"0123";"Kvinnor";0;572;9520;10092;0,0566785572730876;5,67
2016;"0125";"Män";0;125;4270;4395;0,0284414106939704;2,84
2016;"0125";"Kvinnor";0;139;3883;4022;0,0345599204375932;3,46
2016;"0126";"Män";0;474;21215;21689;0,0218543962377242;2,19
2016;"0126";"Kvinnor";0;573;21183;21756;0,0263375620518478;2,63
2016;"0127";"Män";0;416;12580;12996;0,0320098491843644;3,2
2016;"0127";"Kvinnor";0;455;9800;10255;0,0443686006825939;4,44
2016;"0128";"Män";0;40;1107;1147;0,03487358326068;3,49
2016;"0128";"Kvinnor";0;39;1569;1608;0,0242537313432836;2,43
2016;"0136";"Män";0;220;14841;15061;0,0146072637939048;1,46
2016;"0136";"Kvinnor";0;318;11090;11408;0,027875175315568;2,79
2016;"0138";"Män";0;183;5287;5470;0,03345521023766;3,35
2016;"0138";"Kvinnor";0;206;4816;5022;0,0410195141377937;4,1
2016;"0139";"Män";0;55;5161;5216;0,0105444785276074;1,05
2016;"0139";"Kvinnor";0;52;3365;3417;0,0152180275095113;1,52
2016;"0140";"Män";0;16;1395;1411;0,0113394755492558;1,13
2016;"0140";"Kvinnor";0;20;1007;1027;0,0194741966893866;1,95
2016;"0160";"Män";0;494;11803;12297;0,0401723997723022;4,02
2016;"0160";"Kvinnor";0;812;10799;11611;0,0699336835759194;6,99
2016;"0162";"Män";0;146;6858;7004;0,0208452312964021;2,08
2016;"0162";"Kvinnor";0;258;10452;10710;0,0240896358543417;2,41
2016;"0163";"Män";0;303;12334;12637;0,0239772097808024;2,4
2016;"0163";"Kvinnor";0;468;11368;11836;0,0395403852652923;3,95
2016;"0180";"Män";0;31558;308931;340489;0,0926843451623988;9,27
2016;"0180";"Kvinnor";0;37317;278957;316274;0,117989464831127;11,8
2016;"0181";"Män";0;498;26482;26980;0,0184581171237954;1,85
2016;"0181";"Kvinnor";0;540;19781;20321;0,0265734953988485;2,66
2016;"0182";"Män";0;1004;15485;16489;0,0608890775668628;6,09
2016;"0182";"Kvinnor";0;1231;14993;16224;0,0758752465483235;7,59
2016;"0183";"Män";0;278;11613;11891;0,0233790261542343;2,34
2016;"0183";"Kvinnor";0;239;10523;10762;0,0222077680728489;2,22
2016;"0184";"Män";0;1033;41850;42883;0,0240887997574797;2,41
2016;"0184";"Kvinnor";0;1469;42303;43772;0,0335602668372476;3,36
2016;"0186";"Män";0;322;4836;5158;0,0624272974020938;6,24
2016;"0186";"Kvinnor";0;399;5675;6074;0,0656898254856767;6,57
2016;"0187";"Män";0;68;1204;1272;0,0534591194968553;5,35
2016;"0187";"Kvinnor";0;66;1377;1443;0,0457380457380457;4,57
2016;"0188";"Män";0;207;9877;10084;0,0205275684252281;2,05
2016;"0188";"Kvinnor";0;259;10101;10360;0,025;2,5
2016;"0191";"Män";0;176;16388;16564;0,0106254527891814;1,06
2016;"0191";"Kvinnor";0;306;11884;12190;0,0251025430680886;2,51
2016;"0192";"Män";0;67;3112;3179;0,0210758100031456;2,11
2016;"0192";"Kvinnor";0;106;3307;3413;0,0310577204805157;3,11
2016;"0305";"Män";0;45;2462;2507;0,0179497407259673;1,79
2016;"0305";"Kvinnor";0;78;2295;2373;0,0328697850821745;3,29
2016;"0319";"Män";0;14;1236;1250;0,0112;1,12
2016;"0319";"Kvinnor";0;19;1049;1068;0,0177902621722846;1,78
2016;"0330";"Män";0;40;1838;1878;0,0212992545260916;2,13
2016;"0330";"Kvinnor";0;49;1839;1888;0,0259533898305085;2,6
2016;"0331";"Män";0;176;1680;1856;0,0948275862068965;9,48
2016;"0331";"Kvinnor";0;135;1727;1862;0,0725026852846402;7,25
2016;"0360";"Män";0;52;3255;3307;0,0157242213486544;1,57
2016;"0360";"Kvinnor";0;51;2685;2736;0,018640350877193;1,86
2016;"0380";"Män";0;1761;45747;47508;0,0370674412730487;3,71
2016;"0380";"Kvinnor";0;2360;48145;50505;0,0467280467280467;4,67
2016;"0381";"Män";0;122;8598;8720;0,0139908256880734;1,4
2016;"0381";"Kvinnor";0;215;7236;7451;0,0288551872231915;2,89
2016;"0382";"Män";0;44;5221;5265;0,00835707502374169;0,84
2016;"0382";"Kvinnor";0;46;3772;3818;0,0120481927710843;1,2
2016;"0428";"Män";0;66;1395;1461;0,0451745379876797;4,52
2016;"0428";"Kvinnor";0;114;1211;1325;0,0860377358490566;8,6
2016;"0461";"Män";0;35;1145;1180;0,0296610169491525;2,97
2016;"0461";"Kvinnor";0;52;1371;1423;0,0365425158116655;3,65
2016;"0480";"Män";0;237;10563;10800;0,0219444444444444;2,19
2016;"0480";"Kvinnor";0;332;10874;11206;0,0296269855434589;2,96
2016;"0481";"Män";0;21;3171;3192;0,00657894736842105;0,66
2016;"0481";"Kvinnor";0;31;1867;1898;0,0163329820864067;1,63
2016;"0482";"Män";0;45;2651;2696;0,0166913946587537;1,67
2016;"0482";"Kvinnor";0;53;2412;2465;0,021501014198783;2,15
2016;"0483";"Män";0;187;6585;6772;0,027613703484938;2,76
2016;"0483";"Kvinnor";0;181;6001;6182;0,0292785506308638;2,93
2016;"0484";"Män";0;582;20160;20742;0,0280590107029216;2,81
2016;"0484";"Kvinnor";0;873;19639;20512;0,0425604524180967;4,26
2016;"0486";"Män";0;142;4993;5135;0,0276533592989289;2,77
2016;"0486";"Kvinnor";0;180;4882;5062;0,0355590675622284;3,56
2016;"0488";"Män";0;94;1667;1761;0,0533787620670074;5,34
2016;"0488";"Kvinnor";0;94;1701;1795;0,0523676880222841;5,24
2016;"0509";"Män";0;35;818;853;0,041031652989449;4,1
2016;"0509";"Kvinnor";0;18;703;721;0,0249653259361997;2,5
2016;"0512";"Män";0;16;617;633;0,0252764612954186;2,53
2016;"0512";"Kvinnor";0;20;415;435;0,0459770114942529;4,6
2016;"0513";"Män";0;29;1648;1677;0,0172927847346452;1,73
2016;"0513";"Kvinnor";0;29;1467;1496;0,0193850267379679;1,94
2016;"0560";"Män";0;7;946;953;0,00734522560335782;0,73
2016;"0560";"Kvinnor";0;7;587;594;0,0117845117845118;1,18
2016;"0561";"Män";0;48;1585;1633;0,0293937538273117;2,94
2016;"0561";"Kvinnor";0;44;1261;1305;0,0337164750957854;3,37
2016;"0562";"Män";0;31;5359;5390;0,00575139146567718;0,58
2016;"0562";"Kvinnor";0;43;3576;3619;0,0118817352859906;1,19
2016;"0563";"Män";0;20;1369;1389;0,0143988480921526;1,44
2016;"0563";"Kvinnor";0;29;1076;1105;0,0262443438914027;2,62
2016;"0580";"Män";0;857;40888;41745;0,020529404719128;2,05
2016;"0580";"Kvinnor";0;1106;36177;37283;0,0296649947697342;2,97
2016;"0581";"Män";0;972;30593;31565;0,0307936005068905;3,08
2016;"0581";"Kvinnor";0;1235;28822;30057;0,04108859832984;4,11
2016;"0582";"Män";0;52;1982;2034;0,0255653883972468;2,56
2016;"0582";"Kvinnor";0;57;1962;2019;0,0282317979197623;2,82
2016;"0583";"Män";0;158;6908;7066;0,0223606000566091;2,24
2016;"0583";"Kvinnor";0;186;6935;7121;0,0261199269765482;2,61
2016;"0584";"Män";0;42;1477;1519;0,0276497695852535;2,76
2016;"0584";"Kvinnor";0;43;1278;1321;0,032551097653293;3,26
2016;"0586";"Män";0;60;6620;6680;0,00898203592814371;0,9
2016;"0586";"Kvinnor";0;85;4610;4695;0,0181043663471778;1,81
2016;"0604";"Män";0;13;1331;1344;0,00967261904761905;0,97
2016;"0604";"Kvinnor";0;17;1042;1059;0,016052880075543;1,61
2016;"0617";"Män";0;38;3445;3483;0,0109101349411427;1,09
2016;"0617";"Kvinnor";0;48;2421;2469;0,0194410692588092;1,94
2016;"0642";"Män";0;13;1347;1360;0,00955882352941177;0,96
2016;"0642";"Kvinnor";0;56;1174;1230;0,0455284552845528;4,55
2016;"0643";"Män";0;27;1781;1808;0,0149336283185841;1,49
2016;"0643";"Kvinnor";0;34;1579;1613;0,0210787352758834;2,11
2016;"0662";"Män";0;87;7681;7768;0,0111997940267765;1,12
2016;"0662";"Kvinnor";0;137;5831;5968;0,022955764075067;2,3
2016;"0665";"Män";0;39;2923;2962;0,0131667792032411;1,32
2016;"0665";"Kvinnor";0;46;2062;2108;0,0218216318785579;2,18
2016;"0680";"Män";0;1146;35056;36202;0,0316557096293022;3,17
2016;"0680";"Kvinnor";0;1191;31275;32466;0,0366845315098873;3,67
2016;"0682";"Män";0;105;6692;6797;0,0154479917610711;1,54
2016;"0682";"Kvinnor";0;124;5428;5552;0,0223342939481268;2,23
2016;"0683";"Män";0;146;8509;8655;0,0168688619295205;1,69
2016;"0683";"Kvinnor";0;215;7607;7822;0,027486576323191;2,75
2016;"0684";"Män";0;21;2483;2504;0,00838658146964856;0,84
2016;"0684";"Kvinnor";0;41;1795;1836;0,0223311546840959;2,23
2016;"0685";"Män";0;73;6863;6936;0,0105247981545559;1,05
2016;"0685";"Kvinnor";0;113;5024;5137;0,0219972746739342;2,2
2016;"0686";"Män";0;50;4589;4639;0,0107781849536538;1,08
2016;"0686";"Kvinnor";0;103;4369;4472;0,0230322003577818;2,3
2016;"0687";"Män";0;104;4309;4413;0,023566734647632;2,36
2016;"0687";"Kvinnor";0;130;3344;3474;0,0374208405296488;3,74
2016;"0760";"Män";0;14;2593;2607;0,00537015726889145;0,54
2016;"0760";"Kvinnor";0;15;1788;1803;0,00831946755407654;0,83
2016;"0761";"Män";0;10;1176;1186;0,00843170320404722;0,84
2016;"0761";"Kvinnor";0;39;1188;1227;0,0317848410757946;3,18
2016;"0763";"Män";0;33;2784;2817;0,0117145899893504;1,17
2016;"0763";"Kvinnor";0;42;2316;2358;0,0178117048346056;1,78
2016;"0764";"Män";0;56;3957;4013;0,0139546473959631;1,4
2016;"0764";"Kvinnor";0;62;3085;3147;0,0197013028280902;1,97
2016;"0765";"Män";0;1061;4331;5392;0,196772997032641;19,68
2016;"0765";"Kvinnor";0;1114;3924;5038;0,22111949186185;22,11
2016;"0767";"Män";0;44;3037;3081;0,0142810775722168;1,43
2016;"0767";"Kvinnor";0;40;1851;1891;0,0211528291909043;2,12
2016;"0780";"Män";0;777;21919;22696;0,0342351075079309;3,42
2016;"0780";"Kvinnor";0;915;20618;21533;0,0424929178470255;4,25
2016;"0781";"Män";0;299;6690;6989;0,0427815138074116;4,28
2016;"0781";"Kvinnor";0;223;5489;5712;0,0390406162464986;3,9
2016;"0821";"Män";0;7;746;753;0,00929614873837981;0,93
2016;"0821";"Kvinnor";0;8;836;844;0,00947867298578199;0,95
2016;"0834";"Män";0;9;1173;1182;0,00761421319796954;0,76
2016;"0834";"Kvinnor";0;17;887;904;0,0188053097345133;1,88
2016;"0840";"Män";0;37;2313;2350;0,0157446808510638;1,57
2016;"0840";"Kvinnor";0;87;2346;2433;0,0357583230579531;3,58
2016;"0860";"Män";0;22;2582;2604;0,00844854070660522;0,84
2016;"0860";"Kvinnor";0;26;2191;2217;0,0117275597654488;1,17
2016;"0861";"Män";0;17;2332;2349;0,00723712217965092;0,72
2016;"0861";"Kvinnor";0;35;1875;1910;0,0183246073298429;1,83
2016;"0862";"Män";0;34;2522;2556;0,013302034428795;1,33
2016;"0862";"Kvinnor";0;38;1632;1670;0,0227544910179641;2,28
2016;"0880";"Män";0;616;15770;16386;0,0375930672525326;3,76
2016;"0880";"Kvinnor";0;803;15512;16315;0,0492185105730922;4,92
2016;"0881";"Män";0;41;3741;3782;0,0108408249603384;1,08
2016;"0881";"Kvinnor";0;66;3094;3160;0,0208860759493671;2,09
2016;"0882";"Män";0;68;8260;8328;0,00816522574447646;0,82
2016;"0882";"Kvinnor";0;138;6049;6187;0,0223048327137546;2,23
2016;"0883";"Män";0;110;6887;6997;0,0157210232956982;1,57
2016;"0883";"Kvinnor";0;158;7035;7193;0,0219658000834144;2,2
2016;"0884";"Män";0;326;3685;4011;0,081276489653453;8,13
2016;"0884";"Kvinnor";0;323;2826;3149;0,102572245157193;10,26
2016;"0885";"Män";0;62;1949;2011;0,0308304326205868;3,08
2016;"0885";"Kvinnor";0;70;1749;1819;0,0384826827927433;3,85
2016;"0980";"Män";0;450;12362;12812;0,0351233218857321;3,51
2016;"0980";"Kvinnor";0;543;11717;12260;0,0442903752039152;4,43
2016;"1060";"Män";0;29;4321;4350;0,00666666666666667;0,67
2016;"1060";"Kvinnor";0;39;2385;2424;0,0160891089108911;1,61
2016;"1080";"Män";0;405;15000;15405;0,0262901655306719;2,63
2016;"1080";"Kvinnor";0;469;13567;14036;0,0334140780849245;3,34
2016;"1081";"Män";0;87;5591;5678;0,015322296583304;1,53
2016;"1081";"Kvinnor";0;117;4341;4458;0,0262449528936743;2,62
2016;"1082";"Män";0;173;5680;5853;0,0295574918845037;2,96
2016;"1082";"Kvinnor";0;243;5678;5921;0,0410403648032427;4,1
2016;"1083";"Män";0;63;3033;3096;0,0203488372093023;2,03
2016;"1083";"Kvinnor";0;82;2555;2637;0,031095942358741;3,11
2016;"1214";"Män";0;37;1632;1669;0,0221689634511684;2,22
2016;"1214";"Kvinnor";0;35;1728;1763;0,0198525241066364;1,99
2016;"1230";"Män";0;70;3376;3446;0,02031340684852;2,03
2016;"1230";"Kvinnor";0;55;2568;2623;0,0209683568433092;2,1
2016;"1231";"Män";0;82;4555;4637;0,0176838473150744;1,77
2016;"1231";"Kvinnor";0;188;2877;3065;0,0613376835236542;6,13
2016;"1233";"Män";0;148;3735;3883;0,0381148596446047;3,81
2016;"1233";"Kvinnor";0;205;4110;4315;0,0475086906141367;4,75
2016;"1256";"Män";0;47;2192;2239;0,0209915140687807;2,1
2016;"1256";"Kvinnor";0;57;1698;1755;0,0324786324786325;3,25
2016;"1257";"Män";0;16;1729;1745;0,00916905444126074;0,92
2016;"1257";"Kvinnor";0;28;1543;1571;0,0178230426479949;1,78
2016;"1260";"Män";0;9;2598;2607;0,00345224395857307;0,35
2016;"1260";"Kvinnor";0;18;2018;2036;0,00884086444007859;0,88
2016;"1261";"Män";0;100;3422;3522;0,0283929585462805;2,84
2016;"1261";"Kvinnor";0;205;3464;3669;0,0558735350231671;5,59
2016;"1262";"Män";0;62;2538;2600;0,0238461538461538;2,38
2016;"1262";"Kvinnor";0;109;2856;2965;0,0367622259696459;3,68
2016;"1263";"Män";0;73;3525;3598;0,0202890494719289;2,03
2016;"1263";"Kvinnor";0;106;2638;2744;0,0386297376093294;3,86
2016;"1264";"Män";0;54;1913;1967;0,0274529740721912;2,75
2016;"1264";"Kvinnor";0;58;1757;1815;0,0319559228650138;3,2
2016;"1265";"Män";0;49;2751;2800;0,0175;1,75
2016;"1265";"Kvinnor";0;57;2504;2561;0,0222569308863725;2,23
2016;"1266";"Män";0;38;2298;2336;0,0162671232876712;1,63
2016;"1266";"Kvinnor";0;55;2226;2281;0,0241122314774222;2,41
2016;"1267";"Män";0;53;1995;2048;0,02587890625;2,59
2016;"1267";"Kvinnor";0;59;2500;2559;0,0230558812035952;2,31
2016;"1270";"Män";0;56;2364;2420;0,0231404958677686;2,31
2016;"1270";"Kvinnor";0;75;2074;2149;0,0348999534667287;3,49
2016;"1272";"Män";0;34;2360;2394;0,0142021720969089;1,42
2016;"1272";"Kvinnor";0;37;1785;1822;0,0203073545554336;2,03
2016;"1273";"Män";0;33;2139;2172;0,0151933701657459;1,52
2016;"1273";"Kvinnor";0;46;1856;1902;0,0241850683491062;2,42
2016;"1275";"Män";0;9;1788;1797;0,00500834724540901;0,5
2016;"1275";"Kvinnor";0;11;1239;1250;0,0088;0,88
2016;"1276";"Män";0;76;2704;2780;0,0273381294964029;2,73
2016;"1276";"Kvinnor";0;59;2250;2309;0,0255521870939801;2,56
2016;"1277";"Män";0;24;3003;3027;0,00792864222001982;0,79
2016;"1277";"Kvinnor";0;113;2570;2683;0,0421170331718226;4,21
2016;"1278";"Män";0;88;3149;3237;0,0271856657398826;2,72
2016;"1278";"Kvinnor";0;118;2721;2839;0,0415639309616062;4,16
2016;"1280";"Män";0;5166;81611;86777;0,0595319036150132;5,95
2016;"1280";"Kvinnor";0;5608;75117;80725;0,0694704242799628;6,95
2016;"1281";"Män";0;798;31719;32517;0,0245410093182028;2,45
2016;"1281";"Kvinnor";0;1213;32263;33476;0,036234914565659;3,62
2016;"1282";"Män";0;267;7814;8081;0,0330404652889494;3,3
2016;"1282";"Kvinnor";0;243;6146;6389;0,0380341211457192;3,8
2016;"1283";"Män";0;1416;33546;34962;0,0405011154968251;4,05
2016;"1283";"Kvinnor";0;1823;29939;31762;0,057395629998111;5,74
2016;"1284";"Män";0;124;3794;3918;0,0316488004083716;3,16
2016;"1284";"Kvinnor";0;180;3702;3882;0,0463678516228748;4,64
2016;"1285";"Män";0;153;5218;5371;0,0284863153975051;2,85
2016;"1285";"Kvinnor";0;149;4862;5011;0,0297345839153862;2,97
2016;"1286";"Män";0;168;5528;5696;0,0294943820224719;2,95
2016;"1286";"Kvinnor";0;264;5905;6169;0,0427946182525531;4,28
2016;"1287";"Män";0;87;6089;6176;0,0140867875647668;1,41
2016;"1287";"Kvinnor";0;177;6014;6191;0,0285898885478921;2,86
2016;"1290";"Män";0;543;16734;17277;0,031429067546449;3,14
2016;"1290";"Kvinnor";0;635;17111;17746;0,0357827115969796;3,58
2016;"1291";"Män";0;105;3316;3421;0,0306927798889214;3,07
2016;"1291";"Kvinnor";0;124;3397;3521;0,0352172678216416;3,52
2016;"1292";"Män";0;223;7914;8137;0,0274056777682192;2,74
2016;"1292";"Kvinnor";0;299;8293;8592;0,0347998137802607;3,48
2016;"1293";"Män";0;195;9988;10183;0,0191495629971521;1,91
2016;"1293";"Kvinnor";0;218;8805;9023;0,0241604787764602;2,42
2016;"1315";"Män";0;25;2387;2412;0,0103648424543947;1,04
2016;"1315";"Kvinnor";0;34;1838;1872;0,0181623931623932;1,82
2016;"1380";"Män";0;604;22910;23514;0,02568682487029;2,57
2016;"1380";"Kvinnor";0;793;21368;22161;0,0357835837732954;3,58
2016;"1381";"Män";0;139;4050;4189;0,0331821437097159;3,32
2016;"1381";"Kvinnor";0;133;3623;3756;0,0354100106496273;3,54
2016;"1382";"Män";0;264;9560;9824;0,0268729641693811;2,69
2016;"1382";"Kvinnor";0;373;8904;9277;0,0402069634580144;4,02
2016;"1383";"Män";0;449;14224;14673;0,0306004225448102;3,06
2016;"1383";"Kvinnor";0;738;12909;13647;0,0540778193009453;5,41
2016;"1384";"Män";0;501;10371;10872;0,0460816777041943;4,61
2016;"1384";"Kvinnor";0;864;11419;12283;0,0703411218757632;7,03
2016;"1401";"Män";0;392;7570;7962;0,0492338608389852;4,92
2016;"1401";"Kvinnor";0;247;6396;6643;0,0371819960861057;3,72
2016;"1402";"Män";0;312;5625;5937;0,0525517938352703;5,26
2016;"1402";"Kvinnor";0;448;5021;5469;0,0819162552569025;8,19
2016;"1407";"Män";0;25;1664;1689;0,014801657785672;1,48
2016;"1407";"Kvinnor";0;59;1559;1618;0,0364647713226205;3,65
2016;"1415";"Män";0;114;6902;7016;0,016248574686431;1,62
2016;"1415";"Kvinnor";0;233;4680;4913;0,0474251984530837;4,74
2016;"1419";"Män";0;43;2229;2272;0,0189260563380282;1,89
2016;"1419";"Kvinnor";0;54;2294;2348;0,0229982964224872;2,3
2016;"1421";"Män";0;27;2251;2278;0,0118525021949078;1,19
2016;"1421";"Kvinnor";0;35;2015;2050;0,0170731707317073;1,71
2016;"1427";"Män";0;23;2001;2024;0,0113636363636364;1,14
2016;"1427";"Kvinnor";0;49;1840;1889;0,0259396506087877;2,59
2016;"1430";"Män";0;73;1848;1921;0,0380010411244144;3,8
2016;"1430";"Kvinnor";0;56;1669;1725;0,032463768115942;3,25
2016;"1435";"Män";0;91;2583;2674;0,0340314136125654;3,4
2016;"1435";"Kvinnor";0;160;2219;2379;0,0672551492223623;6,73
2016;"1438";"Män";0;9;1059;1068;0,00842696629213483;0,84
2016;"1438";"Kvinnor";0;15;756;771;0,0194552529182879;1,95
2016;"1439";"Män";0;4;1091;1095;0,00365296803652968;0,37
2016;"1439";"Kvinnor";0;7;926;933;0,007502679528403;0,75
2016;"1440";"Män";0;78;3094;3172;0,0245901639344262;2,46
2016;"1440";"Kvinnor";0;90;3321;3411;0,0263852242744063;2,64
2016;"1441";"Män";0;134;4170;4304;0,0311338289962825;3,11
2016;"1441";"Kvinnor";0;198;5127;5325;0,0371830985915493;3,72
2016;"1442";"Män";0;44;2664;2708;0,0162481536189069;1,62
2016;"1442";"Kvinnor";0;29;1801;1830;0,0158469945355191;1,58
2016;"1443";"Män";0;69;1227;1296;0,0532407407407407;5,32
2016;"1443";"Kvinnor";0;42;1095;1137;0,0369393139841689;3,69
2016;"1444";"Män";0;6;685;691;0,00868306801736614;0,87
2016;"1444";"Kvinnor";0;21;776;797;0,0263488080301129;2,63
2016;"1445";"Män";0;33;1048;1081;0,030527289546716;3,05
2016;"1445";"Kvinnor";0;42;848;890;0,0471910112359551;4,72
2016;"1446";"Män";0;22;1680;1702;0,0129259694477086;1,29
2016;"1446";"Kvinnor";0;21;1173;1194;0,0175879396984925;1,76
2016;"1447";"Män";0;11;968;979;0,0112359550561798;1,12
2016;"1447";"Kvinnor";0;9;794;803;0,0112079701120797;1,12
2016;"1452";"Män";0;66;3234;3300;0,02;2
2016;"1452";"Kvinnor";0;101;2169;2270;0,0444933920704846;4,45
2016;"1460";"Män";0;37;1966;2003;0,018472291562656;1,85
2016;"1460";"Kvinnor";0;76;1723;1799;0,0422456920511395;4,22
2016;"1461";"Män";0;17;1504;1521;0,0111768573307035;1,12
2016;"1461";"Kvinnor";0;65;1334;1399;0,0464617583988563;4,65
2016;"1462";"Män";0;23;1854;1877;0,0122535961640916;1,23
2016;"1462";"Kvinnor";0;26;1894;1920;0,0135416666666667;1,35
2016;"1463";"Män";0;180;5265;5445;0,0330578512396694;3,31
2016;"1463";"Kvinnor";0;218;5054;5272;0,041350531107739;4,14
2016;"1465";"Män";0;210;1627;1837;0,114316820903647;11,43
2016;"1465";"Kvinnor";0;129;1575;1704;0,0757042253521127;7,57
2016;"1466";"Män";0;11;2133;2144;0,00513059701492537;0,51
2016;"1466";"Kvinnor";0;12;1519;1531;0,00783801436969301;0,78
2016;"1470";"Män";0;63;4290;4353;0,0144727773949001;1,45
2016;"1470";"Kvinnor";0;74;2775;2849;0,025974025974026;2,6
2016;"1471";"Män";0;32;3323;3355;0,00953800298062593;0,95
2016;"1471";"Kvinnor";0;29;2346;2375;0,0122105263157895;1,22
2016;"1472";"Män";0;23;1699;1722;0,0133565621370499;1,34
2016;"1472";"Kvinnor";0;23;1611;1634;0,0140758873929009;1,41
2016;"1473";"Män";0;14;1530;1544;0,00906735751295337;0,91
2016;"1473";"Kvinnor";0;27;1342;1369;0,0197224251278305;1,97
2016;"1480";"Män";0;7207;167526;174733;0,0412457864284365;4,12
2016;"1480";"Kvinnor";0;9301;144886;154187;0,0603228547153781;6,03
2016;"1481";"Män";0;615;19797;20412;0,0301293356848912;3,01
2016;"1481";"Kvinnor";0;804;16889;17693;0,0454417001073871;4,54
2016;"1482";"Män";0;233;7915;8148;0,0285959744722631;2,86
2016;"1482";"Kvinnor";0;213;7931;8144;0,0261542239685658;2,62
2016;"1484";"Män";0;43;3086;3129;0,0137424097155641;1,37
2016;"1484";"Kvinnor";0;65;2524;2589;0,0251062186172267;2,51
2016;"1485";"Män";0;293;11213;11506;0,0254649747957587;2,55
2016;"1485";"Kvinnor";0;524;11005;11529;0,045450602827652;4,55
2016;"1486";"Män";0;77;2761;2838;0,0271317829457364;2,71
2016;"1486";"Kvinnor";0;270;2811;3081;0,0876338851022395;8,76
2016;"1487";"Män";0;157;5953;6110;0,02569558101473;2,57
2016;"1487";"Kvinnor";0;212;6425;6637;0,0319421425342775;3,19
2016;"1488";"Män";0;284;13044;13328;0,0213085234093637;2,13
2016;"1488";"Kvinnor";0;472;12707;13179;0,0358145534562562;3,58
2016;"1489";"Män";0;230;6319;6549;0,0351198656283402;3,51
2016;"1489";"Kvinnor";0;313;7248;7561;0,0413966406559979;4,14
2016;"1490";"Män";0;2040;24969;27009;0,0755303787626347;7,55
2016;"1490";"Kvinnor";0;2592;23136;25728;0,100746268656716;10,07
2016;"1491";"Män";0;239;4616;4855;0,0492276004119464;4,92
2016;"1491";"Kvinnor";0;380;3623;4003;0,0949288033974519;9,49
2016;"1492";"Män";0;33;2142;2175;0,0151724137931034;1,52
2016;"1492";"Kvinnor";0;73;1935;2008;0,0363545816733068;3,64
2016;"1493";"Män";0;91;4437;4528;0,0200971731448763;2,01
2016;"1493";"Kvinnor";0;113;4036;4149;0,027235478428537;2,72
2016;"1494";"Män";0;200;8591;8791;0,0227505403253327;2,28
2016;"1494";"Kvinnor";0;285;7651;7936;0,0359122983870968;3,59
2016;"1495";"Män";0;85;4085;4170;0,0203836930455636;2,04
2016;"1495";"Kvinnor";0;107;3701;3808;0,0280987394957983;2,81
2016;"1496";"Män";0;328;16730;17058;0,0192285144800094;1,92
2016;"1496";"Kvinnor";0;422;14161;14583;0,0289378042926695;2,89
2016;"1497";"Män";0;20;1378;1398;0,0143061516452074;1,43
2016;"1497";"Kvinnor";0;26;1381;1407;0,0184790334044065;1,85
2016;"1498";"Män";0;48;2342;2390;0,0200836820083682;2,01
2016;"1498";"Kvinnor";0;55;1874;1929;0,0285121824779679;2,85
2016;"1499";"Män";0;202;6153;6355;0,0317859952793076;3,18
2016;"1499";"Kvinnor";0;244;5386;5630;0,0433392539964476;4,33
2016;"1715";"Män";0;25;1697;1722;0,0145180023228804;1,45
2016;"1715";"Kvinnor";0;27;1375;1402;0,0192582025677603;1,93
2016;"1730";"Män";0;9;1617;1626;0,00553505535055351;0,55
2016;"1730";"Kvinnor";0;114;1757;1871;0,0609299839657937;6,09
2016;"1737";"Män";0;27;2447;2474;0,0109135004042037;1,09
2016;"1737";"Kvinnor";0;40;2453;2493;0,0160449257922182;1,6
2016;"1760";"Män";0;6;507;513;0,0116959064327485;1,17
2016;"1760";"Kvinnor";0;6;447;453;0,0132450331125828;1,32
2016;"1761";"Män";0;39;1945;1984;0,0196572580645161;1,97
2016;"1761";"Kvinnor";0;44;1832;1876;0,023454157782516;2,35
2016;"1762";"Män";0;12;777;789;0,0152091254752852;1,52
2016;"1762";"Kvinnor";0;14;628;642;0,0218068535825545;2,18
2016;"1763";"Män";0;28;1061;1089;0,0257116620752984;2,57
2016;"1763";"Kvinnor";0;24;1339;1363;0,0176082171680117;1,76
2016;"1764";"Män";0;16;1788;1804;0,00886917960088692;0,89
2016;"1764";"Kvinnor";0;13;1199;1212;0,0107260726072607;1,07
2016;"1765";"Män";0;14;1819;1833;0,00763775231860338;0,76
2016;"1765";"Kvinnor";0;76;1743;1819;0,0417811984606927;4,18
2016;"1766";"Män";0;158;2424;2582;0,0611928737412858;6,12
2016;"1766";"Kvinnor";0;135;2108;2243;0,0601872492197949;6,02
2016;"1780";"Män";0;763;24262;25025;0,0304895104895105;3,05
2016;"1780";"Kvinnor";0;1084;22853;23937;0,0452855412123491;4,53
2016;"1781";"Män";0;54;4317;4371;0,0123541523678792;1,24
2016;"1781";"Kvinnor";0;95;3412;3507;0,0270886797832906;2,71
2016;"1782";"Män";0;20;1787;1807;0,0110680686220255;1,11
2016;"1782";"Kvinnor";0;28;1647;1675;0,0167164179104478;1,67
2016;"1783";"Män";0;17;2391;2408;0,00705980066445183;0,71
2016;"1783";"Kvinnor";0;37;1779;1816;0,020374449339207;2,04
2016;"1784";"Män";0;84;5090;5174;0,0162350212601469;1,62
2016;"1784";"Kvinnor";0;137;4540;4677;0,029292281376951;2,93
2016;"1785";"Män";0;30;2987;3017;0,00994365263506795;0,99
2016;"1785";"Kvinnor";0;50;2555;2605;0,0191938579654511;1,92
2016;"1814";"Män";0;13;908;921;0,0141150922909881;1,41
2016;"1814";"Kvinnor";0;15;959;974;0,0154004106776181;1,54
2016;"1860";"Män";0;15;1230;1245;0,0120481927710843;1,2
2016;"1860";"Kvinnor";0;14;862;876;0,0159817351598174;1,6
2016;"1861";"Män";0;47;4066;4113;0,0114271821055191;1,14
2016;"1861";"Kvinnor";0;49;3004;3053;0,016049787094661;1,6
2016;"1862";"Män";0;8;1390;1398;0,00572246065808298;0,57
2016;"1862";"Kvinnor";0;19;1134;1153;0,0164787510841284;1,65
2016;"1863";"Män";0;11;1327;1338;0,00822122571001495;0,82
2016;"1863";"Kvinnor";0;31;1092;1123;0,0276046304541407;2,76
2016;"1864";"Män";0;10;799;809;0,0123609394313968;1,24
2016;"1864";"Kvinnor";0;9;721;730;0,0123287671232877;1,23
2016;"1880";"Män";0;1121;35717;36838;0,0304305336880395;3,04
2016;"1880";"Kvinnor";0;1499;34048;35547;0,0421695220412412;4,22
2016;"1881";"Män";0;96;3674;3770;0,0254641909814324;2,55
2016;"1881";"Kvinnor";0;77;3342;3419;0,0225212050307107;2,25
2016;"1882";"Män";0;29;2147;2176;0,0133272058823529;1,33
2016;"1882";"Kvinnor";0;41;1653;1694;0,0242030696576151;2,42
2016;"1883";"Män";0;134;7210;7344;0,0182461873638344;1,82
2016;"1883";"Kvinnor";0;156;6316;6472;0,0241038318912237;2,41
2016;"1884";"Män";0;19;1407;1426;0,0133239831697055;1,33
2016;"1884";"Kvinnor";0;50;1428;1478;0,03382949932341;3,38
2016;"1885";"Män";0;64;4993;5057;0,0126557247379869;1,27
2016;"1885";"Kvinnor";0;71;4588;4659;0,0152393217428633;1,52
2016;"1904";"Män";0;8;854;862;0,00928074245939675;0,93
2016;"1904";"Kvinnor";0;13;615;628;0,0207006369426752;2,07
2016;"1907";"Män";0;14;1372;1386;0,0101010101010101;1,01
2016;"1907";"Kvinnor";0;18;1160;1178;0,0152801358234295;1,53
2016;"1960";"Män";0;15;1182;1197;0,012531328320802;1,25
2016;"1960";"Kvinnor";0;10;1001;1011;0,00989119683481701;0,99
2016;"1961";"Män";0;22;2452;2474;0,00889248181083266;0,89
2016;"1961";"Kvinnor";0;19;2287;2306;0,00823937554206418;0,82
2016;"1962";"Män";0;15;890;905;0,0165745856353591;1,66
2016;"1962";"Kvinnor";0;19;755;774;0,0245478036175711;2,45
2016;"1980";"Män";0;1050;34133;35183;0,0298439587300685;2,98
2016;"1980";"Kvinnor";0;1413;31114;32527;0,0434408337688689;4,34
2016;"1981";"Män";0;71;3606;3677;0,019309219472396;1,93
2016;"1981";"Kvinnor";0;135;3386;3521;0,0383413802896904;3,83
2016;"1982";"Män";0;29;3379;3408;0,0085093896713615;0,85
2016;"1982";"Kvinnor";0;42;2752;2794;0,0150322118826056;1,5
2016;"1983";"Män";0;94;5892;5986;0,0157033077180087;1,57
2016;"1983";"Kvinnor";0;97;4990;5087;0,0190682130921958;1,91
2016;"1984";"Män";0;21;2760;2781;0,0075512405609493;0,76
2016;"1984";"Kvinnor";0;45;2226;2271;0,0198150594451783;1,98
2016;"2021";"Män";0;13;1260;1273;0,0102120974076984;1,02
2016;"2021";"Kvinnor";0;22;1121;1143;0,0192475940507437;1,92
2016;"2023";"Män";0;57;2752;2809;0,0202919188323247;2,03
2016;"2023";"Kvinnor";0;53;2517;2570;0,0206225680933852;2,06
2016;"2026";"Män";0;28;1343;1371;0,0204230488694384;2,04
2016;"2026";"Kvinnor";0;28;1273;1301;0,02152190622598;2,15
2016;"2029";"Män";0;164;3130;3294;0,0497874924104432;4,98
2016;"2029";"Kvinnor";0;129;2826;2955;0,0436548223350254;4,37
2016;"2031";"Män";0;53;1667;1720;0,0308139534883721;3,08
2016;"2031";"Kvinnor";0;73;1639;1712;0,0426401869158878;4,26
2016;"2034";"Män";0;33;1137;1170;0,0282051282051282;2,82
2016;"2034";"Kvinnor";0;19;895;914;0,0207877461706783;2,08
2016;"2039";"Män";0;10;1499;1509;0,00662690523525514;0,66
2016;"2039";"Kvinnor";0;20;1242;1262;0,0158478605388273;1,58
2016;"2061";"Män";0;12;1610;1622;0,00739827373612824;0,74
2016;"2061";"Kvinnor";0;24;1195;1219;0,0196882690730107;1,97
2016;"2062";"Män";0;82;4925;5007;0,0163770720990613;1,64
2016;"2062";"Kvinnor";0;148;4594;4742;0,0312104597216364;3,12
2016;"2080";"Män";0;682;11402;12084;0,0564382654750083;5,64
2016;"2080";"Kvinnor";0;576;13043;13619;0,0422938541743153;4,23
2016;"2081";"Män";0;140;14373;14513;0,00964652380624268;0,96
2016;"2081";"Kvinnor";0;388;10754;11142;0,0348231915275534;3,48
2016;"2082";"Män";0;22;1487;1509;0,0145791915175613;1,46
2016;"2082";"Kvinnor";0;33;1553;1586;0,0208070617906683;2,08
2016;"2083";"Män";0;41;3157;3198;0,0128205128205128;1,28
2016;"2083";"Kvinnor";0;57;2694;2751;0,0207197382769902;2,07
2016;"2084";"Män";0;101;5226;5327;0,0189600150178337;1,9
2016;"2084";"Kvinnor";0;167;3998;4165;0,0400960384153661;4,01
2016;"2085";"Män";0;75;6594;6669;0,0112460638776428;1,12
2016;"2085";"Kvinnor";0;82;5138;5220;0,0157088122605364;1,57
2016;"2101";"Män";0;9;913;922;0,00976138828633406;0,98
2016;"2101";"Kvinnor";0;9;834;843;0,0106761565836299;1,07
2016;"2104";"Män";0;14;1981;1995;0,00701754385964912;0,7
2016;"2104";"Kvinnor";0;22;1507;1529;0,0143884892086331;1,44
2016;"2121";"Män";0;21;2948;2969;0,00707308858201415;0,71
2016;"2121";"Kvinnor";0;32;1992;2024;0,0158102766798419;1,58
2016;"2132";"Män";0;16;1464;1480;0,0108108108108108;1,08
2016;"2132";"Kvinnor";0;20;1205;1225;0,0163265306122449;1,63
2016;"2161";"Män";0;105;3637;3742;0,0280598610368787;2,81
2016;"2161";"Kvinnor";0;177;3342;3519;0,0502983802216539;5,03
2016;"2180";"Män";0;710;21782;22492;0,0315667792993064;3,16
2016;"2180";"Kvinnor";0;894;20908;21802;0,0410054123474911;4,1
2016;"2181";"Män";0;66;9174;9240;0,00714285714285714;0,71
2016;"2181";"Kvinnor";0;86;7015;7101;0,0121109702858752;1,21
2016;"2182";"Män";0;115;4720;4835;0,0237849017580145;2,38
2016;"2182";"Kvinnor";0;162;4007;4169;0,0388582393859439;3,89
2016;"2183";"Män";0;115;5041;5156;0,0223041117145074;2,23
2016;"2183";"Kvinnor";0;139;5078;5217;0,0266436649415373;2,66
2016;"2184";"Män";0;160;7721;7881;0,0203019921329781;2,03
2016;"2184";"Kvinnor";0;266;7187;7453;0,0356903260432041;3,57
2016;"2260";"Män";0;50;1927;1977;0,0252908447142135;2,53
2016;"2260";"Kvinnor";0;62;1460;1522;0,0407358738501971;4,07
2016;"2262";"Män";0;29;3107;3136;0,00924744897959184;0,92
2016;"2262";"Kvinnor";0;21;2100;2121;0,0099009900990099;0,99
2016;"2280";"Män";0;146;4351;4497;0,0324660885034467;3,25
2016;"2280";"Kvinnor";0;201;4463;4664;0,0430960548885077;4,31
2016;"2281";"Män";0;580;24214;24794;0,023392756312011;2,34
2016;"2281";"Kvinnor";0;843;22316;23159;0,0364005354289909;3,64
2016;"2282";"Män";0;38;3841;3879;0,00979633926269657;0,98
2016;"2282";"Kvinnor";0;51;3250;3301;0,0154498636776734;1,54
2016;"2283";"Män";0;76;3638;3714;0,020463112547119;2,05
2016;"2283";"Kvinnor";0;99;3366;3465;0,0285714285714286;2,86
2016;"2284";"Män";0;243;12767;13010;0,0186779400461184;1,87
2016;"2284";"Kvinnor";0;317;10750;11067;0,0286437155507364;2,86
2016;"2303";"Män";0;6;1091;1097;0,00546946216955333;0,55
2016;"2303";"Kvinnor";0;8;867;875;0,00914285714285714;0,91
2016;"2305";"Män";0;23;1038;1061;0,0216776625824694;2,17
2016;"2305";"Kvinnor";0;29;914;943;0,0307529162248144;3,08
2016;"2309";"Män";0;20;2213;2233;0,00895656068069861;0,9
2016;"2309";"Kvinnor";0;15;1869;1884;0,00796178343949045;0,8
2016;"2313";"Män";0;19;2455;2474;0,00767987065481002;0,77
2016;"2313";"Kvinnor";0;27;1992;2019;0,0133729569093611;1,34
2016;"2321";"Män";0;84;2648;2732;0,0307467057101025;3,07
2016;"2321";"Kvinnor";0;96;2238;2334;0,0411311053984576;4,11
2016;"2326";"Män";0;14;1220;1234;0,0113452188006483;1,13
2016;"2326";"Kvinnor";0;8;1129;1137;0,00703605980650836;0,7
2016;"2361";"Män";0;16;2437;2453;0,00652262535670607;0,65
2016;"2361";"Kvinnor";0;23;2116;2139;0,010752688172043;1,08
2016;"2380";"Män";0;591;15320;15911;0,0371441141348752;3,71
2016;"2380";"Kvinnor";0;667;15380;16047;0,0415654016327039;4,16
2016;"2401";"Män";0;23;1021;1044;0,0220306513409962;2,2
2016;"2401";"Kvinnor";0;22;985;1007;0,0218470705064548;2,18
2016;"2403";"Män";0;3;317;320;0,009375;0,94
2016;"2403";"Kvinnor";0;6;325;331;0,0181268882175227;1,81
2016;"2404";"Män";0;16;1228;1244;0,0128617363344051;1,29
2016;"2404";"Kvinnor";0;31;888;919;0,0337323177366703;3,37
2016;"2409";"Män";0;15;1027;1042;0,0143953934740883;1,44
2016;"2409";"Kvinnor";0;8;1000;1008;0,00793650793650794;0,79
2016;"2417";"Män";0;15;768;783;0,0191570881226054;1,92
2016;"2417";"Kvinnor";0;23;715;738;0,0311653116531165;3,12
2016;"2418";"Män";0;4;727;731;0,00547195622435021;0,55
2016;"2418";"Kvinnor";0;15;618;633;0,023696682464455;2,37
2016;"2421";"Män";0;11;1248;1259;0,00873709293089754;0,87
2016;"2421";"Kvinnor";0;22;1136;1158;0,0189982728842832;1,9
2016;"2422";"Män";0;3;431;434;0,00691244239631336;0,69
2016;"2422";"Kvinnor";0;4;414;418;0,00956937799043062;0,96
2016;"2425";"Män";0;4;486;490;0,00816326530612245;0,82
2016;"2425";"Kvinnor";0;9;466;475;0,0189473684210526;1,89
2016;"2460";"Män";0;12;1269;1281;0,00936768149882904;0,94
2016;"2460";"Kvinnor";0;13;1098;1111;0,0117011701170117;1,17
2016;"2462";"Män";0;32;1061;1093;0,0292772186642269;2,93
2016;"2462";"Kvinnor";0;33;1180;1213;0,0272052761747733;2,72
2016;"2463";"Män";0;1;474;475;0,00210526315789474;0,21
2016;"2463";"Kvinnor";0;7;434;441;0,0158730158730159;1,59
2016;"2480";"Män";0;939;30676;31615;0,0297010912541515;2,97
2016;"2480";"Kvinnor";0;1266;28417;29683;0,0426506754708082;4,27
2016;"2481";"Män";0;43;2759;2802;0,0153461812990721;1,53
2016;"2481";"Kvinnor";0;58;2593;2651;0,021878536401358;2,19
2016;"2482";"Män";0;343;16882;17225;0,0199129172714078;1,99
2016;"2482";"Kvinnor";0;445;13967;14412;0,0308770469053566;3,09
2016;"2505";"Män";0;13;1350;1363;0,00953778429933969;0,95
2016;"2505";"Kvinnor";0;41;1228;1269;0,0323089046493302;3,23
2016;"2506";"Män";0;4;841;845;0,00473372781065089;0,47
2016;"2506";"Kvinnor";0;14;621;635;0,0220472440944882;2,2
2016;"2510";"Män";0;24;1029;1053;0,0227920227920228;2,28
2016;"2510";"Kvinnor";0;44;923;967;0,0455015511892451;4,55
2016;"2513";"Män";0;6;694;700;0,00857142857142857;0,86
2016;"2513";"Kvinnor";0;11;624;635;0,0173228346456693;1,73
2016;"2514";"Män";0;62;3079;3141;0,0197389366443808;1,97
2016;"2514";"Kvinnor";0;92;2787;2879;0,0319555401180966;3,2
2016;"2518";"Män";0;12;703;715;0,0167832167832168;1,68
2016;"2518";"Kvinnor";0;18;677;695;0,0258992805755396;2,59
2016;"2521";"Män";0;30;1006;1036;0,028957528957529;2,9
2016;"2521";"Kvinnor";0;25;939;964;0,0259336099585062;2,59
2016;"2523";"Män";0;55;5125;5180;0,0106177606177606;1,06
2016;"2523";"Kvinnor";0;70;3924;3994;0,0175262894341512;1,75
2016;"2560";"Män";0;3;1383;1386;0,00216450216450216;0,22
2016;"2560";"Kvinnor";0;26;1401;1427;0,0182200420462509;1,82
2016;"2580";"Män";0;638;21163;21801;0,0292647126278611;2,93
2016;"2580";"Kvinnor";0;850;18205;19055;0,0446077145106271;4,46
2016;"2581";"Män";0;188;8582;8770;0,0214367160775371;2,14
2016;"2581";"Kvinnor";0;279;7470;7749;0,0360046457607433;3,6
2016;"2582";"Män";0;51;5353;5404;0,00943745373797187;0,94
2016;"2582";"Kvinnor";0;104;4603;4707;0,0220947524962821;2,21
2016;"2583";"Män";0;27;1484;1511;0,0178689609530112;1,79
2016;"2583";"Kvinnor";0;35;1575;1610;0,0217391304347826;2,17
2016;"2584";"Män";0;116;6995;7111;0,0163127548867951;1,63
2016;"2584";"Kvinnor";0;271;5440;5711;0,0474522850639117;4,75
2016;"9999";"Män";0;1616;166989;168605;0,00958453189407194;0,96
2016;"9999";"Kvinnor";0;1907;180907;182814;0,0104313674007461;1,04
2017;"0114";"Män";0;193;7396;7589;0,0254315456581895;2,54
2017;"0114";"Kvinnor";0;244;6514;6758;0,036105356614383;3,61
2017;"0115";"Män";0;75;4240;4315;0,0173812282734647;1,74
2017;"0115";"Kvinnor";0;97;3782;3879;0,0250064449600412;2,5
2017;"0117";"Män";0;163;4906;5069;0,032156243835076;3,22
2017;"0117";"Kvinnor";0;206;4796;5002;0,0411835265893643;4,12
2017;"0120";"Män";0;222;5616;5838;0,0380267214799589;3,8
2017;"0120";"Kvinnor";0;245;5247;5492;0,0446103423160961;4,46
2017;"0123";"Män";0;421;13871;14292;0,0294570389028827;2,95
2017;"0123";"Kvinnor";0;613;9574;10187;0,0601747325022087;6,02
2017;"0125";"Män";0;126;4448;4574;0,0275470048097945;2,75
2017;"0125";"Kvinnor";0;154;3946;4100;0,0375609756097561;3,76
2017;"0126";"Män";0;475;21689;22164;0,0214311496119834;2,14
2017;"0126";"Kvinnor";0;595;21611;22206;0,026794560028821;2,68
2017;"0127";"Män";0;740;12530;13270;0,0557648831951771;5,58
2017;"0127";"Kvinnor";0;596;9782;10378;0,0574291771054153;5,74
2017;"0128";"Män";0;37;1235;1272;0,0290880503144654;2,91
2017;"0128";"Kvinnor";0;37;1565;1602;0,0230961298377029;2,31
2017;"0136";"Män";0;225;15308;15533;0,0144852893838924;1,45
2017;"0136";"Kvinnor";0;315;11194;11509;0,0273698844382657;2,74
2017;"0138";"Män";0;167;5304;5471;0,0305245841710839;3,05
2017;"0138";"Kvinnor";0;239;4728;4967;0,0481175760016106;4,81
2017;"0139";"Män";0;74;5515;5589;0,0132402934335301;1,32
2017;"0139";"Kvinnor";0;56;3524;3580;0,0156424581005587;1,56
2017;"0140";"Män";0;22;1399;1421;0,0154820548909219;1,55
2017;"0140";"Kvinnor";0;21;1071;1092;0,0192307692307692;1,92
2017;"0160";"Män";0;489;12166;12655;0,0386408534176215;3,86
2017;"0160";"Kvinnor";0;782;10859;11641;0,0671763594192939;6,72
2017;"0162";"Män";0;153;7186;7339;0,0208475269110233;2,08
2017;"0162";"Kvinnor";0;270;10723;10993;0,0245610843263895;2,46
2017;"0163";"Män";0;288;12433;12721;0,0226397295810078;2,26
2017;"0163";"Kvinnor";0;426;11439;11865;0,0359039190897598;3,59
2017;"0180";"Män";0;32118;314883;347001;0,0925588110697087;9,26
2017;"0180";"Kvinnor";0;37911;284530;322441;0,117574998216728;11,76
2017;"0181";"Män";0;483;27284;27767;0,0173947491626751;1,74
2017;"0181";"Kvinnor";0;525;20289;20814;0,0252234073219948;2,52
2017;"0182";"Män";0;942;15706;16648;0,0565833733781836;5,66
2017;"0182";"Kvinnor";0;1222;15200;16422;0,0744123736451102;7,44
2017;"0183";"Män";0;252;11449;11701;0,0215366208016409;2,15
2017;"0183";"Kvinnor";0;248;10557;10805;0,0229523368810736;2,3
2017;"0184";"Män";0;1067;43735;44802;0,0238159010758448;2,38
2017;"0184";"Kvinnor";0;1549;43786;45335;0,034167861475681;3,42
2017;"0186";"Män";0;414;4740;5154;0,080325960419092;8,03
2017;"0186";"Kvinnor";0;441;5662;6103;0,0722595444863182;7,23
2017;"0187";"Män";0;63;1217;1280;0,04921875;4,92
2017;"0187";"Kvinnor";0;67;1353;1420;0,0471830985915493;4,72
2017;"0188";"Män";0;206;10119;10325;0,0199515738498789;2
2017;"0188";"Kvinnor";0;274;10152;10426;0,0262804527143679;2,63
2017;"0191";"Män";0;177;16690;16867;0,0104938637576332;1,05
2017;"0191";"Kvinnor";0;358;11852;12210;0,0293202293202293;2,93
2017;"0192";"Män";0;72;3189;3261;0,0220791168353266;2,21
2017;"0192";"Kvinnor";0;110;3411;3521;0,0312411246804885;3,12
2017;"0305";"Män";0;56;2553;2609;0,0214641625143733;2,15
2017;"0305";"Kvinnor";0;73;2342;2415;0,0302277432712215;3,02
2017;"0319";"Män";0;16;1241;1257;0,0127287191726333;1,27
2017;"0319";"Kvinnor";0;19;1096;1115;0,0170403587443946;1,7
2017;"0330";"Män";0;50;1764;1814;0,0275633958103638;2,76
2017;"0330";"Kvinnor";0;54;1890;1944;0,0277777777777778;2,78
2017;"0331";"Män";0;248;1788;2036;0,121807465618861;12,18
2017;"0331";"Kvinnor";0;195;1778;1973;0,0988342625443487;9,88
2017;"0360";"Män";0;51;3447;3498;0,0145797598627787;1,46
2017;"0360";"Kvinnor";0;58;2885;2943;0,0197077811756711;1,97
2017;"0380";"Män";0;1771;47011;48782;0,0363043745643885;3,63
2017;"0380";"Kvinnor";0;2316;49046;51362;0,0450917020365251;4,51
2017;"0381";"Män";0;127;8744;8871;0,0143163115770488;1,43
2017;"0381";"Kvinnor";0;179;7338;7517;0,0238126912332047;2,38
2017;"0382";"Män";0;30;5139;5169;0,00580383052814858;0,58
2017;"0382";"Kvinnor";0;46;3780;3826;0,0120230005227392;1,2
2017;"0428";"Män";0;71;1375;1446;0,0491009681881051;4,91
2017;"0428";"Kvinnor";0;121;1245;1366;0,0885797950219619;8,86
2017;"0461";"Män";0;39;1093;1132;0,034452296819788;3,45
2017;"0461";"Kvinnor";0;53;1355;1408;0,0376420454545455;3,76
2017;"0480";"Män";0;247;10672;10919;0,0226211191501053;2,26
2017;"0480";"Kvinnor";0;348;11031;11379;0,0305826522541524;3,06
2017;"0481";"Män";0;22;3074;3096;0,00710594315245478;0,71
2017;"0481";"Kvinnor";0;30;1844;1874;0,016008537886873;1,6
2017;"0482";"Män";0;37;2679;2716;0,0136229749631811;1,36
2017;"0482";"Kvinnor";0;48;2412;2460;0,0195121951219512;1,95
2017;"0483";"Män";0;173;6736;6909;0,0250398031553047;2,5
2017;"0483";"Kvinnor";0;164;6133;6297;0,0260441480069875;2,6
2017;"0484";"Män";0;596;20796;21392;0,0278608825729245;2,79
2017;"0484";"Kvinnor";0;891;19839;20730;0,0429811866859624;4,3
2017;"0486";"Män";0;146;5220;5366;0,0272083488632128;2,72
2017;"0486";"Kvinnor";0;207;4876;5083;0,0407239819004525;4,07
2017;"0488";"Män";0;57;1816;1873;0,0304324612920448;3,04
2017;"0488";"Kvinnor";0;86;1734;1820;0,0472527472527473;4,73
2017;"0509";"Män";0;41;787;828;0,0495169082125604;4,95
2017;"0509";"Kvinnor";0;29;704;733;0,0395634379263302;3,96
2017;"0512";"Män";0;17;593;610;0,0278688524590164;2,79
2017;"0512";"Kvinnor";0;19;397;416;0,0456730769230769;4,57
2017;"0513";"Män";0;27;1708;1735;0,0155619596541787;1,56
2017;"0513";"Kvinnor";0;33;1491;1524;0,0216535433070866;2,17
2017;"0560";"Män";0;5;965;970;0,00515463917525773;0,52
2017;"0560";"Kvinnor";0;8;598;606;0,0132013201320132;1,32
2017;"0561";"Män";0;46;1592;1638;0,0280830280830281;2,81
2017;"0561";"Kvinnor";0;42;1287;1329;0,0316027088036117;3,16
2017;"0562";"Män";0;35;5464;5499;0,00636479359883615;0,64
2017;"0562";"Kvinnor";0;44;3596;3640;0,0120879120879121;1,21
2017;"0563";"Män";0;19;1357;1376;0,0138081395348837;1,38
2017;"0563";"Kvinnor";0;26;1064;1090;0,0238532110091743;2,39
2017;"0580";"Män";0;869;41629;42498;0,0204480210833451;2,04
2017;"0580";"Kvinnor";0;1154;36838;37992;0,0303748157506844;3,04
2017;"0581";"Män";0;978;31396;32374;0,0302094273182183;3,02
2017;"0581";"Kvinnor";0;1209;29103;30312;0,0398851939825812;3,99
2017;"0582";"Män";0;50;1953;2003;0,0249625561657514;2,5
2017;"0582";"Kvinnor";0;52;1859;1911;0,0272108843537415;2,72
2017;"0583";"Män";0;161;6857;7018;0,0229410088344258;2,29
2017;"0583";"Kvinnor";0;183;7108;7291;0,025099437662872;2,51
2017;"0584";"Män";0;41;1469;1510;0,0271523178807947;2,72
2017;"0584";"Kvinnor";0;46;1260;1306;0,0352220520673813;3,52
2017;"0586";"Män";0;55;6973;7028;0,00782583949914627;0,78
2017;"0586";"Kvinnor";0;104;4607;4711;0,0220759923583103;2,21
2017;"0604";"Män";0;12;1294;1306;0,00918836140888208;0,92
2017;"0604";"Kvinnor";0;15;1068;1083;0,0138504155124654;1,39
2017;"0617";"Män";0;44;3510;3554;0,0123804164321891;1,24
2017;"0617";"Kvinnor";0;54;2355;2409;0,0224159402241594;2,24
2017;"0642";"Män";0;19;1370;1389;0,013678905687545;1,37
2017;"0642";"Kvinnor";0;56;1154;1210;0,0462809917355372;4,63
2017;"0643";"Män";0;28;1795;1823;0,0153592978606692;1,54
2017;"0643";"Kvinnor";0;41;1568;1609;0,0254816656308266;2,55
2017;"0662";"Män";0;79;7798;7877;0,0100291989336042;1
2017;"0662";"Kvinnor";0;141;5791;5932;0,0237693863789616;2,38
2017;"0665";"Män";0;33;3016;3049;0,0108232207281076;1,08
2017;"0665";"Kvinnor";0;42;2144;2186;0,0192131747483989;1,92
2017;"0680";"Män";0;1083;36324;37407;0,0289518004651536;2,9
2017;"0680";"Kvinnor";0;1255;32166;33421;0,0375512402381736;3,76
2017;"0682";"Män";0;106;6752;6858;0,0154564012831729;1,55
2017;"0682";"Kvinnor";0;127;5469;5596;0,0226947819871337;2,27
2017;"0683";"Män";0;144;8561;8705;0,0165422171165997;1,65
2017;"0683";"Kvinnor";0;208;7658;7866;0,0264429188914315;2,64
2017;"0684";"Män";0;16;2512;2528;0,00632911392405063;0,63
2017;"0684";"Kvinnor";0;45;1843;1888;0,0238347457627119;2,38
2017;"0685";"Män";0;72;6889;6961;0,0103433414739262;1,03
2017;"0685";"Kvinnor";0;112;5108;5220;0,021455938697318;2,15
2017;"0686";"Män";0;48;4572;4620;0,0103896103896104;1,04
2017;"0686";"Kvinnor";0;92;4405;4497;0,0204580831665555;2,05
2017;"0687";"Män";0;112;4340;4452;0,0251572327044025;2,52
2017;"0687";"Kvinnor";0;124;3385;3509;0,0353377030493018;3,53
2017;"0760";"Män";0;9;2754;2763;0,00325732899022801;0,33
2017;"0760";"Kvinnor";0;15;1806;1821;0,00823723228995058;0,82
2017;"0761";"Män";0;7;1202;1209;0,00578990901571547;0,58
2017;"0761";"Kvinnor";0;45;1181;1226;0,0367047308319739;3,67
2017;"0763";"Män";0;32;2888;2920;0,010958904109589;1,1
2017;"0763";"Kvinnor";0;35;2289;2324;0,0150602409638554;1,51
2017;"0764";"Män";0;55;3944;3999;0,0137534383595899;1,38
2017;"0764";"Kvinnor";0;52;3007;3059;0,0169990192873488;1,7
2017;"0765";"Män";0;1273;4406;5679;0,224159182954746;22,42
2017;"0765";"Kvinnor";0;1297;3860;5157;0,251502811712236;25,15
2017;"0767";"Män";0;49;3101;3150;0,0155555555555556;1,56
2017;"0767";"Kvinnor";0;41;1909;1950;0,021025641025641;2,1
2017;"0780";"Män";0;765;22587;23352;0,03275950668037;3,28
2017;"0780";"Kvinnor";0;913;21009;21922;0,041647659885047;4,16
2017;"0781";"Män";0;286;6653;6939;0,0412163135898544;4,12
2017;"0781";"Kvinnor";0;214;5456;5670;0,0377425044091711;3,77
2017;"0821";"Män";0;7;750;757;0,00924702774108322;0,92
2017;"0821";"Kvinnor";0;8;871;879;0,00910125142207053;0,91
2017;"0834";"Män";0;9;1127;1136;0,00792253521126761;0,79
2017;"0834";"Kvinnor";0;13;889;902;0,0144124168514412;1,44
2017;"0840";"Män";0;34;2375;2409;0,0141137401411374;1,41
2017;"0840";"Kvinnor";0;92;2280;2372;0,0387858347386172;3,88
2017;"0860";"Män";0;24;2609;2633;0,0091150778579567;0,91
2017;"0860";"Kvinnor";0;24;2262;2286;0,010498687664042;1,05
2017;"0861";"Män";0;21;2277;2298;0,00913838120104439;0,91
2017;"0861";"Kvinnor";0;33;1876;1909;0,0172865374541645;1,73
2017;"0862";"Män";0;34;2472;2506;0,0135674381484437;1,36
2017;"0862";"Kvinnor";0;39;1641;1680;0,0232142857142857;2,32
2017;"0880";"Män";0;597;16090;16687;0,0357763528495236;3,58
2017;"0880";"Kvinnor";0;798;15423;16221;0,0491954873312373;4,92
2017;"0881";"Män";0;39;3980;4019;0,00970390644438915;0,97
2017;"0881";"Kvinnor";0;61;3169;3230;0,0188854489164087;1,89
2017;"0882";"Män";0;61;8270;8331;0,00732205017404873;0,73
2017;"0882";"Kvinnor";0;119;6056;6175;0,0192712550607287;1,93
2017;"0883";"Män";0;111;7032;7143;0,0155396892062159;1,55
2017;"0883";"Kvinnor";0;177;6919;7096;0,0249436302142052;2,49
2017;"0884";"Män";0;315;3761;4076;0,0772816486751717;7,73
2017;"0884";"Kvinnor";0;317;2878;3195;0,0992175273865415;9,92
2017;"0885";"Män";0;60;1973;2033;0,029513034923758;2,95
2017;"0885";"Kvinnor";0;79;1755;1834;0,0430752453653217;4,31
2017;"0980";"Män";0;450;12571;13021;0,0345595576376622;3,46
2017;"0980";"Kvinnor";0;529;11795;12324;0,0429243752028562;4,29
2017;"1060";"Män";0;30;4594;4624;0,0064878892733564;0,65
2017;"1060";"Kvinnor";0;35;2574;2609;0,0134151015714833;1,34
2017;"1080";"Män";0;414;15353;15767;0,0262573729942285;2,63
2017;"1080";"Kvinnor";0;457;13667;14124;0,0323562730104786;3,24
2017;"1081";"Män";0;92;5616;5708;0,0161177295024527;1,61
2017;"1081";"Kvinnor";0;114;4415;4529;0,0251711194524178;2,52
2017;"1082";"Män";0;173;5807;5980;0,0289297658862876;2,89
2017;"1082";"Kvinnor";0;212;5810;6022;0,0352042510793756;3,52
2017;"1083";"Män";0;69;3133;3202;0,0215490318550906;2,15
2017;"1083";"Kvinnor";0;78;2637;2715;0,0287292817679558;2,87
2017;"1214";"Män";0;33;1713;1746;0,0189003436426117;1,89
2017;"1214";"Kvinnor";0;43;1779;1822;0,0236004390779363;2,36
2017;"1230";"Män";0;74;3392;3466;0,0213502596653203;2,14
2017;"1230";"Kvinnor";0;56;2591;2647;0,0211560256894598;2,12
2017;"1231";"Män";0;110;4744;4854;0,0226617222908941;2,27
2017;"1231";"Kvinnor";0;208;2982;3190;0,0652037617554859;6,52
2017;"1233";"Män";0;151;3866;4017;0,0375902414737366;3,76
2017;"1233";"Kvinnor";0;184;4167;4351;0,0422891289358768;4,23
2017;"1256";"Män";0;44;2222;2266;0,0194174757281553;1,94
2017;"1256";"Kvinnor";0;58;1717;1775;0,0326760563380282;3,27
2017;"1257";"Män";0;16;1781;1797;0,00890372843628269;0,89
2017;"1257";"Kvinnor";0;24;1599;1623;0,0147874306839187;1,48
2017;"1260";"Män";0;13;2392;2405;0,00540540540540541;0,54
2017;"1260";"Kvinnor";0;16;1959;1975;0,00810126582278481;0,81
2017;"1261";"Män";0;89;3468;3557;0,0250210851841439;2,5
2017;"1261";"Kvinnor";0;203;3497;3700;0,0548648648648649;5,49
2017;"1262";"Män";0;75;2589;2664;0,0281531531531532;2,82
2017;"1262";"Kvinnor";0;101;2865;2966;0,0340525960890088;3,41
2017;"1263";"Män";0;61;3568;3629;0,0168090383025627;1,68
2017;"1263";"Kvinnor";0;85;2719;2804;0,0303138373751783;3,03
2017;"1264";"Män";0;53;1921;1974;0,0268490374873354;2,68
2017;"1264";"Kvinnor";0;62;1794;1856;0,0334051724137931;3,34
2017;"1265";"Män";0;46;2809;2855;0,0161120840630473;1,61
2017;"1265";"Kvinnor";0;60;2586;2646;0,0226757369614512;2,27
2017;"1266";"Män";0;32;2353;2385;0,0134171907756813;1,34
2017;"1266";"Kvinnor";0;60;2260;2320;0,0258620689655172;2,59
2017;"1267";"Män";0;46;2026;2072;0,0222007722007722;2,22
2017;"1267";"Kvinnor";0;58;2538;2596;0,0223420647149461;2,23
2017;"1270";"Män";0;59;2360;2419;0,024390243902439;2,44
2017;"1270";"Kvinnor";0;72;2104;2176;0,0330882352941176;3,31
2017;"1272";"Män";0;33;2335;2368;0,0139358108108108;1,39
2017;"1272";"Kvinnor";0;34;1757;1791;0,0189838079285315;1,9
2017;"1273";"Män";0;33;2107;2140;0,0154205607476636;1,54
2017;"1273";"Kvinnor";0;51;1853;1904;0,0267857142857143;2,68
2017;"1275";"Män";0;9;1833;1842;0,00488599348534202;0,49
2017;"1275";"Kvinnor";0;12;1226;1238;0,00969305331179321;0,97
2017;"1276";"Män";0;88;2803;2891;0,0304392943618125;3,04
2017;"1276";"Kvinnor";0;58;2298;2356;0,0246179966044143;2,46
2017;"1277";"Män";0;22;3099;3121;0,00704902274911887;0,7
2017;"1277";"Kvinnor";0;106;2612;2718;0,0389992641648271;3,9
2017;"1278";"Män";0;79;3146;3225;0,0244961240310078;2,45
2017;"1278";"Kvinnor";0;99;2731;2830;0,034982332155477;3,5
2017;"1280";"Män";0;5211;83767;88978;0,0585650385488548;5,86
2017;"1280";"Kvinnor";0;5668;78312;83980;0,0674922600619195;6,75
2017;"1281";"Män";0;783;32153;32936;0,0237733786737916;2,38
2017;"1281";"Kvinnor";0;1176;32071;33247;0,0353716124763137;3,54
2017;"1282";"Män";0;243;7761;8004;0,030359820089955;3,04
2017;"1282";"Kvinnor";0;244;6328;6572;0,0371272063298844;3,71
2017;"1283";"Män";0;1429;34340;35769;0,0399507953814756;4
2017;"1283";"Kvinnor";0;1836;30479;32315;0,0568157202537521;5,68
2017;"1284";"Män";0;156;3811;3967;0,0393244265187799;3,93
2017;"1284";"Kvinnor";0;200;3677;3877;0,0515862780500387;5,16
2017;"1285";"Män";0;166;5170;5336;0,0311094452773613;3,11
2017;"1285";"Kvinnor";0;148;4739;4887;0,0302844280744833;3,03
2017;"1286";"Män";0;160;5608;5768;0,0277392510402219;2,77
2017;"1286";"Kvinnor";0;253;6002;6255;0,0404476418864908;4,04
2017;"1287";"Män";0;92;6095;6187;0,0148698884758364;1,49
2017;"1287";"Kvinnor";0;185;6110;6295;0,0293884034948372;2,94
2017;"1290";"Män";0;509;17060;17569;0,0289714838636234;2,9
2017;"1290";"Kvinnor";0;643;17234;17877;0,035968003580019;3,6
2017;"1291";"Män";0;108;3361;3469;0,0311328913231479;3,11
2017;"1291";"Kvinnor";0;131;3404;3535;0,0370579915134371;3,71
2017;"1292";"Män";0;208;8140;8348;0,0249161475802587;2,49
2017;"1292";"Kvinnor";0;291;8412;8703;0,0334367459496725;3,34
2017;"1293";"Män";0;191;10297;10488;0,018211289092296;1,82
2017;"1293";"Kvinnor";0;210;8919;9129;0,0230036148537627;2,3
2017;"1315";"Män";0;30;2425;2455;0,0122199592668024;1,22
2017;"1315";"Kvinnor";0;36;1879;1915;0,018798955613577;1,88
2017;"1380";"Män";0;588;23188;23776;0,0247308209959623;2,47
2017;"1380";"Kvinnor";0;733;21748;22481;0,0326053111516392;3,26
2017;"1381";"Män";0;148;4059;4207;0,0351794628000951;3,52
2017;"1381";"Kvinnor";0;141;3626;3767;0,0374303159012477;3,74
2017;"1382";"Män";0;260;9725;9985;0,0260390585878818;2,6
2017;"1382";"Kvinnor";0;379;9056;9435;0,0401695813460519;4,02
2017;"1383";"Män";0;440;14381;14821;0,0296876054247352;2,97
2017;"1383";"Kvinnor";0;757;13070;13827;0,0547479568959283;5,47
2017;"1384";"Män";0;480;10619;11099;0,0432471393819263;4,32
2017;"1384";"Kvinnor";0;842;11543;12385;0,0679854662898668;6,8
2017;"1401";"Män";0;379;7859;8238;0,0460063122117019;4,6
2017;"1401";"Kvinnor";0;251;6631;6882;0,0364719558267945;3,65
2017;"1402";"Män";0;312;5610;5922;0,0526849037487335;5,27
2017;"1402";"Kvinnor";0;474;5089;5563;0,0852058241955779;8,52
2017;"1407";"Män";0;27;1649;1676;0,016109785202864;1,61
2017;"1407";"Kvinnor";0;56;1581;1637;0,034208918753818;3,42
2017;"1415";"Män";0;124;6957;7081;0,017511650896766;1,75
2017;"1415";"Kvinnor";0;227;4730;4957;0,0457938269114384;4,58
2017;"1419";"Män";0;43;2342;2385;0,0180293501048218;1,8
2017;"1419";"Kvinnor";0;53;2276;2329;0,0227565478746243;2,28
2017;"1421";"Män";0;27;2306;2333;0,0115730818688384;1,16
2017;"1421";"Kvinnor";0;38;2043;2081;0,0182604517059106;1,83
2017;"1427";"Män";0;35;2009;2044;0,0171232876712329;1,71
2017;"1427";"Kvinnor";0;49;1808;1857;0,0263866451265482;2,64
2017;"1430";"Män";0;74;1835;1909;0,0387637506547931;3,88
2017;"1430";"Kvinnor";0;58;1585;1643;0,0353012781497261;3,53
2017;"1435";"Män";0;85;2559;2644;0,0321482602118003;3,21
2017;"1435";"Kvinnor";0;150;2164;2314;0,0648228176318064;6,48
2017;"1438";"Män";0;8;1069;1077;0,0074280408542247;0,74
2017;"1438";"Kvinnor";0;14;767;781;0,0179257362355954;1,79
2017;"1439";"Män";0;3;1178;1181;0,00254022015241321;0,25
2017;"1439";"Kvinnor";0;6;986;992;0,00604838709677419;0,6
2017;"1440";"Män";0;70;3333;3403;0,0205700852189245;2,06
2017;"1440";"Kvinnor";0;96;3508;3604;0,0266370699223085;2,66
2017;"1441";"Män";0;139;4187;4326;0,0321312991215904;3,21
2017;"1441";"Kvinnor";0;208;5032;5240;0,0396946564885496;3,97
2017;"1442";"Män";0;37;2786;2823;0,0131066241586964;1,31
2017;"1442";"Kvinnor";0;30;1831;1861;0,016120365394949;1,61
2017;"1443";"Män";0;63;1256;1319;0,0477634571645186;4,78
2017;"1443";"Kvinnor";0;48;1089;1137;0,0422163588390501;4,22
2017;"1444";"Män";0;7;712;719;0,00973574408901252;0,97
2017;"1444";"Kvinnor";0;21;797;818;0,0256723716381418;2,57
2017;"1445";"Män";0;32;1096;1128;0,0283687943262411;2,84
2017;"1445";"Kvinnor";0;42;874;916;0,0458515283842795;4,59
2017;"1446";"Män";0;28;1671;1699;0,0164802825191289;1,65
2017;"1446";"Kvinnor";0;28;1164;1192;0,023489932885906;2,35
2017;"1447";"Män";0;9;944;953;0,00944386149003148;0,94
2017;"1447";"Kvinnor";0;10;777;787;0,0127064803049555;1,27
2017;"1452";"Män";0;64;3318;3382;0,0189237137788291;1,89
2017;"1452";"Kvinnor";0;95;2174;2269;0,0418686646099603;4,19
2017;"1460";"Män";0;44;1969;2013;0,0218579234972678;2,19
2017;"1460";"Kvinnor";0;66;1728;1794;0,0367892976588629;3,68
2017;"1461";"Män";0;17;1561;1578;0,0107731305449937;1,08
2017;"1461";"Kvinnor";0;67;1339;1406;0,0476529160739687;4,77
2017;"1462";"Män";0;19;1882;1901;0,00999473961073119;1
2017;"1462";"Kvinnor";0;26;1914;1940;0,0134020618556701;1,34
2017;"1463";"Män";0;198;5227;5425;0,0364976958525346;3,65
2017;"1463";"Kvinnor";0;204;4986;5190;0,0393063583815029;3,93
2017;"1465";"Män";0;201;1615;1816;0,11068281938326;11,07
2017;"1465";"Kvinnor";0;137;1577;1714;0,0799299883313886;7,99
2017;"1466";"Män";0;14;2075;2089;0,00670177118238392;0,67
2017;"1466";"Kvinnor";0;14;1505;1519;0,00921658986175115;0,92
2017;"1470";"Män";0;63;4331;4394;0,0143377332726445;1,43
2017;"1470";"Kvinnor";0;75;2771;2846;0,0263527758257203;2,64
2017;"1471";"Män";0;27;3475;3502;0,00770988006853227;0,77
2017;"1471";"Kvinnor";0;30;2361;2391;0,0125470514429109;1,25
2017;"1472";"Män";0;20;1703;1723;0,0116076610562972;1,16
2017;"1472";"Kvinnor";0;30;1603;1633;0,0183710961420698;1,84
2017;"1473";"Män";0;7;1608;1615;0,0043343653250774;0,43
2017;"1473";"Kvinnor";0;24;1366;1390;0,0172661870503597;1,73
2017;"1480";"Män";0;7093;174516;181609;0,0390564344278092;3,91
2017;"1480";"Kvinnor";0;9422;150656;160078;0,0588588063319132;5,89
2017;"1481";"Män";0;746;20470;21216;0,0351621417797888;3,52
2017;"1481";"Kvinnor";0;841;17544;18385;0,0457438128909437;4,57
2017;"1482";"Män";0;235;7828;8063;0,0291454793501178;2,91
2017;"1482";"Kvinnor";0;230;7924;8154;0,0282070149619819;2,82
2017;"1484";"Män";0;38;3119;3157;0,0120367437440608;1,2
2017;"1484";"Kvinnor";0;62;2626;2688;0,0230654761904762;2,31
2017;"1485";"Män";0;292;11597;11889;0,0245605181259988;2,46
2017;"1485";"Kvinnor";0;533;11282;11815;0,0451121455776555;4,51
2017;"1486";"Män";0;79;2805;2884;0,0273925104022191;2,74
2017;"1486";"Kvinnor";0;268;2787;3055;0,0877250409165303;8,77
2017;"1487";"Män";0;153;6101;6254;0,0244643428205948;2,45
2017;"1487";"Kvinnor";0;203;6395;6598;0,0307668990603213;3,08
2017;"1488";"Män";0;279;13326;13605;0,0205071664829107;2,05
2017;"1488";"Kvinnor";0;445;12964;13409;0,0331866656723096;3,32
2017;"1489";"Män";0;205;6328;6533;0,0313791519975509;3,14
2017;"1489";"Kvinnor";0;293;7341;7634;0,0383809274299188;3,84
2017;"1490";"Män";0;2061;25488;27549;0,074812152891212;7,48
2017;"1490";"Kvinnor";0;2662;23425;26087;0,102043163261395;10,2
2017;"1491";"Män";0;239;4755;4994;0,0478574289146976;4,79
2017;"1491";"Kvinnor";0;356;3720;4076;0,0873405299313052;8,73
2017;"1492";"Män";0;33;2113;2146;0,0153774464119292;1,54
2017;"1492";"Kvinnor";0;68;1971;2039;0,0333496812162825;3,33
2017;"1493";"Män";0;86;4443;4529;0,0189887392360344;1,9
2017;"1493";"Kvinnor";0;106;3986;4092;0,0259042033235582;2,59
2017;"1494";"Män";0;196;8637;8833;0,0221895165855315;2,22
2017;"1494";"Kvinnor";0;280;7872;8152;0,0343473994111874;3,43
2017;"1495";"Män";0;83;4188;4271;0,0194333879653477;1,94
2017;"1495";"Kvinnor";0;106;3739;3845;0,0275682704811443;2,76
2017;"1496";"Män";0;353;17310;17663;0,0199852799637661;2
2017;"1496";"Kvinnor";0;418;14647;15065;0,0277464321274477;2,77
2017;"1497";"Män";0;20;1353;1373;0,0145666423889294;1,46
2017;"1497";"Kvinnor";0;22;1356;1378;0,0159651669085631;1,6
2017;"1498";"Män";0;43;2402;2445;0,0175869120654397;1,76
2017;"1498";"Kvinnor";0;57;1917;1974;0,0288753799392097;2,89
2017;"1499";"Män";0;220;6224;6444;0,0341402855369336;3,41
2017;"1499";"Kvinnor";0;265;5425;5690;0,046572934973638;4,66
2017;"1715";"Män";0;22;1680;1702;0,0129259694477086;1,29
2017;"1715";"Kvinnor";0;32;1400;1432;0,0223463687150838;2,23
2017;"1730";"Män";0;8;1633;1641;0,0048750761730652;0,49
2017;"1730";"Kvinnor";0;114;1761;1875;0,0608;6,08
2017;"1737";"Män";0;28;2469;2497;0,0112134561473769;1,12
2017;"1737";"Kvinnor";0;42;2412;2454;0,0171149144254279;1,71
2017;"1760";"Män";0;6;542;548;0,0109489051094891;1,09
2017;"1760";"Kvinnor";0;5;437;442;0,0113122171945701;1,13
2017;"1761";"Män";0;33;1994;2027;0,0162802170695609;1,63
2017;"1761";"Kvinnor";0;51;1863;1914;0,0266457680250784;2,66
2017;"1762";"Män";0;14;810;824;0,0169902912621359;1,7
2017;"1762";"Kvinnor";0;13;640;653;0,0199081163859112;1,99
2017;"1763";"Män";0;20;1064;1084;0,018450184501845;1,85
2017;"1763";"Kvinnor";0;30;1363;1393;0,0215362526920316;2,15
2017;"1764";"Män";0;11;1838;1849;0,00594916170903191;0,59
2017;"1764";"Kvinnor";0;14;1274;1288;0,0108695652173913;1,09
2017;"1765";"Män";0;19;1768;1787;0,0106323447118075;1,06
2017;"1765";"Kvinnor";0;68;1755;1823;0,0373011519473396;3,73
2017;"1766";"Män";0;144;2444;2588;0,0556414219474498;5,56
2017;"1766";"Kvinnor";0;132;2071;2203;0,0599182932364957;5,99
2017;"1780";"Män";0;769;24769;25538;0,0301119899757225;3,01
2017;"1780";"Kvinnor";0;1090;23061;24151;0,0451327067202186;4,51
2017;"1781";"Män";0;51;4307;4358;0,0117026158788435;1,17
2017;"1781";"Kvinnor";0;103;3475;3578;0,0287870318613751;2,88
2017;"1782";"Män";0;21;1781;1802;0,01165371809101;1,17
2017;"1782";"Kvinnor";0;31;1631;1662;0,0186522262334537;1,87
2017;"1783";"Män";0;20;2397;2417;0,00827472072817542;0,83
2017;"1783";"Kvinnor";0;39;1805;1844;0,0211496746203905;2,11
2017;"1784";"Män";0;91;5129;5220;0,0174329501915709;1,74
2017;"1784";"Kvinnor";0;131;4565;4696;0,0278960817717206;2,79
2017;"1785";"Män";0;29;3082;3111;0,00932176149148184;0,93
2017;"1785";"Kvinnor";0;56;2629;2685;0,0208566108007449;2,09
2017;"1814";"Män";0;10;984;994;0,0100603621730382;1,01
2017;"1814";"Kvinnor";0;13;954;967;0,0134436401240951;1,34
2017;"1860";"Män";0;9;1213;1222;0,00736497545008183;0,74
2017;"1860";"Kvinnor";0;14;879;893;0,0156774916013438;1,57
2017;"1861";"Män";0;40;4035;4075;0,0098159509202454;0,98
2017;"1861";"Kvinnor";0;51;3042;3093;0,0164888457807953;1,65
2017;"1862";"Män";0;4;1360;1364;0,00293255131964809;0,29
2017;"1862";"Kvinnor";0;18;1159;1177;0,0152931180968564;1,53
2017;"1863";"Män";0;13;1319;1332;0,00975975975975976;0,98
2017;"1863";"Kvinnor";0;26;1096;1122;0,0231729055258467;2,32
2017;"1864";"Män";0;17;803;820;0,0207317073170732;2,07
2017;"1864";"Kvinnor";0;10;736;746;0,0134048257372654;1,34
2017;"1880";"Män";0;1175;36915;38090;0,0308479915988448;3,08
2017;"1880";"Kvinnor";0;1522;34932;36454;0,0417512481483513;4,18
2017;"1881";"Män";0;90;3633;3723;0,024174053182917;2,42
2017;"1881";"Kvinnor";0;81;3378;3459;0,023417172593235;2,34
2017;"1882";"Män";0;27;2224;2251;0,011994669035984;1,2
2017;"1882";"Kvinnor";0;47;1669;1716;0,0273892773892774;2,74
2017;"1883";"Män";0;129;7247;7376;0,0174891540130152;1,75
2017;"1883";"Kvinnor";0;159;6346;6505;0,0244427363566487;2,44
2017;"1884";"Män";0;25;1468;1493;0,0167448091091762;1,67
2017;"1884";"Kvinnor";0;49;1490;1539;0,0318388564002599;3,18
2017;"1885";"Män";0;68;5022;5090;0,0133595284872299;1,34
2017;"1885";"Kvinnor";0;63;4615;4678;0,0134672937152629;1,35
2017;"1904";"Män";0;6;870;876;0,00684931506849315;0,68
2017;"1904";"Kvinnor";0;14;602;616;0,0227272727272727;2,27
2017;"1907";"Män";0;8;1283;1291;0,00619674670797831;0,62
2017;"1907";"Kvinnor";0;16;1166;1182;0,0135363790186125;1,35
2017;"1960";"Män";0;19;1171;1190;0,0159663865546218;1,6
2017;"1960";"Kvinnor";0;9;1040;1049;0,00857959961868446;0,86
2017;"1961";"Män";0;20;2436;2456;0,00814332247557003;0,81
2017;"1961";"Kvinnor";0;13;2378;2391;0,0054370556252614;0,54
2017;"1962";"Män";0;16;915;931;0,0171858216970999;1,72
2017;"1962";"Kvinnor";0;15;811;826;0,0181598062953995;1,82
2017;"1980";"Män";0;1016;35035;36051;0,0281822973010457;2,82
2017;"1980";"Kvinnor";0;1364;31659;33023;0,0413045453169003;4,13
2017;"1981";"Män";0;80;3627;3707;0,0215807930941462;2,16
2017;"1981";"Kvinnor";0;140;3364;3504;0,0399543378995434;4
2017;"1982";"Män";0;30;3445;3475;0,00863309352517986;0,86
2017;"1982";"Kvinnor";0;42;2774;2816;0,0149147727272727;1,49
2017;"1983";"Män";0;96;6012;6108;0,0157170923379175;1,57
2017;"1983";"Kvinnor";0;96;5003;5099;0,0188272210237301;1,88
2017;"1984";"Män";0;19;2843;2862;0,006638714185884;0,66
2017;"1984";"Kvinnor";0;40;2257;2297;0,0174140182847192;1,74
2017;"2021";"Män";0;15;1349;1364;0,0109970674486804;1,1
2017;"2021";"Kvinnor";0;19;1152;1171;0,0162254483347566;1,62
2017;"2023";"Män";0;49;2774;2823;0,0173574211831385;1,74
2017;"2023";"Kvinnor";0;52;2460;2512;0,0207006369426752;2,07
2017;"2026";"Män";0;17;1283;1300;0,0130769230769231;1,31
2017;"2026";"Kvinnor";0;13;1290;1303;0,00997697620874904;1
2017;"2029";"Män";0;172;3118;3290;0,0522796352583587;5,23
2017;"2029";"Kvinnor";0;146;2822;2968;0,0491913746630728;4,92
2017;"2031";"Män";0;60;1670;1730;0,0346820809248555;3,47
2017;"2031";"Kvinnor";0;75;1590;1665;0,045045045045045;4,5
2017;"2034";"Män";0;33;1133;1166;0,0283018867924528;2,83
2017;"2034";"Kvinnor";0;18;929;947;0,0190073917634636;1,9
2017;"2039";"Män";0;9;1496;1505;0,00598006644518272;0,6
2017;"2039";"Kvinnor";0;22;1241;1263;0,0174188440221694;1,74
2017;"2061";"Män";0;13;1680;1693;0,00767867690490254;0,77
2017;"2061";"Kvinnor";0;19;1239;1258;0,0151033386327504;1,51
2017;"2062";"Män";0;75;5053;5128;0,0146255850234009;1,46
2017;"2062";"Kvinnor";0;144;4608;4752;0,0303030303030303;3,03
2017;"2080";"Män";0;624;11637;12261;0,0508930756055787;5,09
2017;"2080";"Kvinnor";0;560;13091;13651;0,041022635704344;4,1
2017;"2081";"Män";0;156;14650;14806;0,0105362690801027;1,05
2017;"2081";"Kvinnor";0;393;10838;11231;0,0349924316623631;3,5
2017;"2082";"Män";0;21;1461;1482;0,01417004048583;1,42
2017;"2082";"Kvinnor";0;33;1531;1564;0,0210997442455243;2,11
2017;"2083";"Män";0;38;3156;3194;0,0118973074514715;1,19
2017;"2083";"Kvinnor";0;62;2716;2778;0,0223182145428366;2,23
2017;"2084";"Män";0;81;5293;5374;0,0150725716412356;1,51
2017;"2084";"Kvinnor";0;160;4121;4281;0,0373744452230787;3,74
2017;"2085";"Män";0;73;6658;6731;0,0108453424454019;1,08
2017;"2085";"Kvinnor";0;86;5079;5165;0,0166505324298161;1,67
2017;"2101";"Män";0;10;884;894;0,0111856823266219;1,12
2017;"2101";"Kvinnor";0;7;824;831;0,00842358604091456;0,84
2017;"2104";"Män";0;14;1994;2008;0,00697211155378486;0,7
2017;"2104";"Kvinnor";0;18;1416;1434;0,0125523012552301;1,26
2017;"2121";"Män";0;16;2937;2953;0,00541821876058246;0,54
2017;"2121";"Kvinnor";0;36;1974;2010;0,017910447761194;1,79
2017;"2132";"Män";0;16;1467;1483;0,0107889413351315;1,08
2017;"2132";"Kvinnor";0;18;1196;1214;0,014827018121911;1,48
2017;"2161";"Män";0;118;3538;3656;0,0322757111597374;3,23
2017;"2161";"Kvinnor";0;173;3278;3451;0,0501303969863808;5,01
2017;"2180";"Män";0;684;22261;22945;0,0298104162126825;2,98
2017;"2180";"Kvinnor";0;925;21328;22253;0,0415674291106817;4,16
2017;"2181";"Män";0;64;9276;9340;0,00685224839400428;0,69
2017;"2181";"Kvinnor";0;95;7069;7164;0,0132607481853713;1,33
2017;"2182";"Män";0;118;4848;4966;0,0237615787354007;2,38
2017;"2182";"Kvinnor";0;171;4009;4180;0,0409090909090909;4,09
2017;"2183";"Män";0;124;5112;5236;0,0236822001527884;2,37
2017;"2183";"Kvinnor";0;148;5101;5249;0,0281958468279672;2,82
2017;"2184";"Män";0;170;7863;8033;0,0211627038466326;2,12
2017;"2184";"Kvinnor";0;260;7394;7654;0,0339691664489156;3,4
2017;"2260";"Män";0;51;1910;1961;0,0260071392146864;2,6
2017;"2260";"Kvinnor";0;58;1491;1549;0,0374435119431892;3,74
2017;"2262";"Män";0;26;3108;3134;0,00829610721123165;0,83
2017;"2262";"Kvinnor";0;21;2087;2108;0,00996204933586338;1
2017;"2280";"Män";0;150;4363;4513;0,0332373144249945;3,32
2017;"2280";"Kvinnor";0;190;4428;4618;0,0411433521004764;4,11
2017;"2281";"Män";0;536;24523;25059;0,0213895207310747;2,14
2017;"2281";"Kvinnor";0;853;22420;23273;0,0366519142353801;3,67
2017;"2282";"Män";0;42;3872;3914;0,0107307102708227;1,07
2017;"2282";"Kvinnor";0;51;3240;3291;0,0154968094804011;1,55
2017;"2283";"Män";0;75;3643;3718;0,0201721355567509;2,02
2017;"2283";"Kvinnor";0;101;3388;3489;0,0289481226712525;2,89
2017;"2284";"Män";0;242;12617;12859;0,018819503849444;1,88
2017;"2284";"Kvinnor";0;328;10749;11077;0,0296109054798231;2,96
2017;"2303";"Män";0;7;1085;1092;0,00641025641025641;0,64
2017;"2303";"Kvinnor";0;7;873;880;0,00795454545454545;0,8
2017;"2305";"Män";0;18;1042;1060;0,0169811320754717;1,7
2017;"2305";"Kvinnor";0;27;901;928;0,0290948275862069;2,91
2017;"2309";"Män";0;17;2191;2208;0,00769927536231884;0,77
2017;"2309";"Kvinnor";0;15;1831;1846;0,00812567713976165;0,81
2017;"2313";"Män";0;16;2426;2442;0,00655200655200655;0,66
2017;"2313";"Kvinnor";0;26;2082;2108;0,0123339658444023;1,23
2017;"2321";"Män";0;88;2799;2887;0,0304814686525805;3,05
2017;"2321";"Kvinnor";0;102;2359;2461;0,041446566436408;4,14
2017;"2326";"Män";0;14;1245;1259;0,011119936457506;1,11
2017;"2326";"Kvinnor";0;10;1160;1170;0,00854700854700855;0,85
2017;"2361";"Män";0;9;2432;2441;0,00368701351904957;0,37
2017;"2361";"Kvinnor";0;21;2141;2162;0,00971322849213691;0,97
2017;"2380";"Män";0;598;15670;16268;0,0367592820260634;3,68
2017;"2380";"Kvinnor";0;680;15585;16265;0,0418075622502306;4,18
2017;"2401";"Män";0;21;1011;1032;0,0203488372093023;2,03
2017;"2401";"Kvinnor";0;26;966;992;0,0262096774193548;2,62
2017;"2403";"Män";0;3;325;328;0,00914634146341463;0,91
2017;"2403";"Kvinnor";0;6;352;358;0,0167597765363128;1,68
2017;"2404";"Män";0;12;1207;1219;0,00984413453650533;0,98
2017;"2404";"Kvinnor";0;13;886;899;0,014460511679644;1,45
2017;"2409";"Män";0;11;1003;1014;0,0108481262327416;1,08
2017;"2409";"Kvinnor";0;7;1011;1018;0,0068762278978389;0,69
2017;"2417";"Män";0;13;752;765;0,0169934640522876;1,7
2017;"2417";"Kvinnor";0;22;710;732;0,0300546448087432;3,01
2017;"2418";"Män";0;5;704;709;0,00705218617771509;0,71
2017;"2418";"Kvinnor";0;14;590;604;0,0231788079470199;2,32
2017;"2421";"Män";0;9;1290;1299;0,0069284064665127;0,69
2017;"2421";"Kvinnor";0;23;1137;1160;0,0198275862068966;1,98
2017;"2422";"Män";0;3;462;465;0,00645161290322581;0,65
2017;"2422";"Kvinnor";0;4;434;438;0,0091324200913242;0,91
2017;"2425";"Män";0;1;511;512;0,001953125;0,2
2017;"2425";"Kvinnor";0;9;460;469;0,0191897654584222;1,92
2017;"2460";"Män";0;9;1250;1259;0,00714853057982526;0,71
2017;"2460";"Kvinnor";0;17;1113;1130;0,0150442477876106;1,5
2017;"2462";"Män";0;30;1093;1123;0,0267141585040071;2,67
2017;"2462";"Kvinnor";0;29;1193;1222;0,0237315875613748;2,37
2017;"2463";"Män";0;1;465;466;0,00214592274678112;0,21
2017;"2463";"Kvinnor";0;8;419;427;0,0187353629976581;1,87
2017;"2480";"Män";0;900;31356;32256;0,0279017857142857;2,79
2017;"2480";"Kvinnor";0;1242;28945;30187;0,0411435386093351;4,11
2017;"2481";"Män";0;36;2774;2810;0,0128113879003559;1,28
2017;"2481";"Kvinnor";0;57;2600;2657;0,0214527662777569;2,15
2017;"2482";"Män";0;331;16978;17309;0,0191229995955861;1,91
2017;"2482";"Kvinnor";0;415;13987;14402;0,0288154422996806;2,88
2017;"2505";"Män";0;16;1375;1391;0,0115025161754134;1,15
2017;"2505";"Kvinnor";0;33;1251;1284;0,0257009345794393;2,57
2017;"2506";"Män";0;4;830;834;0,00479616306954436;0,48
2017;"2506";"Kvinnor";0;16;601;617;0,0259319286871961;2,59
2017;"2510";"Män";0;27;1021;1048;0,025763358778626;2,58
2017;"2510";"Kvinnor";0;43;911;954;0,0450733752620545;4,51
2017;"2513";"Män";0;5;622;627;0,00797448165869218;0,8
2017;"2513";"Kvinnor";0;19;603;622;0,0305466237942122;3,05
2017;"2514";"Män";0;55;3239;3294;0,0166970248937462;1,67
2017;"2514";"Kvinnor";0;91;2947;3038;0,0299539170506912;3
2017;"2518";"Män";0;14;719;733;0,0190995907230559;1,91
2017;"2518";"Kvinnor";0;16;661;677;0,0236336779911374;2,36
2017;"2521";"Män";0;33;986;1019;0,0323846908734053;3,24
2017;"2521";"Kvinnor";0;23;910;933;0,0246516613076099;2,47
2017;"2523";"Män";0;46;4965;5011;0,00917980443025344;0,92
2017;"2523";"Kvinnor";0;65;3869;3934;0,0165226232841891;1,65
2017;"2560";"Män";0;2;1413;1415;0,00141342756183746;0,14
2017;"2560";"Kvinnor";0;23;1412;1435;0,0160278745644599;1,6
2017;"2580";"Män";0;611;21077;21688;0,0281722611582442;2,82
2017;"2580";"Kvinnor";0;853;18224;19077;0,0447135293809299;4,47
2017;"2581";"Män";0;166;8670;8836;0,0187867813490267;1,88
2017;"2581";"Kvinnor";0;274;7426;7700;0,0355844155844156;3,56
2017;"2582";"Män";0;41;5235;5276;0,0077710386656558;0,78
2017;"2582";"Kvinnor";0;93;4635;4728;0,0196700507614213;1,97
2017;"2583";"Män";0;28;1495;1523;0,0183847669074196;1,84
2017;"2583";"Kvinnor";0;31;1545;1576;0,0196700507614213;1,97
2017;"2584";"Män";0;146;6860;7006;0,0208392806166143;2,08
2017;"2584";"Kvinnor";0;273;5287;5560;0,0491007194244604;4,91
2017;"9999";"Män";0;1720;174318;176038;0,00977061770754042;0,98
2017;"9999";"Kvinnor";0;1844;180232;182076;0,0101276390078868;1,01
2018;"0114";"Män";0;193;7390;7583;0,0254516682051958;2,55
2018;"0114";"Kvinnor";0;251;6369;6620;0,0379154078549849;3,79
2018;"0115";"Män";0;81;4189;4270;0,0189695550351288;1,9
2018;"0115";"Kvinnor";0;102;3783;3885;0,0262548262548263;2,63
2018;"0117";"Män";0;144;4948;5092;0,02827965435978;2,83
2018;"0117";"Kvinnor";0;217;4855;5072;0,0427839116719243;4,28
2018;"0120";"Män";0;240;5537;5777;0,0415440540072702;4,15
2018;"0120";"Kvinnor";0;234;5271;5505;0,0425068119891008;4,25
2018;"0123";"Män";0;370;14234;14604;0,0253355245138318;2,53
2018;"0123";"Kvinnor";0;609;9879;10488;0,0580663615560641;5,81
2018;"0125";"Män";0;117;4417;4534;0,0258050286722541;2,58
2018;"0125";"Kvinnor";0;161;3923;4084;0,0394221351616063;3,94
2018;"0126";"Män";0;470;21790;22260;0,0211141060197664;2,11
2018;"0126";"Kvinnor";0;603;22255;22858;0,0263802607402222;2,64
2018;"0127";"Män";0;697;12634;13331;0,0522841497262021;5,23
2018;"0127";"Kvinnor";0;614;9769;10383;0,0591351247231051;5,91
2018;"0128";"Män";0;42;1276;1318;0,031866464339909;3,19
2018;"0128";"Kvinnor";0;42;1481;1523;0,0275771503611294;2,76
2018;"0136";"Män";0;233;15350;15583;0,0149521914907271;1,5
2018;"0136";"Kvinnor";0;333;11315;11648;0,0285885989010989;2,86
2018;"0138";"Män";0;182;5286;5468;0,0332845647403072;3,33
2018;"0138";"Kvinnor";0;264;4726;4990;0,0529058116232465;5,29
2018;"0139";"Män";0;66;5758;5824;0,0113324175824176;1,13
2018;"0139";"Kvinnor";0;53;3690;3743;0,0141597648944697;1,42
2018;"0140";"Män";0;24;1449;1473;0,0162932790224033;1,63
2018;"0140";"Kvinnor";0;20;1088;1108;0,0180505415162455;1,81
2018;"0160";"Män";0;468;12305;12773;0,0366397870508103;3,66
2018;"0160";"Kvinnor";0;738;10926;11664;0,0632716049382716;6,33
2018;"0162";"Män";0;184;7263;7447;0,0247079360816436;2,47
2018;"0162";"Kvinnor";0;293;10810;11103;0,0263892641628389;2,64
2018;"0163";"Män";0;270;12572;12842;0,0210247624980533;2,1
2018;"0163";"Kvinnor";0;414;11424;11838;0,0349721236695388;3,5
2018;"0180";"Män";0;32270;319249;351519;0,0918015811378617;9,18
2018;"0180";"Kvinnor";0;38244;288512;326756;0,117041462130764;11,7
2018;"0181";"Män";0;479;28181;28660;0,0167131891137474;1,67
2018;"0181";"Kvinnor";0;548;20936;21484;0,0255073543101843;2,55
2018;"0182";"Män";0;906;16145;17051;0,0531347135065392;5,31
2018;"0182";"Kvinnor";0;1164;15479;16643;0,0699393138256324;6,99
2018;"0183";"Män";0;280;11043;11323;0,0247284288616091;2,47
2018;"0183";"Kvinnor";0;273;10759;11032;0,024746192893401;2,47
2018;"0184";"Män";0;1091;46126;47217;0,0231060846728932;2,31
2018;"0184";"Kvinnor";0;1483;45270;46753;0,0317198896327508;3,17
2018;"0186";"Män";0;425;4728;5153;0,082476227440326;8,25
2018;"0186";"Kvinnor";0;404;5641;6045;0,0668320926385443;6,68
2018;"0187";"Män";0;67;1171;1238;0,0541195476575121;5,41
2018;"0187";"Kvinnor";0;73;1297;1370;0,0532846715328467;5,33
2018;"0188";"Män";0;204;10243;10447;0,0195271369771226;1,95
2018;"0188";"Kvinnor";0;285;10259;10544;0,0270295902883156;2,7
2018;"0191";"Män";0;178;17601;17779;0,0100118116879465;1
2018;"0191";"Kvinnor";0;284;11973;12257;0,0231704332218324;2,32
2018;"0192";"Män";0;81;3219;3300;0,0245454545454545;2,45
2018;"0192";"Kvinnor";0;116;3406;3522;0,0329358319136854;3,29
2018;"0305";"Män";0;58;2568;2626;0,0220868240670221;2,21
2018;"0305";"Kvinnor";0;76;2373;2449;0,0310330747243773;3,1
2018;"0319";"Män";0;14;1281;1295;0,0108108108108108;1,08
2018;"0319";"Kvinnor";0;19;1097;1116;0,0170250896057348;1,7
2018;"0330";"Män";0;50;1785;1835;0,0272479564032698;2,72
2018;"0330";"Kvinnor";0;53;1927;1980;0,0267676767676768;2,68
2018;"0331";"Män";0;396;1943;2339;0,169303120991877;16,93
2018;"0331";"Kvinnor";0;264;1804;2068;0,127659574468085;12,77
2018;"0360";"Män";0;53;3541;3594;0,0147468002225932;1,47
2018;"0360";"Kvinnor";0;56;2953;3009;0,0186108341641741;1,86
2018;"0380";"Män";0;1691;47121;48812;0,0346431205441285;3,46
2018;"0380";"Kvinnor";0;2220;49222;51442;0,0431553983126628;4,32
2018;"0381";"Män";0;129;8916;9045;0,0142620232172471;1,43
2018;"0381";"Kvinnor";0;195;7572;7767;0,0251062186172267;2,51
2018;"0382";"Män";0;30;5179;5209;0,00575926281435976;0,58
2018;"0382";"Kvinnor";0;55;3854;3909;0,014070094653364;1,41
2018;"0428";"Män";0;66;1343;1409;0,0468417317246274;4,68
2018;"0428";"Kvinnor";0;117;1219;1336;0,0875748502994012;8,76
2018;"0461";"Män";0;40;1130;1170;0,0341880341880342;3,42
2018;"0461";"Kvinnor";0;52;1352;1404;0,037037037037037;3,7
2018;"0480";"Män";0;256;10698;10954;0,0233704582800803;2,34
2018;"0480";"Kvinnor";0;380;11176;11556;0,03288335064036;3,29
2018;"0481";"Män";0;21;3083;3104;0,00676546391752577;0,68
2018;"0481";"Kvinnor";0;28;1860;1888;0,0148305084745763;1,48
2018;"0482";"Män";0;39;2816;2855;0,0136602451838879;1,37
2018;"0482";"Kvinnor";0;62;2383;2445;0,0253578732106339;2,54
2018;"0483";"Män";0;177;6909;7086;0,0249788314987299;2,5
2018;"0483";"Kvinnor";0;155;6327;6482;0,0239123727244678;2,39
2018;"0484";"Män";0;613;21101;21714;0,0282306346136133;2,82
2018;"0484";"Kvinnor";0;882;19988;20870;0,0422616195495927;4,23
2018;"0486";"Män";0;147;5361;5508;0,0266884531590414;2,67
2018;"0486";"Kvinnor";0;204;4993;5197;0,03925341543198;3,93
2018;"0488";"Män";0;56;1866;1922;0,0291363163371488;2,91
2018;"0488";"Kvinnor";0;78;1774;1852;0,0421166306695464;4,21
2018;"0509";"Män";0;43;815;858;0,0501165501165501;5,01
2018;"0509";"Kvinnor";0;25;680;705;0,0354609929078014;3,55
2018;"0512";"Män";0;12;583;595;0,0201680672268908;2,02
2018;"0512";"Kvinnor";0;16;378;394;0,0406091370558376;4,06
2018;"0513";"Män";0;26;1720;1746;0,0148911798396334;1,49
2018;"0513";"Kvinnor";0;26;1461;1487;0,0174848688634835;1,75
2018;"0560";"Män";0;7;963;970;0,00721649484536083;0,72
2018;"0560";"Kvinnor";0;11;605;616;0,0178571428571429;1,79
2018;"0561";"Män";0;39;1564;1603;0,024329382407985;2,43
2018;"0561";"Kvinnor";0;39;1246;1285;0,0303501945525292;3,04
2018;"0562";"Män";0;27;5477;5504;0,00490552325581395;0,49
2018;"0562";"Kvinnor";0;41;3625;3666;0,0111838516093835;1,12
2018;"0563";"Män";0;16;1336;1352;0,0118343195266272;1,18
2018;"0563";"Kvinnor";0;20;1059;1079;0,0185356811862836;1,85
2018;"0580";"Män";0;868;42653;43521;0,0199443946600492;1,99
2018;"0580";"Kvinnor";0;1136;37774;38910;0,0291955795425341;2,92
2018;"0581";"Män";0;895;32255;33150;0,0269984917043741;2,7
2018;"0581";"Kvinnor";0;1218;29229;30447;0,0400039412750025;4
2018;"0582";"Män";0;45;1977;2022;0,0222551928783383;2,23
2018;"0582";"Kvinnor";0;42;1861;1903;0,022070415133999;2,21
2018;"0583";"Män";0;138;6886;7024;0,0196469248291572;1,96
2018;"0583";"Kvinnor";0;175;7124;7299;0,023975887107823;2,4
2018;"0584";"Män";0;42;1476;1518;0,0276679841897233;2,77
2018;"0584";"Kvinnor";0;42;1323;1365;0,0307692307692308;3,08
2018;"0586";"Män";0;52;7217;7269;0,00715366625395515;0,72
2018;"0586";"Kvinnor";0;107;4468;4575;0,0233879781420765;2,34
2018;"0604";"Män";0;13;1235;1248;0,0104166666666667;1,04
2018;"0604";"Kvinnor";0;16;1075;1091;0,0146654445462878;1,47
2018;"0617";"Män";0;40;3586;3626;0,0110314396028682;1,1
2018;"0617";"Kvinnor";0;54;2430;2484;0,0217391304347826;2,17
2018;"0642";"Män";0;21;1311;1332;0,0157657657657658;1,58
2018;"0642";"Kvinnor";0;56;1159;1215;0,0460905349794239;4,61
2018;"0643";"Män";0;24;1784;1808;0,0132743362831858;1,33
2018;"0643";"Kvinnor";0;40;1592;1632;0,0245098039215686;2,45
2018;"0662";"Män";0;80;7960;8040;0,00995024875621891;1
2018;"0662";"Kvinnor";0;133;5850;5983;0,0222296506769179;2,22
2018;"0665";"Män";0;43;3069;3112;0,0138174807197943;1,38
2018;"0665";"Kvinnor";0;53;2199;2252;0,0235346358792185;2,35
2018;"0680";"Män";0;1061;37595;38656;0,0274472268211921;2,74
2018;"0680";"Kvinnor";0;1228;32708;33936;0,0361857614332862;3,62
2018;"0682";"Män";0;110;6850;6960;0,0158045977011494;1,58
2018;"0682";"Kvinnor";0;118;5393;5511;0,0214117220105244;2,14
2018;"0683";"Män";0;137;8766;8903;0,0153880714365944;1,54
2018;"0683";"Kvinnor";0;202;7740;7942;0,0254343993956182;2,54
2018;"0684";"Män";0;26;2469;2495;0,0104208416833667;1,04
2018;"0684";"Kvinnor";0;60;1913;1973;0,0304105423213381;3,04
2018;"0685";"Män";0;64;6925;6989;0,00915724710258978;0,92
2018;"0685";"Kvinnor";0;115;5110;5225;0,0220095693779904;2,2
2018;"0686";"Män";0;50;4634;4684;0,0106746370623399;1,07
2018;"0686";"Kvinnor";0;82;4515;4597;0,0178377202523385;1,78
2018;"0687";"Män";0;110;4399;4509;0,0243956531381681;2,44
2018;"0687";"Kvinnor";0;123;3511;3634;0,0338470005503577;3,38
2018;"0760";"Män";0;8;2869;2877;0,00278067431352103;0,28
2018;"0760";"Kvinnor";0;16;1861;1877;0,00852424080980288;0,85
2018;"0761";"Män";0;8;1150;1158;0,00690846286701209;0,69
2018;"0761";"Kvinnor";0;42;1183;1225;0,0342857142857143;3,43
2018;"0763";"Män";0;34;2885;2919;0,0116478245974649;1,16
2018;"0763";"Kvinnor";0;37;2351;2388;0,0154941373534338;1,55
2018;"0764";"Män";0;49;4003;4052;0,0120927936821323;1,21
2018;"0764";"Kvinnor";0;55;2973;3028;0,0181638044914135;1,82
2018;"0765";"Män";0;1377;4412;5789;0,237864916220418;23,79
2018;"0765";"Kvinnor";0;1408;3834;5242;0,268599771079741;26,86
2018;"0767";"Män";0;58;3223;3281;0,017677537336178;1,77
2018;"0767";"Kvinnor";0;47;1936;1983;0,0237014624306606;2,37
2018;"0780";"Män";0;784;23135;23919;0,0327772900204858;3,28
2018;"0780";"Kvinnor";0;933;21234;22167;0,0420895926377047;4,21
2018;"0781";"Män";0;290;6723;7013;0,0413517752744902;4,14
2018;"0781";"Kvinnor";0;203;5544;5747;0,0353227771010962;3,53
2018;"0821";"Män";0;7;766;773;0,00905562742561449;0,91
2018;"0821";"Kvinnor";0;8;871;879;0,00910125142207053;0,91
2018;"0834";"Män";0;11;1131;1142;0,00963222416812609;0,96
2018;"0834";"Kvinnor";0;16;907;923;0,0173347778981582;1,73
2018;"0840";"Män";0;35;2282;2317;0,0151057401812689;1,51
2018;"0840";"Kvinnor";0;91;2325;2416;0,0376655629139073;3,77
2018;"0860";"Män";0;20;2686;2706;0,0073909830007391;0,74
2018;"0860";"Kvinnor";0;26;2259;2285;0,0113785557986871;1,14
2018;"0861";"Män";0;22;2273;2295;0,00958605664488017;0,96
2018;"0861";"Kvinnor";0;42;1908;1950;0,0215384615384615;2,15
2018;"0862";"Män";0;30;2562;2592;0,0115740740740741;1,16
2018;"0862";"Kvinnor";0;37;1651;1688;0,0219194312796209;2,19
2018;"0880";"Män";0;584;16544;17128;0,0340962167211583;3,41
2018;"0880";"Kvinnor";0;739;15791;16530;0,0447065940713854;4,47
2018;"0881";"Män";0;37;4006;4043;0,00915162008409597;0,92
2018;"0881";"Kvinnor";0;60;3273;3333;0,018001800180018;1,8
2018;"0882";"Män";0;59;8110;8169;0,00722242624556249;0,72
2018;"0882";"Kvinnor";0;110;5893;6003;0,0183241712477095;1,83
2018;"0883";"Män";0;113;7102;7215;0,0156618156618157;1,57
2018;"0883";"Kvinnor";0;185;6891;7076;0,0261447145279819;2,61
2018;"0884";"Män";0;309;3786;4095;0,0754578754578755;7,55
2018;"0884";"Kvinnor";0;321;2941;3262;0,098405885959534;9,84
2018;"0885";"Män";0;65;1972;2037;0,0319096710849288;3,19
2018;"0885";"Kvinnor";0;71;1720;1791;0,03964265773311;3,96
2018;"0980";"Män";0;406;12868;13274;0,0305861081814073;3,06
2018;"0980";"Kvinnor";0;529;11916;12445;0,0425070309361189;4,25
2018;"1060";"Män";0;28;4606;4634;0,00604229607250755;0,6
2018;"1060";"Kvinnor";0;34;2577;2611;0,0130218307162007;1,3
2018;"1080";"Män";0;428;15332;15760;0,0271573604060914;2,72
2018;"1080";"Kvinnor";0;442;13548;13990;0,0315939957112223;3,16
2018;"1081";"Män";0;82;5621;5703;0,0143783973347361;1,44
2018;"1081";"Kvinnor";0;110;4455;4565;0,0240963855421687;2,41
2018;"1082";"Män";0;179;5862;6041;0,0296308558185731;2,96
2018;"1082";"Kvinnor";0;204;5908;6112;0,0333769633507853;3,34
2018;"1083";"Män";0;69;3129;3198;0,0215759849906191;2,16
2018;"1083";"Kvinnor";0;67;2561;2628;0,0254946727549467;2,55
2018;"1214";"Män";0;30;1708;1738;0,0172612197928654;1,73
2018;"1214";"Kvinnor";0;38;1820;1858;0,0204520990312164;2,05
2018;"1230";"Män";0;61;3628;3689;0,0165356465166712;1,65
2018;"1230";"Kvinnor";0;59;2650;2709;0,0217792543373939;2,18
2018;"1231";"Män";0;115;4897;5012;0,0229449321628093;2,29
2018;"1231";"Kvinnor";0;203;3001;3204;0,0633583021223471;6,34
2018;"1233";"Män";0;148;3822;3970;0,03727959697733;3,73
2018;"1233";"Kvinnor";0;181;4175;4356;0,0415518824609734;4,16
2018;"1256";"Män";0;49;2145;2194;0,0223336371923428;2,23
2018;"1256";"Kvinnor";0;54;1715;1769;0,0305257207461843;3,05
2018;"1257";"Män";0;14;1814;1828;0,00765864332603939;0,77
2018;"1257";"Kvinnor";0;23;1568;1591;0,0144563167818982;1,45
2018;"1260";"Män";0;9;2169;2178;0,00413223140495868;0,41
2018;"1260";"Kvinnor";0;17;1792;1809;0,00939745715865119;0,94
2018;"1261";"Män";0;80;3507;3587;0,0223027599665459;2,23
2018;"1261";"Kvinnor";0;211;3503;3714;0,0568120624663436;5,68
2018;"1262";"Män";0;80;2517;2597;0,0308047747400847;3,08
2018;"1262";"Kvinnor";0;108;2841;2949;0,0366225839267548;3,66
2018;"1263";"Män";0;75;3489;3564;0,021043771043771;2,1
2018;"1263";"Kvinnor";0;78;2732;2810;0,0277580071174377;2,78
2018;"1264";"Män";0;66;1941;2007;0,0328849028400598;3,29
2018;"1264";"Kvinnor";0;60;1863;1923;0,031201248049922;3,12
2018;"1265";"Män";0;48;2874;2922;0,0164271047227926;1,64
2018;"1265";"Kvinnor";0;60;2615;2675;0,0224299065420561;2,24
2018;"1266";"Män";0;31;2397;2428;0,0127677100494234;1,28
2018;"1266";"Kvinnor";0;49;2325;2374;0,0206402695871946;2,06
2018;"1267";"Män";0;55;2020;2075;0,0265060240963855;2,65
2018;"1267";"Kvinnor";0;62;2509;2571;0,0241151302994944;2,41
2018;"1270";"Män";0;59;2353;2412;0,0244610281923715;2,45
2018;"1270";"Kvinnor";0;73;2097;2170;0,0336405529953917;3,36
2018;"1272";"Män";0;32;2372;2404;0,0133111480865225;1,33
2018;"1272";"Kvinnor";0;35;1843;1878;0,0186368477103301;1,86
2018;"1273";"Män";0;26;2118;2144;0,0121268656716418;1,21
2018;"1273";"Kvinnor";0;31;1869;1900;0,0163157894736842;1,63
2018;"1275";"Män";0;8;1836;1844;0,00433839479392625;0,43
2018;"1275";"Kvinnor";0;12;1228;1240;0,00967741935483871;0,97
2018;"1276";"Män";0;84;2771;2855;0,0294220665499124;2,94
2018;"1276";"Kvinnor";0;63;2314;2377;0,0265039966344131;2,65
2018;"1277";"Män";0;20;3157;3177;0,00629524708844822;0,63
2018;"1277";"Kvinnor";0;66;2713;2779;0,0237495501979129;2,37
2018;"1278";"Män";0;85;3174;3259;0,0260816201288739;2,61
2018;"1278";"Kvinnor";0;100;2724;2824;0,0354107648725212;3,54
2018;"1280";"Män";0;5251;85882;91133;0,0576190841956262;5,76
2018;"1280";"Kvinnor";0;5729;79652;85381;0,067099237535283;6,71
2018;"1281";"Män";0;808;33400;34208;0,0236202057998129;2,36
2018;"1281";"Kvinnor";0;1198;33395;34593;0,034631283785737;3,46
2018;"1282";"Män";0;208;8028;8236;0,0252549781447305;2,53
2018;"1282";"Kvinnor";0;218;6492;6710;0,0324888226527571;3,25
2018;"1283";"Män";0;1392;35523;36915;0,0377082486793986;3,77
2018;"1283";"Kvinnor";0;1843;31298;33141;0,0556108747472919;5,56
2018;"1284";"Män";0;143;3904;4047;0,035334815913022;3,53
2018;"1284";"Kvinnor";0;188;3722;3910;0,0480818414322251;4,81
2018;"1285";"Män";0;161;5159;5320;0,0302631578947368;3,03
2018;"1285";"Kvinnor";0;138;4809;4947;0,0278956943602183;2,79
2018;"1286";"Män";0;163;5812;5975;0,0272803347280335;2,73
2018;"1286";"Kvinnor";0;256;5911;6167;0,0415112696610994;4,15
2018;"1287";"Män";0;101;6137;6238;0,0161910868868227;1,62
2018;"1287";"Kvinnor";0;171;6104;6275;0,0272509960159363;2,73
2018;"1290";"Män";0;508;17511;18019;0,0281924635107387;2,82
2018;"1290";"Kvinnor";0;693;17026;17719;0,0391105592866415;3,91
2018;"1291";"Män";0;99;3306;3405;0,0290748898678414;2,91
2018;"1291";"Kvinnor";0;141;3373;3514;0,0401252134319863;4,01
2018;"1292";"Män";0;205;8264;8469;0,0242059275002952;2,42
2018;"1292";"Kvinnor";0;297;8470;8767;0,0338770388958595;3,39
2018;"1293";"Män";0;197;10331;10528;0,0187120060790274;1,87
2018;"1293";"Kvinnor";0;219;8928;9147;0,0239422761561168;2,39
2018;"1315";"Män";0;30;2451;2481;0,0120918984280532;1,21
2018;"1315";"Kvinnor";0;39;1934;1973;0,0197668525088697;1,98
2018;"1380";"Män";0;587;23862;24449;0,0240091619289132;2,4
2018;"1380";"Kvinnor";0;805;21888;22693;0,0354734940289957;3,55
2018;"1381";"Män";0;145;4090;4235;0,0342384887839433;3,42
2018;"1381";"Kvinnor";0;133;3739;3872;0,034349173553719;3,43
2018;"1382";"Män";0;243;9878;10121;0,0240094852287323;2,4
2018;"1382";"Kvinnor";0;369;9153;9522;0,0387523629489603;3,88
2018;"1383";"Män";0;472;14218;14690;0,0321307011572498;3,21
2018;"1383";"Kvinnor";0;773;13182;13955;0,0553923324973128;5,54
2018;"1384";"Män";0;481;10587;11068;0,0434586194434406;4,35
2018;"1384";"Kvinnor";0;832;11659;12491;0,0666079577295653;6,66
2018;"1401";"Män";0;354;8064;8418;0,0420527441197434;4,21
2018;"1401";"Kvinnor";0;256;6698;6954;0,0368133448375036;3,68
2018;"1402";"Män";0;290;5714;6004;0,0483011325782811;4,83
2018;"1402";"Kvinnor";0;441;5075;5516;0,0799492385786802;7,99
2018;"1407";"Män";0;24;1649;1673;0,0143454871488344;1,43
2018;"1407";"Kvinnor";0;55;1518;1573;0,034965034965035;3,5
2018;"1415";"Män";0;108;6967;7075;0,0152650176678445;1,53
2018;"1415";"Kvinnor";0;223;4874;5097;0,043751226211497;4,38
2018;"1419";"Män";0;37;2386;2423;0,0152703260420966;1,53
2018;"1419";"Kvinnor";0;54;2223;2277;0,0237154150197628;2,37
2018;"1421";"Män";0;21;2304;2325;0,00903225806451613;0,9
2018;"1421";"Kvinnor";0;38;2001;2039;0,0186365865620402;1,86
2018;"1427";"Män";0;37;1953;1990;0,0185929648241206;1,86
2018;"1427";"Kvinnor";0;51;1791;1842;0,0276872964169381;2,77
2018;"1430";"Män";0;76;1794;1870;0,0406417112299465;4,06
2018;"1430";"Kvinnor";0;58;1611;1669;0,0347513481126423;3,48
2018;"1435";"Män";0;81;2564;2645;0,0306238185255199;3,06
2018;"1435";"Kvinnor";0;141;2216;2357;0,0598218073822656;5,98
2018;"1438";"Män";0;9;1122;1131;0,00795755968169761;0,8
2018;"1438";"Kvinnor";0;14;862;876;0,0159817351598174;1,6
2018;"1439";"Män";0;4;1132;1136;0,00352112676056338;0,35
2018;"1439";"Kvinnor";0;8;953;961;0,00832466181061394;0,83
2018;"1440";"Män";0;63;3372;3435;0,0183406113537118;1,83
2018;"1440";"Kvinnor";0;87;3555;3642;0,0238879736408567;2,39
2018;"1441";"Män";0;142;4223;4365;0,0325315005727377;3,25
2018;"1441";"Kvinnor";0;196;4993;5189;0,0377722104451725;3,78
2018;"1442";"Män";0;25;2807;2832;0,00882768361581921;0,88
2018;"1442";"Kvinnor";0;21;1831;1852;0,0113390928725702;1,13
2018;"1443";"Män";0;61;1260;1321;0,0461771385314156;4,62
2018;"1443";"Kvinnor";0;57;1104;1161;0,0490956072351421;4,91
2018;"1444";"Män";0;8;723;731;0,0109439124487004;1,09
2018;"1444";"Kvinnor";0;23;782;805;0,0285714285714286;2,86
2018;"1445";"Män";0;30;1108;1138;0,0263620386643234;2,64
2018;"1445";"Kvinnor";0;37;860;897;0,0412486064659978;4,12
2018;"1446";"Män";0;27;1616;1643;0,0164333536214242;1,64
2018;"1446";"Kvinnor";0;21;1157;1178;0,0178268251273345;1,78
2018;"1447";"Män";0;6;979;985;0,00609137055837563;0,61
2018;"1447";"Kvinnor";0;11;767;778;0,0141388174807198;1,41
2018;"1452";"Män";0;64;3349;3413;0,0187518312335189;1,88
2018;"1452";"Kvinnor";0;91;2183;2274;0,0400175901495163;4
2018;"1460";"Män";0;46;2009;2055;0,0223844282238443;2,24
2018;"1460";"Kvinnor";0;70;1770;1840;0,0380434782608696;3,8
2018;"1461";"Män";0;19;1562;1581;0,0120177103099304;1,2
2018;"1461";"Kvinnor";0;64;1347;1411;0,0453579021970234;4,54
2018;"1462";"Män";0;22;1900;1922;0,0114464099895942;1,14
2018;"1462";"Kvinnor";0;22;1866;1888;0,0116525423728814;1,17
2018;"1463";"Män";0;183;5259;5442;0,0336273428886439;3,36
2018;"1463";"Kvinnor";0;203;4975;5178;0,0392043259945925;3,92
2018;"1465";"Män";0;224;1600;1824;0,12280701754386;12,28
2018;"1465";"Kvinnor";0;172;1541;1713;0,100408639813193;10,04
2018;"1466";"Män";0;11;2000;2011;0,00546991546494281;0,55
2018;"1466";"Kvinnor";0;15;1476;1491;0,0100603621730382;1,01
2018;"1470";"Män";0;59;4394;4453;0,0132494947226589;1,32
2018;"1470";"Kvinnor";0;68;2855;2923;0,0232637700992131;2,33
2018;"1471";"Män";0;27;3462;3489;0,00773860705073087;0,77
2018;"1471";"Kvinnor";0;28;2346;2374;0,0117944397641112;1,18
2018;"1472";"Män";0;25;1736;1761;0,0141964792731403;1,42
2018;"1472";"Kvinnor";0;21;1643;1664;0,0126201923076923;1,26
2018;"1473";"Män";0;9;1687;1696;0,00530660377358491;0,53
2018;"1473";"Kvinnor";0;23;1464;1487;0,01546738399462;1,55
2018;"1480";"Män";0;7176;179295;186471;0,038483195778432;3,85
2018;"1480";"Kvinnor";0;9646;153987;163633;0,0589489895070065;5,89
2018;"1481";"Män";0;733;21252;21985;0,0333409142597225;3,33
2018;"1481";"Kvinnor";0;974;17598;18572;0,0524445401679948;5,24
2018;"1482";"Män";0;250;8224;8474;0,0295020061364173;2,95
2018;"1482";"Kvinnor";0;221;8205;8426;0,0262283408497508;2,62
2018;"1484";"Män";0;40;3124;3164;0,0126422250316056;1,26
2018;"1484";"Kvinnor";0;63;2635;2698;0,0233506300963677;2,34
2018;"1485";"Män";0;299;11806;12105;0,024700536968195;2,47
2018;"1485";"Kvinnor";0;532;11352;11884;0,0447660720296197;4,48
2018;"1486";"Män";0;65;2872;2937;0,0221314266258086;2,21
2018;"1486";"Kvinnor";0;249;2762;3011;0,0826967784789107;8,27
2018;"1487";"Män";0;174;6286;6460;0,0269349845201238;2,69
2018;"1487";"Kvinnor";0;203;6471;6674;0,0304165418040156;3,04
2018;"1488";"Män";0;254;13673;13927;0,0182379550513391;1,82
2018;"1488";"Kvinnor";0;434;13180;13614;0,0318789481416189;3,19
2018;"1489";"Män";0;198;6472;6670;0,0296851574212894;2,97
2018;"1489";"Kvinnor";0;279;7401;7680;0,036328125;3,63
2018;"1490";"Män";0;2017;25813;27830;0,0724757455982752;7,25
2018;"1490";"Kvinnor";0;2721;23930;26651;0,102097482270834;10,21
2018;"1491";"Män";0;250;4736;4986;0,0501403931006819;5,01
2018;"1491";"Kvinnor";0;361;3746;4107;0,0878987095203311;8,79
2018;"1492";"Män";0;32;2198;2230;0,0143497757847534;1,43
2018;"1492";"Kvinnor";0;57;1971;2028;0,0281065088757396;2,81
2018;"1493";"Män";0;91;4496;4587;0,0198386745149335;1,98
2018;"1493";"Kvinnor";0;115;4050;4165;0,0276110444177671;2,76
2018;"1494";"Män";0;187;8697;8884;0,0210490769923458;2,1
2018;"1494";"Kvinnor";0;276;7911;8187;0,0337119824111396;3,37
2018;"1495";"Män";0;95;4236;4331;0,0219348880166243;2,19
2018;"1495";"Kvinnor";0;109;3694;3803;0,0286615829608204;2,87
2018;"1496";"Män";0;375;17644;18019;0,020811365780565;2,08
2018;"1496";"Kvinnor";0;407;14994;15401;0,0264268553990001;2,64
2018;"1497";"Män";0;17;1314;1331;0,0127723516153268;1,28
2018;"1497";"Kvinnor";0;23;1343;1366;0,0168374816983895;1,68
2018;"1498";"Män";0;41;2391;2432;0,0168585526315789;1,69
2018;"1498";"Kvinnor";0;55;1969;2024;0,0271739130434783;2,72
2018;"1499";"Män";0;209;6312;6521;0,0320502990338905;3,21
2018;"1499";"Kvinnor";0;258;5428;5686;0,0453746042912416;4,54
2018;"1715";"Män";0;39;1749;1788;0,0218120805369128;2,18
2018;"1715";"Kvinnor";0;36;1406;1442;0,0249653259361997;2,5
2018;"1730";"Män";0;13;1661;1674;0,00776583034647551;0,78
2018;"1730";"Kvinnor";0;127;1767;1894;0,0670538542766631;6,71
2018;"1737";"Män";0;24;2424;2448;0,00980392156862745;0,98
2018;"1737";"Kvinnor";0;39;2397;2436;0,0160098522167488;1,6
2018;"1760";"Män";0;3;533;536;0,00559701492537313;0,56
2018;"1760";"Kvinnor";0;2;453;455;0,0043956043956044;0,44
2018;"1761";"Män";0;31;1937;1968;0,0157520325203252;1,58
2018;"1761";"Kvinnor";0;44;1898;1942;0,0226570545829042;2,27
2018;"1762";"Män";0;13;842;855;0,0152046783625731;1,52
2018;"1762";"Kvinnor";0;16;667;683;0,0234260614934114;2,34
2018;"1763";"Män";0;13;1046;1059;0,012275731822474;1,23
2018;"1763";"Kvinnor";0;23;1380;1403;0,0163934426229508;1,64
2018;"1764";"Män";0;10;1880;1890;0,00529100529100529;0,53
2018;"1764";"Kvinnor";0;13;1327;1340;0,00970149253731343;0,97
2018;"1765";"Män";0;19;1787;1806;0,0105204872646733;1,05
2018;"1765";"Kvinnor";0;80;1740;1820;0,043956043956044;4,4
2018;"1766";"Män";0;149;2467;2616;0,0569571865443425;5,7
2018;"1766";"Kvinnor";0;128;2169;2297;0,0557248585111014;5,57
2018;"1780";"Män";0;734;25640;26374;0,0278304390687799;2,78
2018;"1780";"Kvinnor";0;1073;23313;24386;0,0440006561141639;4,4
2018;"1781";"Män";0;57;4165;4222;0,0135007105637139;1,35
2018;"1781";"Kvinnor";0;106;3454;3560;0,0297752808988764;2,98
2018;"1782";"Män";0;16;1728;1744;0,00917431192660551;0,92
2018;"1782";"Kvinnor";0;37;1579;1616;0,0228960396039604;2,29
2018;"1783";"Män";0;20;2425;2445;0,0081799591002045;0,82
2018;"1783";"Kvinnor";0;40;1818;1858;0,0215285252960172;2,15
2018;"1784";"Män";0;69;5255;5324;0,0129601803155522;1,3
2018;"1784";"Kvinnor";0;117;4619;4736;0,0247043918918919;2,47
2018;"1785";"Män";0;27;3019;3046;0,00886408404464872;0,89
2018;"1785";"Kvinnor";0;53;2608;2661;0,0199173243141676;1,99
2018;"1814";"Män";0;11;1010;1021;0,0107737512242899;1,08
2018;"1814";"Kvinnor";0;10;973;983;0,0101729399796541;1,02
2018;"1860";"Män";0;8;1249;1257;0,00636435958631663;0,64
2018;"1860";"Kvinnor";0;14;867;881;0,0158910329171396;1,59
2018;"1861";"Män";0;41;4194;4235;0,00968122786304604;0,97
2018;"1861";"Kvinnor";0;59;3152;3211;0,0183743382123949;1,84
2018;"1862";"Män";0;5;1383;1388;0,00360230547550432;0,36
2018;"1862";"Kvinnor";0;15;1173;1188;0,0126262626262626;1,26
2018;"1863";"Män";0;14;1353;1367;0,0102414045354792;1,02
2018;"1863";"Kvinnor";0;24;1140;1164;0,0206185567010309;2,06
2018;"1864";"Män";0;11;829;840;0,0130952380952381;1,31
2018;"1864";"Kvinnor";0;16;748;764;0,0209424083769634;2,09
2018;"1880";"Män";0;1206;38026;39232;0,0307402120717781;3,07
2018;"1880";"Kvinnor";0;1480;35643;37123;0,0398674676076826;3,99
2018;"1881";"Män";0;97;3510;3607;0,0268921541447186;2,69
2018;"1881";"Kvinnor";0;90;3373;3463;0,0259890268553278;2,6
2018;"1882";"Män";0;25;2238;2263;0,0110472823685373;1,1
2018;"1882";"Kvinnor";0;42;1660;1702;0,0246768507638073;2,47
2018;"1883";"Män";0;115;7280;7395;0,0155510480054091;1,56
2018;"1883";"Kvinnor";0;154;6223;6377;0,0241492864983535;2,41
2018;"1884";"Män";0;25;1476;1501;0,016655562958028;1,67
2018;"1884";"Kvinnor";0;51;1487;1538;0,0331599479843953;3,32
2018;"1885";"Män";0;72;5078;5150;0,0139805825242718;1,4
2018;"1885";"Kvinnor";0;68;4629;4697;0,0144773259527358;1,45
2018;"1904";"Män";0;9;840;849;0,0106007067137809;1,06
2018;"1904";"Kvinnor";0;9;604;613;0,0146818923327896;1,47
2018;"1907";"Män";0;7;1304;1311;0,0053394355453852;0,53
2018;"1907";"Kvinnor";0;15;1181;1196;0,0125418060200669;1,25
2018;"1960";"Män";0;22;1268;1290;0,0170542635658915;1,71
2018;"1960";"Kvinnor";0;12;1066;1078;0,0111317254174397;1,11
2018;"1961";"Män";0;18;2457;2475;0,00727272727272727;0,73
2018;"1961";"Kvinnor";0;13;2429;2442;0,00532350532350532;0,53
2018;"1962";"Män";0;13;939;952;0,0136554621848739;1,37
2018;"1962";"Kvinnor";0;15;797;812;0,0184729064039409;1,85
2018;"1980";"Män";0;1007;35990;36997;0,0272184231153877;2,72
2018;"1980";"Kvinnor";0;1324;32344;33668;0,0393251752405845;3,93
2018;"1981";"Män";0;87;3635;3722;0,023374529822676;2,34
2018;"1981";"Kvinnor";0;143;3467;3610;0,039612188365651;3,96
2018;"1982";"Män";0;27;3459;3486;0,00774526678141136;0,77
2018;"1982";"Kvinnor";0;44;2788;2832;0,0155367231638418;1,55
2018;"1983";"Män";0;73;6142;6215;0,0117457763475463;1,17
2018;"1983";"Kvinnor";0;91;5099;5190;0,0175337186897881;1,75
2018;"1984";"Män";0;21;2801;2822;0,00744153082919915;0,74
2018;"1984";"Kvinnor";0;33;2235;2268;0,0145502645502645;1,46
2018;"2021";"Män";0;14;1361;1375;0,0101818181818182;1,02
2018;"2021";"Kvinnor";0;19;1135;1154;0,0164644714038128;1,65
2018;"2023";"Män";0;51;2825;2876;0,0177329624478442;1,77
2018;"2023";"Kvinnor";0;53;2480;2533;0,0209238057639163;2,09
2018;"2026";"Män";0;18;1224;1242;0,0144927536231884;1,45
2018;"2026";"Kvinnor";0;10;1275;1285;0,00778210116731518;0,78
2018;"2029";"Män";0;177;3221;3398;0,0520894643908181;5,21
2018;"2029";"Kvinnor";0;161;2829;2990;0,0538461538461538;5,38
2018;"2031";"Män";0;53;1670;1723;0,0307603017991875;3,08
2018;"2031";"Kvinnor";0;69;1611;1680;0,0410714285714286;4,11
2018;"2034";"Män";0;32;1152;1184;0,027027027027027;2,7
2018;"2034";"Kvinnor";0;21;927;948;0,0221518987341772;2,22
2018;"2039";"Män";0;8;1506;1514;0,00528401585204756;0,53
2018;"2039";"Kvinnor";0;17;1258;1275;0,0133333333333333;1,33
2018;"2061";"Män";0;14;1654;1668;0,00839328537170264;0,84
2018;"2061";"Kvinnor";0;16;1243;1259;0,0127084988085782;1,27
2018;"2062";"Män";0;79;5122;5201;0,0151893866564122;1,52
2018;"2062";"Kvinnor";0;148;4702;4850;0,0305154639175258;3,05
2018;"2080";"Män";0;583;11833;12416;0,0469555412371134;4,7
2018;"2080";"Kvinnor";0;565;13264;13829;0,040856171812857;4,09
2018;"2081";"Män";0;152;14515;14667;0,0103634008317993;1,04
2018;"2081";"Kvinnor";0;351;10927;11278;0,0311225394573506;3,11
2018;"2082";"Män";0;21;1411;1432;0,0146648044692737;1,47
2018;"2082";"Kvinnor";0;35;1512;1547;0,0226244343891403;2,26
2018;"2083";"Män";0;36;3271;3307;0,0108859993952223;1,09
2018;"2083";"Kvinnor";0;67;2701;2768;0,0242052023121387;2,42
2018;"2084";"Män";0;70;5404;5474;0,0127877237851662;1,28
2018;"2084";"Kvinnor";0;151;4171;4322;0,0349375289217955;3,49
2018;"2085";"Män";0;76;6622;6698;0,0113466706479546;1,13
2018;"2085";"Kvinnor";0;87;5113;5200;0,0167307692307692;1,67
2018;"2101";"Män";0;12;859;871;0,0137772675086108;1,38
2018;"2101";"Kvinnor";0;9;788;797;0,0112923462986198;1,13
2018;"2104";"Män";0;12;1963;1975;0,00607594936708861;0,61
2018;"2104";"Kvinnor";0;19;1458;1477;0,012863913337847;1,29
2018;"2121";"Män";0;21;2981;3002;0,00699533644237175;0,7
2018;"2121";"Kvinnor";0;40;2003;2043;0,0195790504160548;1,96
2018;"2132";"Män";0;14;1439;1453;0,00963523743977977;0,96
2018;"2132";"Kvinnor";0;17;1145;1162;0,0146299483648881;1,46
2018;"2161";"Män";0;107;3571;3678;0,0290918977705275;2,91
2018;"2161";"Kvinnor";0;163;3187;3350;0,0486567164179104;4,87
2018;"2180";"Män";0;654;22796;23450;0,0278891257995736;2,79
2018;"2180";"Kvinnor";0;935;21665;22600;0,0413716814159292;4,14
2018;"2181";"Män";0;64;9433;9497;0,00673897020111614;0,67
2018;"2181";"Kvinnor";0;97;7157;7254;0,0133719327267714;1,34
2018;"2182";"Män";0;97;4953;5050;0,0192079207920792;1,92
2018;"2182";"Kvinnor";0;151;3946;4097;0,0368562362704418;3,69
2018;"2183";"Män";0;122;5070;5192;0,023497688751926;2,35
2018;"2183";"Kvinnor";0;143;5051;5194;0,0275317674239507;2,75
2018;"2184";"Män";0;159;8138;8297;0,0191635530914788;1,92
2018;"2184";"Kvinnor";0;209;7398;7607;0,0274746943604575;2,75
2018;"2260";"Män";0;49;1928;1977;0,0247850278199292;2,48
2018;"2260";"Kvinnor";0;59;1496;1555;0,0379421221864952;3,79
2018;"2262";"Män";0;26;3217;3243;0,0080172679617638;0,8
2018;"2262";"Kvinnor";0;22;2110;2132;0,0103189493433396;1,03
2018;"2280";"Män";0;173;4319;4492;0,0385129118432769;3,85
2018;"2280";"Kvinnor";0;208;4413;4621;0,0450119021856741;4,5
2018;"2281";"Män";0;534;24722;25256;0,0211434906556858;2,11
2018;"2281";"Kvinnor";0;824;22536;23360;0,0352739726027397;3,53
2018;"2282";"Män";0;34;3913;3947;0,00861413731948315;0,86
2018;"2282";"Kvinnor";0;44;3206;3250;0,0135384615384615;1,35
2018;"2283";"Män";0;74;3675;3749;0,0197385969591891;1,97
2018;"2283";"Kvinnor";0;83;3374;3457;0,0240092565808504;2,4
2018;"2284";"Män";0;234;12605;12839;0,018225718513903;1,82
2018;"2284";"Kvinnor";0;341;10776;11117;0,0306737429162544;3,07
2018;"2303";"Män";0;8;1116;1124;0,00711743772241993;0,71
2018;"2303";"Kvinnor";0;10;875;885;0,0112994350282486;1,13
2018;"2305";"Män";0;25;1072;1097;0,0227894257064722;2,28
2018;"2305";"Kvinnor";0;19;885;904;0,0210176991150442;2,1
2018;"2309";"Män";0;17;2233;2250;0,00755555555555556;0,76
2018;"2309";"Kvinnor";0;17;1863;1880;0,00904255319148936;0,9
2018;"2313";"Män";0;16;2435;2451;0,00652794777641779;0,65
2018;"2313";"Kvinnor";0;25;2052;2077;0,0120365912373616;1,2
2018;"2321";"Män";0;84;2790;2874;0,0292275574112735;2,92
2018;"2321";"Kvinnor";0;104;2378;2482;0,0419016921837228;4,19
2018;"2326";"Män";0;16;1246;1262;0,0126782884310618;1,27
2018;"2326";"Kvinnor";0;12;1087;1099;0,010919017288444;1,09
2018;"2361";"Män";0;13;2424;2437;0,00533442757488716;0,53
2018;"2361";"Kvinnor";0;22;2183;2205;0,00997732426303855;1
2018;"2380";"Män";0;579;15967;16546;0,0349933518675209;3,5
2018;"2380";"Kvinnor";0;669;15773;16442;0,040688480720107;4,07
2018;"2401";"Män";0;27;1021;1048;0,025763358778626;2,58
2018;"2401";"Kvinnor";0;22;954;976;0,0225409836065574;2,25
2018;"2403";"Män";0;3;313;316;0,00949367088607595;0,95
2018;"2403";"Kvinnor";0;6;355;361;0,0166204986149584;1,66
2018;"2404";"Män";0;13;1203;1216;0,0106907894736842;1,07
2018;"2404";"Kvinnor";0;12;881;893;0,013437849944009;1,34
2018;"2409";"Män";0;10;969;979;0,0102145045965271;1,02
2018;"2409";"Kvinnor";0;4;955;959;0,00417101147028154;0,42
2018;"2417";"Män";0;14;729;743;0,018842530282638;1,88
2018;"2417";"Kvinnor";0;23;696;719;0,0319888734353268;3,2
2018;"2418";"Män";0;5;714;719;0,00695410292072323;0,7
2018;"2418";"Kvinnor";0;12;582;594;0,0202020202020202;2,02
2018;"2421";"Män";0;8;1305;1313;0,00609291698400609;0,61
2018;"2421";"Kvinnor";0;23;1125;1148;0,0200348432055749;2
2018;"2422";"Män";0;2;457;459;0,00435729847494553;0,44
2018;"2422";"Kvinnor";0;5;407;412;0,0121359223300971;1,21
2018;"2425";"Män";0;2;508;510;0,00392156862745098;0,39
2018;"2425";"Kvinnor";0;7;450;457;0,0153172866520788;1,53
2018;"2460";"Män";0;9;1243;1252;0,00718849840255591;0,72
2018;"2460";"Kvinnor";0;16;1118;1134;0,0141093474426808;1,41
2018;"2462";"Män";0;30;1077;1107;0,02710027100271;2,71
2018;"2462";"Kvinnor";0;24;1181;1205;0,0199170124481328;1,99
2018;"2463";"Män";0;2;486;488;0,00409836065573771;0,41
2018;"2463";"Kvinnor";0;9;423;432;0,0208333333333333;2,08
2018;"2480";"Män";0;870;32233;33103;0,0262816058967465;2,63
2018;"2480";"Kvinnor";0;1184;29371;30555;0,0387497954508264;3,87
2018;"2481";"Män";0;37;2866;2903;0,0127454357561144;1,27
2018;"2481";"Kvinnor";0;55;2604;2659;0,0206844678450545;2,07
2018;"2482";"Män";0;338;17158;17496;0,0193187014174668;1,93
2018;"2482";"Kvinnor";0;425;13976;14401;0,0295118394555934;2,95
2018;"2505";"Män";0;12;1322;1334;0,00899550224887556;0,9
2018;"2505";"Kvinnor";0;28;1235;1263;0,0221694378463975;2,22
2018;"2506";"Män";0;2;828;830;0,00240963855421687;0,24
2018;"2506";"Kvinnor";0;20;579;599;0,0333889816360601;3,34
2018;"2510";"Män";0;27;1013;1040;0,0259615384615385;2,6
2018;"2510";"Kvinnor";0;43;897;940;0,0457446808510638;4,57
2018;"2513";"Män";0;6;644;650;0,00923076923076923;0,92
2018;"2513";"Kvinnor";0;13;596;609;0,0213464696223317;2,13
2018;"2514";"Män";0;46;3263;3309;0,0139014808099124;1,39
2018;"2514";"Kvinnor";0;87;2952;3039;0,0286278381046397;2,86
2018;"2518";"Män";0;16;753;769;0,0208062418725618;2,08
2018;"2518";"Kvinnor";0;17;629;646;0,0263157894736842;2,63
2018;"2521";"Män";0;36;1008;1044;0,0344827586206897;3,45
2018;"2521";"Kvinnor";0;19;909;928;0,0204741379310345;2,05
2018;"2523";"Män";0;49;5027;5076;0,00965327029156816;0,97
2018;"2523";"Kvinnor";0;59;3850;3909;0,0150933742645178;1,51
2018;"2560";"Män";0;4;1399;1403;0,00285103349964362;0,29
2018;"2560";"Kvinnor";0;23;1376;1399;0,0164403145103645;1,64
2018;"2580";"Män";0;599;21324;21923;0,0273229028873786;2,73
2018;"2580";"Kvinnor";0;845;18447;19292;0,043800539083558;4,38
2018;"2581";"Män";0;163;8791;8954;0,0182041545677909;1,82
2018;"2581";"Kvinnor";0;263;7509;7772;0,0338394235717962;3,38
2018;"2582";"Män";0;47;5277;5324;0,00882794891059354;0,88
2018;"2582";"Kvinnor";0;87;4626;4713;0,0184595798854233;1,85
2018;"2583";"Män";0;28;1473;1501;0,0186542305129913;1,87
2018;"2583";"Kvinnor";0;35;1570;1605;0,0218068535825545;2,18
2018;"2584";"Män";0;148;6868;7016;0,0210946408209806;2,11
2018;"2584";"Kvinnor";0;271;5287;5558;0,0487585462396546;4,88
2018;"9999";"Män";0;1511;171009;172520;0,00875840482262926;0,88
2018;"9999";"Kvinnor";0;1972;175662;177634;0,0111014783205918;1,11
2019;"0114";"Män";0;167;7216;7383;0,0226195313558174;2,26
2019;"0114";"Kvinnor";0;223;6302;6525;0,034176245210728;3,42
2019;"0115";"Män";0;82;4276;4358;0,0188159706287288;1,88
2019;"0115";"Kvinnor";0;108;3898;4006;0,0269595606590115;2,7
2019;"0117";"Män";0;142;4980;5122;0,027723545490043;2,77
2019;"0117";"Kvinnor";0;201;5142;5343;0,0376193149915778;3,76
2019;"0120";"Män";0;232;5506;5738;0,0404322063436738;4,04
2019;"0120";"Kvinnor";0;261;5421;5682;0,045934530095037;4,59
2019;"0123";"Män";0;411;14307;14718;0,0279249898083979;2,79
2019;"0123";"Kvinnor";0;596;9967;10563;0,056423364574458;5,64
2019;"0125";"Män";0;111;3779;3890;0,02853470437018;2,85
2019;"0125";"Kvinnor";0;151;3720;3871;0,0390080082665978;3,9
2019;"0126";"Män";0;450;22364;22814;0,0197247304286841;1,97
2019;"0126";"Kvinnor";0;565;22698;23263;0,0242874951639943;2,43
2019;"0127";"Män";0;546;12614;13160;0,0414893617021277;4,15
2019;"0127";"Kvinnor";0;581;9874;10455;0,0555714968914395;5,56
2019;"0128";"Män";0;44;1178;1222;0,0360065466448445;3,6
2019;"0128";"Kvinnor";0;47;1472;1519;0,0309414088215932;3,09
2019;"0136";"Män";0;286;15389;15675;0,0182456140350877;1,82
2019;"0136";"Kvinnor";0;359;11718;12077;0,0297259253125776;2,97
2019;"0138";"Män";0;178;5203;5381;0,0330793532800595;3,31
2019;"0138";"Kvinnor";0;268;4904;5172;0,0518174787316319;5,18
2019;"0139";"Män";0;58;5410;5468;0,0106071689831748;1,06
2019;"0139";"Kvinnor";0;43;3734;3777;0,0113846968493513;1,14
2019;"0140";"Män";0;22;1493;1515;0,0145214521452145;1,45
2019;"0140";"Kvinnor";0;24;1191;1215;0,0197530864197531;1,98
2019;"0160";"Män";0;485;12069;12554;0,0386331049864585;3,86
2019;"0160";"Kvinnor";0;746;11104;11850;0,0629535864978903;6,3
2019;"0162";"Män";0;194;7720;7914;0,0245135203436947;2,45
2019;"0162";"Kvinnor";0;288;11369;11657;0,0247061851248177;2,47
2019;"0163";"Män";0;347;12686;13033;0,0266247218598941;2,66
2019;"0163";"Kvinnor";0;423;11608;12031;0,0351591721386418;3,52
2019;"0180";"Män";0;32021;323253;355274;0,0901304345378497;9,01
2019;"0180";"Kvinnor";0;38636;297217;335853;0,115038424548835;11,5
2019;"0181";"Män";0;483;28523;29006;0,0166517272288492;1,67
2019;"0181";"Kvinnor";0;573;21139;21712;0,0263909358879882;2,64
2019;"0182";"Män";0;910;16066;16976;0,0536050895381715;5,36
2019;"0182";"Kvinnor";0;1094;15721;16815;0,0650609574784419;6,51
2019;"0183";"Män";0;292;11000;11292;0,0258590152320227;2,59
2019;"0183";"Kvinnor";0;256;10831;11087;0,0230901055289979;2,31
2019;"0184";"Män";0;1073;48161;49234;0,0217938822764756;2,18
2019;"0184";"Kvinnor";0;1487;48007;49494;0,0300440457429183;3
2019;"0186";"Män";0;335;4964;5299;0,0632194753727118;6,32
2019;"0186";"Kvinnor";0;373;5775;6148;0,0606701366297983;6,07
2019;"0187";"Män";0;58;1231;1289;0,0449961210240497;4,5
2019;"0187";"Kvinnor";0;72;1322;1394;0,0516499282639885;5,16
2019;"0188";"Män";0;199;10535;10734;0,0185392211663872;1,85
2019;"0188";"Kvinnor";0;299;10777;11076;0,0269953051643192;2,7
2019;"0191";"Män";0;160;17383;17543;0,00912044690189819;0,91
2019;"0191";"Kvinnor";0;313;11880;12193;0,025670466661199;2,57
2019;"0192";"Män";0;75;3244;3319;0,022597167821633;2,26
2019;"0192";"Kvinnor";0;117;3503;3620;0,0323204419889503;3,23
2019;"0305";"Män";0;71;2708;2779;0,0255487585462397;2,55
2019;"0305";"Kvinnor";0;103;2546;2649;0,038882597206493;3,89
2019;"0319";"Män";0;15;1302;1317;0,0113895216400911;1,14
2019;"0319";"Kvinnor";0;21;1102;1123;0,018699910952805;1,87
2019;"0330";"Män";0;50;1837;1887;0,0264970853206147;2,65
2019;"0330";"Kvinnor";0;50;1991;2041;0,0244977951984321;2,45
2019;"0331";"Män";0;359;1979;2338;0,1535500427716;15,36
2019;"0331";"Kvinnor";0;253;1883;2136;0,118445692883895;11,84
2019;"0360";"Män";0;51;3573;3624;0,0140728476821192;1,41
2019;"0360";"Kvinnor";0;57;2921;2978;0,019140362659503;1,91
2019;"0380";"Män";0;1834;48620;50454;0,0363499425219011;3,63
2019;"0380";"Kvinnor";0;2345;51296;53641;0,043716560093958;4,37
2019;"0381";"Män";0;144;8776;8920;0,0161434977578475;1,61
2019;"0381";"Kvinnor";0;195;7688;7883;0,0247367753393378;2,47
2019;"0382";"Män";0;28;5129;5157;0,00542951328291642;0,54
2019;"0382";"Kvinnor";0;61;3877;3938;0,0154900964956831;1,55
2019;"0428";"Män";0;73;1355;1428;0,0511204481792717;5,11
2019;"0428";"Kvinnor";0;121;1212;1333;0,0907726931732933;9,08
2019;"0461";"Män";0;41;1158;1199;0,0341951626355296;3,42
2019;"0461";"Kvinnor";0;53;1362;1415;0,0374558303886926;3,75
2019;"0480";"Män";0;260;10576;10836;0,0239940937615356;2,4
2019;"0480";"Kvinnor";0;389;11329;11718;0,0331967912613074;3,32
2019;"0481";"Män";0;20;3093;3113;0,0064246707356248;0,64
2019;"0481";"Kvinnor";0;31;1866;1897;0,0163415919873484;1,63
2019;"0482";"Män";0;24;2696;2720;0,00882352941176471;0,88
2019;"0482";"Kvinnor";0;55;2277;2332;0,0235849056603774;2,36
2019;"0483";"Män";0;178;6952;7130;0,0249649368863955;2,5
2019;"0483";"Kvinnor";0;167;6407;6574;0,0254031031335564;2,54
2019;"0484";"Män";0;652;21231;21883;0,0297948178951698;2,98
2019;"0484";"Kvinnor";0;981;20188;21169;0,0463413481978365;4,63
2019;"0486";"Män";0;161;5514;5675;0,0283700440528634;2,84
2019;"0486";"Kvinnor";0;223;5125;5348;0,0416978309648467;4,17
2019;"0488";"Män";0;52;1786;1838;0,0282916213275299;2,83
2019;"0488";"Kvinnor";0;88;1886;1974;0,0445795339412361;4,46
2019;"0509";"Män";0;37;775;812;0,0455665024630542;4,56
2019;"0509";"Kvinnor";0;27;692;719;0,0375521557719054;3,76
2019;"0512";"Män";0;13;574;587;0,0221465076660988;2,21
2019;"0512";"Kvinnor";0;14;418;432;0,0324074074074074;3,24
2019;"0513";"Män";0;31;1651;1682;0,0184304399524376;1,84
2019;"0513";"Kvinnor";0;26;1511;1537;0,0169160702667534;1,69
2019;"0560";"Män";0;9;967;976;0,00922131147540984;0,92
2019;"0560";"Kvinnor";0;9;605;614;0,0146579804560261;1,47
2019;"0561";"Män";0;39;1598;1637;0,0238240684178375;2,38
2019;"0561";"Kvinnor";0;41;1317;1358;0,0301914580265096;3,02
2019;"0562";"Män";0;32;5210;5242;0,00610454025181229;0,61
2019;"0562";"Kvinnor";0;46;3572;3618;0,0127142067440575;1,27
2019;"0563";"Män";0;28;1301;1329;0,0210684725357412;2,11
2019;"0563";"Kvinnor";0;37;1018;1055;0,0350710900473934;3,51
2019;"0580";"Män";0;998;43807;44805;0,0222742997433322;2,23
2019;"0580";"Kvinnor";0;1252;39423;40675;0,030780577750461;3,08
2019;"0581";"Män";0;885;32789;33674;0,0262814040506028;2,63
2019;"0581";"Kvinnor";0;1193;30051;31244;0,0381833311995903;3,82
2019;"0582";"Män";0;49;1889;1938;0,0252837977296182;2,53
2019;"0582";"Kvinnor";0;47;1820;1867;0,0251740760578468;2,52
2019;"0583";"Män";0;129;6865;6994;0,0184443808979125;1,84
2019;"0583";"Kvinnor";0;172;7168;7340;0,023433242506812;2,34
2019;"0584";"Män";0;40;1490;1530;0,0261437908496732;2,61
2019;"0584";"Kvinnor";0;44;1334;1378;0,0319303338171263;3,19
2019;"0586";"Män";0;46;7232;7278;0,00632041769716955;0,63
2019;"0586";"Kvinnor";0;117;4527;4644;0,0251937984496124;2,52
2019;"0604";"Män";0;10;1222;1232;0,00811688311688312;0,81
2019;"0604";"Kvinnor";0;15;1054;1069;0,0140318054256314;1,4
2019;"0617";"Män";0;46;3634;3680;0,0125;1,25
2019;"0617";"Kvinnor";0;52;2494;2546;0,0204241948153967;2,04
2019;"0642";"Män";0;11;1285;1296;0,00848765432098765;0,85
2019;"0642";"Kvinnor";0;49;1256;1305;0,0375478927203065;3,75
2019;"0643";"Män";0;24;1819;1843;0,0130222463374932;1,3
2019;"0643";"Kvinnor";0;38;1627;1665;0,0228228228228228;2,28
2019;"0662";"Män";0;80;7929;8009;0,00998876264202772;1
2019;"0662";"Kvinnor";0;132;5876;6008;0,0219707057256991;2,2
2019;"0665";"Män";0;40;3098;3138;0,0127469725940089;1,27
2019;"0665";"Kvinnor";0;54;2202;2256;0,023936170212766;2,39
2019;"0680";"Män";0;1168;37265;38433;0,0303905497879427;3,04
2019;"0680";"Kvinnor";0;1351;32614;33965;0,0397762402473134;3,98
2019;"0682";"Män";0;96;6709;6805;0,0141072740631888;1,41
2019;"0682";"Kvinnor";0;106;5348;5454;0,0194352768610194;1,94
2019;"0683";"Män";0;131;8758;8889;0,0147373157835527;1,47
2019;"0683";"Kvinnor";0;229;7907;8136;0,0281465093411996;2,81
2019;"0684";"Män";0;20;2437;2457;0,00814000814000814;0,81
2019;"0684";"Kvinnor";0;58;1853;1911;0,0303506017791732;3,04
2019;"0685";"Män";0;74;6618;6692;0,0110579796772265;1,11
2019;"0685";"Kvinnor";0;128;4880;5008;0,0255591054313099;2,56
2019;"0686";"Män";0;56;4574;4630;0,0120950323974082;1,21
2019;"0686";"Kvinnor";0;88;4516;4604;0,0191138140747176;1,91
2019;"0687";"Män";0;105;4352;4457;0,0235584473861342;2,36
2019;"0687";"Kvinnor";0;111;3615;3726;0,0297906602254428;2,98
2019;"0760";"Män";0;12;2798;2810;0,00427046263345196;0,43
2019;"0760";"Kvinnor";0;13;1781;1794;0,0072463768115942;0,72
2019;"0761";"Män";0;15;1134;1149;0,0130548302872063;1,31
2019;"0761";"Kvinnor";0;58;1105;1163;0,0498710232158212;4,99
2019;"0763";"Män";0;35;2916;2951;0,0118603863097255;1,19
2019;"0763";"Kvinnor";0;38;2409;2447;0,0155292194523907;1,55
2019;"0764";"Män";0;46;4084;4130;0,011138014527845;1,11
2019;"0764";"Kvinnor";0;52;3174;3226;0,0161190328580285;1,61
2019;"0765";"Män";0;1332;4324;5656;0,235502121640736;23,55
2019;"0765";"Kvinnor";0;1414;3825;5239;0,269898835655659;26,99
2019;"0767";"Män";0;48;3232;3280;0,0146341463414634;1,46
2019;"0767";"Kvinnor";0;45;1980;2025;0,0222222222222222;2,22
2019;"0780";"Män";0;805;23607;24412;0,0329755857774865;3,3
2019;"0780";"Kvinnor";0;950;21476;22426;0,0423615446356907;4,24
2019;"0781";"Män";0;282;6605;6887;0,0409467111950051;4,09
2019;"0781";"Kvinnor";0;202;5537;5739;0,0351977696462798;3,52
2019;"0821";"Män";0;7;726;733;0,00954979536152797;0,95
2019;"0821";"Kvinnor";0;7;827;834;0,00839328537170264;0,84
2019;"0834";"Män";0;8;1160;1168;0,00684931506849315;0,68
2019;"0834";"Kvinnor";0;16;946;962;0,0166320166320166;1,66
2019;"0840";"Män";0;34;2204;2238;0,0151921358355675;1,52
2019;"0840";"Kvinnor";0;87;2226;2313;0,0376134889753567;3,76
2019;"0860";"Män";0;22;2708;2730;0,00805860805860806;0,81
2019;"0860";"Kvinnor";0;21;2261;2282;0,00920245398773006;0,92
2019;"0861";"Män";0;27;2373;2400;0,01125;1,12
2019;"0861";"Kvinnor";0;44;1934;1978;0,0222446916076845;2,22
2019;"0862";"Män";0;28;2461;2489;0,0112494977902772;1,12
2019;"0862";"Kvinnor";0;38;1632;1670;0,0227544910179641;2,28
2019;"0880";"Män";0;650;16702;17352;0,0374596588289534;3,75
2019;"0880";"Kvinnor";0;824;15969;16793;0,0490680640743167;4,91
2019;"0881";"Män";0;42;4015;4057;0,0103524771999014;1,04
2019;"0881";"Kvinnor";0;58;3482;3540;0,0163841807909605;1,64
2019;"0882";"Män";0;74;7825;7899;0,00936827446512217;0,94
2019;"0882";"Kvinnor";0;122;5902;6024;0,0202523240371846;2,03
2019;"0883";"Män";0;114;7000;7114;0,0160247399493956;1,6
2019;"0883";"Kvinnor";0;191;6845;7036;0,0271461057418988;2,71
2019;"0884";"Män";0;313;3901;4214;0,0742762221167537;7,43
2019;"0884";"Kvinnor";0;330;3010;3340;0,0988023952095808;9,88
2019;"0885";"Män";0;58;1841;1899;0,0305423907319642;3,05
2019;"0885";"Kvinnor";0;82;1585;1667;0,0491901619676065;4,92
2019;"0980";"Män";0;390;12580;12970;0,0300693909020817;3,01
2019;"0980";"Kvinnor";0;530;12122;12652;0,0418906101802087;4,19
2019;"1060";"Män";0;22;4417;4439;0,00495607118720433;0,5
2019;"1060";"Kvinnor";0;45;2528;2573;0,0174893120870579;1,75
2019;"1080";"Män";0;418;15305;15723;0,026585257266425;2,66
2019;"1080";"Kvinnor";0;447;13490;13937;0,0320728994762144;3,21
2019;"1081";"Män";0;90;5465;5555;0,0162016201620162;1,62
2019;"1081";"Kvinnor";0;93;4332;4425;0,0210169491525424;2,1
2019;"1082";"Män";0;179;5976;6155;0,0290820471161657;2,91
2019;"1082";"Kvinnor";0;216;5938;6154;0,0350991225219369;3,51
2019;"1083";"Män";0;72;2999;3071;0,0234451318788668;2,34
2019;"1083";"Kvinnor";0;75;2486;2561;0,0292854353768059;2,93
2019;"1214";"Män";0;40;1763;1803;0,0221852468108708;2,22
2019;"1214";"Kvinnor";0;39;1830;1869;0,0208667736757624;2,09
2019;"1230";"Män";0;67;3618;3685;0,0181818181818182;1,82
2019;"1230";"Kvinnor";0;63;2814;2877;0,0218978102189781;2,19
2019;"1231";"Män";0;91;5049;5140;0,017704280155642;1,77
2019;"1231";"Kvinnor";0;183;3032;3215;0,0569206842923795;5,69
2019;"1233";"Män";0;136;3826;3962;0,0343260979303382;3,43
2019;"1233";"Kvinnor";0;179;4267;4446;0,0402609086819613;4,03
2019;"1256";"Män";0;47;2100;2147;0,0218910107126223;2,19
2019;"1256";"Kvinnor";0;50;1724;1774;0,028184892897407;2,82
2019;"1257";"Män";0;11;1775;1786;0,00615901455767077;0,62
2019;"1257";"Kvinnor";0;23;1513;1536;0,0149739583333333;1,5
2019;"1260";"Män";0;10;2264;2274;0,00439753737906772;0,44
2019;"1260";"Kvinnor";0;19;1829;1848;0,0102813852813853;1,03
2019;"1261";"Män";0;78;3623;3701;0,0210753850310727;2,11
2019;"1261";"Kvinnor";0;228;3627;3855;0,0591439688715953;5,91
2019;"1262";"Män";0;87;2475;2562;0,0339578454332553;3,4
2019;"1262";"Kvinnor";0;116;2989;3105;0,0373590982286634;3,74
2019;"1263";"Män";0;84;3593;3677;0,0228447103617079;2,28
2019;"1263";"Kvinnor";0;86;2923;3009;0,0285809238949817;2,86
2019;"1264";"Män";0;59;1970;2029;0,0290783637259734;2,91
2019;"1264";"Kvinnor";0;59;1903;1962;0,0300713557594292;3,01
2019;"1265";"Män";0;48;2836;2884;0,0166435506241331;1,66
2019;"1265";"Kvinnor";0;46;2674;2720;0,0169117647058824;1,69
2019;"1266";"Män";0;31;2338;2369;0,0130856901646264;1,31
2019;"1266";"Kvinnor";0;43;2225;2268;0,0189594356261023;1,9
2019;"1267";"Män";0;51;2004;2055;0,0248175182481752;2,48
2019;"1267";"Kvinnor";0;59;2489;2548;0,0231554160125589;2,32
2019;"1270";"Män";0;70;2342;2412;0,0290215588723051;2,9
2019;"1270";"Kvinnor";0;74;2054;2128;0,0347744360902256;3,48
2019;"1272";"Män";0;34;2297;2331;0,0145860145860146;1,46
2019;"1272";"Kvinnor";0;31;1809;1840;0,0168478260869565;1,68
2019;"1273";"Män";0;27;2134;2161;0,012494215640907;1,25
2019;"1273";"Kvinnor";0;44;1935;1979;0,022233451237999;2,22
2019;"1275";"Män";0;9;1789;1798;0,0050055617352614;0,5
2019;"1275";"Kvinnor";0;8;1203;1211;0,00660611065235343;0,66
2019;"1276";"Män";0;87;2820;2907;0,0299277605779154;2,99
2019;"1276";"Kvinnor";0;55;2342;2397;0,0229453483521068;2,29
2019;"1277";"Män";0;14;3108;3122;0,00448430493273543;0,45
2019;"1277";"Kvinnor";0;33;2723;2756;0,0119738751814224;1,2
2019;"1278";"Män";0;71;3173;3244;0,0218865598027127;2,19
2019;"1278";"Kvinnor";0;76;2694;2770;0,0274368231046931;2,74
2019;"1280";"Män";0;5332;88304;93636;0,0569439104617882;5,69
2019;"1280";"Kvinnor";0;5750;82174;87924;0,0653973886538374;6,54
2019;"1281";"Män";0;835;33902;34737;0,02403776952529;2,4
2019;"1281";"Kvinnor";0;1324;33899;35223;0,0375890753201033;3,76
2019;"1282";"Män";0;195;8012;8207;0,0237602047033021;2,38
2019;"1282";"Kvinnor";0;231;6639;6870;0,0336244541484716;3,36
2019;"1283";"Män";0;1394;35637;37031;0,037644135994167;3,76
2019;"1283";"Kvinnor";0;1801;31527;33328;0,0540386461833893;5,4
2019;"1284";"Män";0;134;3906;4040;0,0331683168316832;3,32
2019;"1284";"Kvinnor";0;193;3748;3941;0,0489723420451662;4,9
2019;"1285";"Män";0;140;5284;5424;0,025811209439528;2,58
2019;"1285";"Kvinnor";0;152;4887;5039;0,0301647152212741;3,02
2019;"1286";"Män";0;169;5770;5939;0,0284559690183533;2,85
2019;"1286";"Kvinnor";0;268;5962;6230;0,0430176565008026;4,3
2019;"1287";"Män";0;122;6063;6185;0,0197251414713015;1,97
2019;"1287";"Kvinnor";0;183;6250;6433;0,0284470697963625;2,84
2019;"1290";"Män";0;478;17891;18369;0,0260221024552235;2,6
2019;"1290";"Kvinnor";0;709;17420;18129;0,0391086105135418;3,91
2019;"1291";"Män";0;114;3274;3388;0,0336481700118064;3,36
2019;"1291";"Kvinnor";0;158;3238;3396;0,0465253239104829;4,65
2019;"1292";"Män";0;241;8262;8503;0,0283429377866635;2,83
2019;"1292";"Kvinnor";0;340;8618;8958;0,037954900647466;3,8
2019;"1293";"Män";0;215;10271;10486;0,0205035285142094;2,05
2019;"1293";"Kvinnor";0;246;8805;9051;0,0271793172025191;2,72
2019;"1315";"Män";0;34;2361;2395;0,01419624217119;1,42
2019;"1315";"Kvinnor";0;38;1869;1907;0,0199265862611432;1,99
2019;"1380";"Män";0;590;24207;24797;0,0237932007904182;2,38
2019;"1380";"Kvinnor";0;824;22445;23269;0,0354119214405432;3,54
2019;"1381";"Män";0;137;4070;4207;0,0325647729973853;3,26
2019;"1381";"Kvinnor";0;137;3749;3886;0,0352547606793618;3,53
2019;"1382";"Män";0;244;9921;10165;0,0240039350713232;2,4
2019;"1382";"Kvinnor";0;392;9299;9691;0,0404499019709008;4,04
2019;"1383";"Män";0;459;14371;14830;0,0309507754551585;3,1
2019;"1383";"Kvinnor";0;766;13495;14261;0,0537129233574083;5,37
2019;"1384";"Män";0;494;10841;11335;0,0435818262020291;4,36
2019;"1384";"Kvinnor";0;878;11652;12530;0,0700718276137271;7,01
2019;"1401";"Män";0;288;8353;8641;0,0333294757551209;3,33
2019;"1401";"Kvinnor";0;240;6712;6952;0,0345224395857307;3,45
2019;"1402";"Män";0;283;5834;6117;0,0462645087461174;4,63
2019;"1402";"Kvinnor";0;385;5190;5575;0,0690582959641256;6,91
2019;"1407";"Män";0;31;1623;1654;0,0187424425634825;1,87
2019;"1407";"Kvinnor";0;58;1556;1614;0,0359355638166047;3,59
2019;"1415";"Män";0;109;6937;7046;0,0154697700823162;1,55
2019;"1415";"Kvinnor";0;205;4860;5065;0,0404738400789733;4,05
2019;"1419";"Män";0;41;2275;2316;0,0177029360967185;1,77
2019;"1419";"Kvinnor";0;58;2210;2268;0,0255731922398589;2,56
2019;"1421";"Män";0;26;2288;2314;0,0112359550561798;1,12
2019;"1421";"Kvinnor";0;46;2035;2081;0,0221047573282076;2,21
2019;"1427";"Män";0;30;1900;1930;0,0155440414507772;1,55
2019;"1427";"Kvinnor";0;43;1780;1823;0,0235874931431706;2,36
2019;"1430";"Män";0;81;1745;1826;0,0443592552026287;4,44
2019;"1430";"Kvinnor";0;64;1619;1683;0,0380273321449792;3,8
2019;"1435";"Män";0;80;2463;2543;0,0314589068029886;3,15
2019;"1435";"Kvinnor";0;141;2159;2300;0,061304347826087;6,13
2019;"1438";"Män";0;10;1150;1160;0,00862068965517241;0,86
2019;"1438";"Kvinnor";0;11;862;873;0,0126002290950745;1,26
2019;"1439";"Män";0;5;1090;1095;0,0045662100456621;0,46
2019;"1439";"Kvinnor";0;6;963;969;0,00619195046439629;0,62
2019;"1440";"Män";0;73;3374;3447;0,0211778357992457;2,12
2019;"1440";"Kvinnor";0;97;3509;3606;0,0268996117581808;2,69
2019;"1441";"Män";0;142;4284;4426;0,0320831450519657;3,21
2019;"1441";"Kvinnor";0;194;5146;5340;0,0363295880149813;3,63
2019;"1442";"Män";0;33;2956;2989;0,0110404817664771;1,1
2019;"1442";"Kvinnor";0;26;1915;1941;0,0133951571354972;1,34
2019;"1443";"Män";0;52;1225;1277;0,0407204385277995;4,07
2019;"1443";"Kvinnor";0;52;1113;1165;0,0446351931330472;4,46
2019;"1444";"Män";0;3;739;742;0,00404312668463612;0,4
2019;"1444";"Kvinnor";0;22;810;832;0,0264423076923077;2,64
2019;"1445";"Män";0;23;1074;1097;0,0209662716499544;2,1
2019;"1445";"Kvinnor";0;37;885;922;0,0401301518438178;4,01
2019;"1446";"Män";0;24;1568;1592;0,0150753768844221;1,51
2019;"1446";"Kvinnor";0;29;1128;1157;0,0250648228176318;2,51
2019;"1447";"Män";0;6;1003;1009;0,00594648166501487;0,59
2019;"1447";"Kvinnor";0;10;742;752;0,0132978723404255;1,33
2019;"1452";"Män";0;63;3413;3476;0,0181242807825086;1,81
2019;"1452";"Kvinnor";0;100;2202;2302;0,0434404865334492;4,34
2019;"1460";"Män";0;46;2004;2050;0,0224390243902439;2,24
2019;"1460";"Kvinnor";0;83;1765;1848;0,0449134199134199;4,49
2019;"1461";"Män";0;19;1563;1582;0,0120101137800253;1,2
2019;"1461";"Kvinnor";0;51;1360;1411;0,036144578313253;3,61
2019;"1462";"Män";0;22;1888;1910;0,0115183246073298;1,15
2019;"1462";"Kvinnor";0;30;1797;1827;0,0164203612479475;1,64
2019;"1463";"Män";0;175;5321;5496;0,0318413391557496;3,18
2019;"1463";"Kvinnor";0;193;4982;5175;0,0372946859903382;3,73
2019;"1465";"Män";0;218;1597;1815;0,120110192837466;12,01
2019;"1465";"Kvinnor";0;180;1571;1751;0,102798400913764;10,28
2019;"1466";"Män";0;11;1911;1922;0,00572320499479709;0,57
2019;"1466";"Kvinnor";0;16;1386;1402;0,0114122681883024;1,14
2019;"1470";"Män";0;61;4323;4384;0,0139142335766423;1,39
2019;"1470";"Kvinnor";0;70;2849;2919;0,0239808153477218;2,4
2019;"1471";"Män";0;22;3413;3435;0,00640465793304221;0,64
2019;"1471";"Kvinnor";0;23;2372;2395;0,00960334029227557;0,96
2019;"1472";"Män";0;24;1748;1772;0,0135440180586907;1,35
2019;"1472";"Kvinnor";0;17;1668;1685;0,0100890207715134;1,01
2019;"1473";"Män";0;11;1649;1660;0,00662650602409639;0,66
2019;"1473";"Kvinnor";0;25;1432;1457;0,0171585449553878;1,72
2019;"1480";"Män";0;7357;181258;188615;0,0390053813323437;3,9
2019;"1480";"Kvinnor";0;9898;157894;167792;0,0589897015352341;5,9
2019;"1481";"Män";0;688;21255;21943;0,0313539625393064;3,14
2019;"1481";"Kvinnor";0;1011;17655;18666;0,0541626486660238;5,42
2019;"1482";"Män";0;245;8374;8619;0,0284255714119968;2,84
2019;"1482";"Kvinnor";0;253;8301;8554;0,0295768061725509;2,96
2019;"1484";"Män";0;44;3092;3136;0,014030612244898;1,4
2019;"1484";"Kvinnor";0;67;2617;2684;0,0249627421758569;2,5
2019;"1485";"Män";0;281;11569;11850;0,0237130801687764;2,37
2019;"1485";"Kvinnor";0;515;11289;11804;0,043629278210776;4,36
2019;"1486";"Män";0;56;2809;2865;0,0195462478184991;1,95
2019;"1486";"Kvinnor";0;230;2711;2941;0,0782046922815369;7,82
2019;"1487";"Män";0;165;6184;6349;0,0259883446212002;2,6
2019;"1487";"Kvinnor";0;210;6475;6685;0,031413612565445;3,14
2019;"1488";"Män";0;300;13713;14013;0,0214086919289231;2,14
2019;"1488";"Kvinnor";0;464;13358;13822;0,0335696715381276;3,36
2019;"1489";"Män";0;224;6483;6707;0,0333979424481885;3,34
2019;"1489";"Kvinnor";0;284;7558;7842;0,0362152512114257;3,62
2019;"1490";"Män";0;2136;25609;27745;0,0769868444764823;7,7
2019;"1490";"Kvinnor";0;2982;24474;27456;0,10861013986014;10,86
2019;"1491";"Män";0;249;4707;4956;0,0502421307506053;5,02
2019;"1491";"Kvinnor";0;380;3707;4087;0,0929777342794226;9,3
2019;"1492";"Män";0;29;2151;2180;0,013302752293578;1,33
2019;"1492";"Kvinnor";0;48;1972;2020;0,0237623762376238;2,38
2019;"1493";"Män";0;87;4416;4503;0,0193204530313125;1,93
2019;"1493";"Kvinnor";0;106;3955;4061;0,0261019453336617;2,61
2019;"1494";"Män";0;184;8710;8894;0,0206881043400045;2,07
2019;"1494";"Kvinnor";0;246;7961;8207;0,0299744120872426;3
2019;"1495";"Män";0;86;4203;4289;0,0200512940079273;2,01
2019;"1495";"Kvinnor";0;114;3692;3806;0,0299527062532843;3
2019;"1496";"Män";0;432;17416;17848;0,0242043926490363;2,42
2019;"1496";"Kvinnor";0;445;15132;15577;0,0285677601592091;2,86
2019;"1497";"Män";0;15;1339;1354;0,0110782865583456;1,11
2019;"1497";"Kvinnor";0;27;1375;1402;0,0192582025677603;1,93
2019;"1498";"Män";0;44;2307;2351;0,0187154402381965;1,87
2019;"1498";"Kvinnor";0;61;2048;2109;0,0289236605026079;2,89
2019;"1499";"Män";0;105;6403;6508;0,0161339889366933;1,61
2019;"1499";"Kvinnor";0;147;5682;5829;0,0252187339166238;2,52
2019;"1715";"Män";0;34;1686;1720;0,0197674418604651;1,98
2019;"1715";"Kvinnor";0;31;1378;1409;0,0220014194464159;2,2
2019;"1730";"Män";0;12;1639;1651;0,00726832222895215;0,73
2019;"1730";"Kvinnor";0;128;1716;1844;0,06941431670282;6,94
2019;"1737";"Män";0;28;2389;2417;0,0115846090194456;1,16
2019;"1737";"Kvinnor";0;37;2346;2383;0,0155266470835082;1,55
2019;"1760";"Män";0;5;515;520;0,00961538461538462;0,96
2019;"1760";"Kvinnor";0;2;439;441;0,00453514739229025;0,45
2019;"1761";"Män";0;30;1840;1870;0,0160427807486631;1,6
2019;"1761";"Kvinnor";0;44;1884;1928;0,0228215767634855;2,28
2019;"1762";"Män";0;14;778;792;0,0176767676767677;1,77
2019;"1762";"Kvinnor";0;12;677;689;0,0174165457184325;1,74
2019;"1763";"Män";0;13;1017;1030;0,012621359223301;1,26
2019;"1763";"Kvinnor";0;23;1400;1423;0,0161630358397751;1,62
2019;"1764";"Män";0;13;1937;1950;0,00666666666666667;0,67
2019;"1764";"Kvinnor";0;21;1298;1319;0,0159211523881729;1,59
2019;"1765";"Män";0;22;1815;1837;0,0119760479041916;1,2
2019;"1765";"Kvinnor";0;87;1765;1852;0,0469762419006479;4,7
2019;"1766";"Män";0;155;2461;2616;0,0592507645259939;5,93
2019;"1766";"Kvinnor";0;127;2205;2332;0,0544596912521441;5,45
2019;"1780";"Män";0;809;26174;26983;0,029981840418041;3
2019;"1780";"Kvinnor";0;1075;24325;25400;0,0423228346456693;4,23
2019;"1781";"Män";0;55;4373;4428;0,0124209575429088;1,24
2019;"1781";"Kvinnor";0;102;3445;3547;0,028756695799267;2,88
2019;"1782";"Män";0;15;1681;1696;0,00884433962264151;0,88
2019;"1782";"Kvinnor";0;43;1521;1564;0,0274936061381074;2,75
2019;"1783";"Män";0;17;2296;2313;0,00734976221357544;0,73
2019;"1783";"Kvinnor";0;39;1754;1793;0,0217512548800892;2,18
2019;"1784";"Män";0;83;5268;5351;0,0155111194169314;1,55
2019;"1784";"Kvinnor";0;118;4815;4933;0,0239205351712954;2,39
2019;"1785";"Män";0;31;2883;2914;0,0106382978723404;1,06
2019;"1785";"Kvinnor";0;59;2561;2620;0,0225190839694656;2,25
2019;"1814";"Män";0;8;1025;1033;0,00774443368828654;0,77
2019;"1814";"Kvinnor";0;15;983;998;0,0150300601202405;1,5
2019;"1860";"Män";0;4;1241;1245;0,00321285140562249;0,32
2019;"1860";"Kvinnor";0;14;870;884;0,0158371040723982;1,58
2019;"1861";"Män";0;46;4095;4141;0,0111084279159623;1,11
2019;"1861";"Kvinnor";0;54;3143;3197;0,0168908351579606;1,69
2019;"1862";"Män";0;5;1412;1417;0,00352858151023289;0,35
2019;"1862";"Kvinnor";0;17;1140;1157;0,0146931719965428;1,47
2019;"1863";"Män";0;13;1298;1311;0,0099160945842868;0,99
2019;"1863";"Kvinnor";0;18;1065;1083;0,0166204986149584;1,66
2019;"1864";"Män";0;11;785;796;0,0138190954773869;1,38
2019;"1864";"Kvinnor";0;13;749;762;0,0170603674540682;1,71
2019;"1880";"Män";0;1231;38963;40194;0,0306264616609444;3,06
2019;"1880";"Kvinnor";0;1531;37216;38747;0,0395127364699203;3,95
2019;"1881";"Män";0;94;3426;3520;0,0267045454545455;2,67
2019;"1881";"Kvinnor";0;89;3215;3304;0,0269370460048426;2,69
2019;"1882";"Män";0;27;2202;2229;0,0121130551816958;1,21
2019;"1882";"Kvinnor";0;43;1611;1654;0,0259975816203144;2,6
2019;"1883";"Män";0;121;7150;7271;0,0166414523449319;1,66
2019;"1883";"Kvinnor";0;170;6104;6274;0,0270959515460631;2,71
2019;"1884";"Män";0;24;1425;1449;0,0165631469979296;1,66
2019;"1884";"Kvinnor";0;58;1444;1502;0,0386151797603196;3,86
2019;"1885";"Män";0;67;4989;5056;0,013251582278481;1,33
2019;"1885";"Kvinnor";0;62;4647;4709;0,0131662773412614;1,32
2019;"1904";"Män";0;7;814;821;0,00852618757612668;0,85
2019;"1904";"Kvinnor";0;16;585;601;0,0266222961730449;2,66
2019;"1907";"Män";0;7;1317;1324;0,00528700906344411;0,53
2019;"1907";"Kvinnor";0;13;1122;1135;0,0114537444933921;1,15
2019;"1960";"Män";0;23;1314;1337;0,0172026925953628;1,72
2019;"1960";"Kvinnor";0;14;1040;1054;0,0132827324478178;1,33
2019;"1961";"Män";0;25;2498;2523;0,00990883868410622;0,99
2019;"1961";"Kvinnor";0;17;2397;2414;0,00704225352112676;0,7
2019;"1962";"Män";0;14;871;885;0,015819209039548;1,58
2019;"1962";"Kvinnor";0;15;759;774;0,0193798449612403;1,94
2019;"1980";"Män";0;1034;36248;37282;0,0277345635963736;2,77
2019;"1980";"Kvinnor";0;1296;33130;34426;0,037645965258816;3,76
2019;"1981";"Män";0;85;3731;3816;0,0222746331236897;2,23
2019;"1981";"Kvinnor";0;134;3637;3771;0,0355343410236012;3,55
2019;"1982";"Män";0;26;3362;3388;0,0076741440377804;0,77
2019;"1982";"Kvinnor";0;44;2783;2827;0,0155642023346304;1,56
2019;"1983";"Män";0;73;6169;6242;0,0116949695610381;1,17
2019;"1983";"Kvinnor";0;107;5205;5312;0,0201430722891566;2,01
2019;"1984";"Män";0;22;2747;2769;0,00794510653665583;0,79
2019;"1984";"Kvinnor";0;36;2197;2233;0,0161218092252575;1,61
2019;"2021";"Män";0;11;1380;1391;0,00790797987059669;0,79
2019;"2021";"Kvinnor";0;23;1232;1255;0,0183266932270916;1,83
2019;"2023";"Män";0;50;2667;2717;0,0184026499815973;1,84
2019;"2023";"Kvinnor";0;48;2271;2319;0,0206985769728331;2,07
2019;"2026";"Män";0;23;1245;1268;0,0181388012618297;1,81
2019;"2026";"Kvinnor";0;9;1309;1318;0,00682852807283763;0,68
2019;"2029";"Män";0;171;3231;3402;0,0502645502645503;5,03
2019;"2029";"Kvinnor";0;148;2833;2981;0,0496477692049648;4,96
2019;"2031";"Män";0;58;1686;1744;0,033256880733945;3,33
2019;"2031";"Kvinnor";0;66;1682;1748;0,0377574370709382;3,78
2019;"2034";"Män";0;33;1161;1194;0,0276381909547739;2,76
2019;"2034";"Kvinnor";0;23;946;969;0,0237358101135191;2,37
2019;"2039";"Män";0;13;1536;1549;0,00839251129761136;0,84
2019;"2039";"Kvinnor";0;24;1263;1287;0,0186480186480186;1,86
2019;"2061";"Män";0;16;1628;1644;0,0097323600973236;0,97
2019;"2061";"Kvinnor";0;18;1201;1219;0,014766201804758;1,48
2019;"2062";"Män";0;80;5196;5276;0,0151630022744503;1,52
2019;"2062";"Kvinnor";0;148;4724;4872;0,0303776683087028;3,04
2019;"2080";"Män";0;593;12013;12606;0,0470410915437093;4,7
2019;"2080";"Kvinnor";0;579;13503;14082;0,0411163187047294;4,11
2019;"2081";"Män";0;156;14875;15031;0,0103785509946111;1,04
2019;"2081";"Kvinnor";0;334;11402;11736;0,0284594410361282;2,85
2019;"2082";"Män";0;20;1382;1402;0,014265335235378;1,43
2019;"2082";"Kvinnor";0;36;1528;1564;0,0230179028132992;2,3
2019;"2083";"Män";0;44;3285;3329;0,0132171823370382;1,32
2019;"2083";"Kvinnor";0;60;2719;2779;0,0215905001799208;2,16
2019;"2084";"Män";0;82;5407;5489;0,0149389688467845;1,49
2019;"2084";"Kvinnor";0;139;4183;4322;0,0321610365571495;3,22
2019;"2085";"Män";0;56;6576;6632;0,00844390832328106;0,84
2019;"2085";"Kvinnor";0;73;5061;5134;0,014218932606155;1,42
2019;"2101";"Män";0;14;834;848;0,0165094339622642;1,65
2019;"2101";"Kvinnor";0;15;759;774;0,0193798449612403;1,94
2019;"2104";"Män";0;15;1838;1853;0,00809498111171074;0,81
2019;"2104";"Kvinnor";0;16;1337;1353;0,0118255728011826;1,18
2019;"2121";"Män";0;24;2962;2986;0,00803750837240455;0,8
2019;"2121";"Kvinnor";0;45;2107;2152;0,020910780669145;2,09
2019;"2132";"Män";0;21;1413;1434;0,0146443514644351;1,46
2019;"2132";"Kvinnor";0;29;1156;1185;0,0244725738396624;2,45
2019;"2161";"Män";0;116;3615;3731;0,031090860359153;3,11
2019;"2161";"Kvinnor";0;170;3217;3387;0,0501919102450546;5,02
2019;"2180";"Män";0;671;22847;23518;0,0285313376987839;2,85
2019;"2180";"Kvinnor";0;867;21988;22855;0,0379348063880989;3,79
2019;"2181";"Män";0;103;9208;9311;0,0110621845129417;1,11
2019;"2181";"Kvinnor";0;157;6832;6989;0,0224638717985406;2,25
2019;"2182";"Män";0;81;4817;4898;0,0165373621886484;1,65
2019;"2182";"Kvinnor";0;151;3852;4003;0,0377217087184612;3,77
2019;"2183";"Män";0;150;4986;5136;0,0292056074766355;2,92
2019;"2183";"Kvinnor";0;158;5086;5244;0,0301296720061022;3,01
2019;"2184";"Män";0;177;8107;8284;0,0213664896185418;2,14
2019;"2184";"Kvinnor";0;212;7482;7694;0,0275539381336106;2,76
2019;"2260";"Män";0;45;1946;1991;0,0226017076845806;2,26
2019;"2260";"Kvinnor";0;53;1513;1566;0,0338441890166028;3,38
2019;"2262";"Män";0;27;3220;3247;0,00831536803202957;0,83
2019;"2262";"Kvinnor";0;25;2116;2141;0,0116767865483419;1,17
2019;"2280";"Män";0;149;4302;4451;0,0334756234554033;3,35
2019;"2280";"Kvinnor";0;196;4408;4604;0,0425716768027802;4,26
2019;"2281";"Män";0;546;24601;25147;0,0217123314908339;2,17
2019;"2281";"Kvinnor";0;856;22825;23681;0,0361471221654491;3,61
2019;"2282";"Män";0;33;3848;3881;0,00850296315382633;0,85
2019;"2282";"Kvinnor";0;55;3104;3159;0,0174105729661285;1,74
2019;"2283";"Män";0;69;3570;3639;0,0189612530915087;1,9
2019;"2283";"Kvinnor";0;87;3223;3310;0,0262839879154079;2,63
2019;"2284";"Män";0;253;12339;12592;0,0200921219822109;2,01
2019;"2284";"Kvinnor";0;378;10304;10682;0,0353866317169069;3,54
2019;"2303";"Män";0;7;1072;1079;0,00648748841519926;0,65
2019;"2303";"Kvinnor";0;11;871;882;0,0124716553287982;1,25
2019;"2305";"Män";0;18;1030;1048;0,017175572519084;1,72
2019;"2305";"Kvinnor";0;21;848;869;0,0241657077100115;2,42
2019;"2309";"Män";0;19;2282;2301;0,00825727944372012;0,83
2019;"2309";"Kvinnor";0;16;1946;1962;0,00815494393476045;0,82
2019;"2313";"Män";0;11;2483;2494;0,00441058540497193;0,44
2019;"2313";"Kvinnor";0;20;2056;2076;0,00963391136801541;0,96
2019;"2321";"Män";0;88;2806;2894;0,0304077401520387;3,04
2019;"2321";"Kvinnor";0;103;2496;2599;0,039630627164294;3,96
2019;"2326";"Män";0;13;1279;1292;0,010061919504644;1,01
2019;"2326";"Kvinnor";0;14;1077;1091;0,0128322639780018;1,28
2019;"2361";"Män";0;11;2269;2280;0,00482456140350877;0,48
2019;"2361";"Kvinnor";0;16;2016;2032;0,0078740157480315;0,79
2019;"2380";"Män";0;605;16022;16627;0,0363866001082577;3,64
2019;"2380";"Kvinnor";0;691;16181;16872;0,0409554291133239;4,1
2019;"2401";"Män";0;25;999;1024;0,0244140625;2,44
2019;"2401";"Kvinnor";0;26;953;979;0,0265577119509704;2,66
2019;"2403";"Män";0;3;302;305;0,00983606557377049;0,98
2019;"2403";"Kvinnor";0;6;349;355;0,0169014084507042;1,69
2019;"2404";"Män";0;14;1204;1218;0,0114942528735632;1,15
2019;"2404";"Kvinnor";0;14;884;898;0,0155902004454343;1,56
2019;"2409";"Män";0;11;955;966;0,0113871635610766;1,14
2019;"2409";"Kvinnor";0;6;949;955;0,00628272251308901;0,63
2019;"2417";"Män";0;13;743;756;0,0171957671957672;1,72
2019;"2417";"Kvinnor";0;22;650;672;0,0327380952380952;3,27
2019;"2418";"Män";0;3;663;666;0,0045045045045045;0,45
2019;"2418";"Kvinnor";0;12;531;543;0,0220994475138122;2,21
2019;"2421";"Män";0;14;1301;1315;0,0106463878326996;1,06
2019;"2421";"Kvinnor";0;19;1150;1169;0,0162532078699743;1,63
2019;"2422";"Män";0;1;452;453;0,0022075055187638;0,22
2019;"2422";"Kvinnor";0;6;438;444;0,0135135135135135;1,35
2019;"2425";"Män";0;3;491;494;0,00607287449392713;0,61
2019;"2425";"Kvinnor";0;6;443;449;0,0133630289532294;1,34
2019;"2460";"Män";0;10;1256;1266;0,00789889415481832;0,79
2019;"2460";"Kvinnor";0;12;1102;1114;0,0107719928186715;1,08
2019;"2462";"Män";0;24;1160;1184;0,0202702702702703;2,03
2019;"2462";"Kvinnor";0;21;1238;1259;0,0166799046862589;1,67
2019;"2463";"Män";0;3;495;498;0,00602409638554217;0,6
2019;"2463";"Kvinnor";0;10;464;474;0,0210970464135021;2,11
2019;"2480";"Män";0;942;32252;33194;0,0283786226426463;2,84
2019;"2480";"Kvinnor";0;1267;29862;31129;0,0407015965819654;4,07
2019;"2481";"Män";0;35;2907;2942;0,0118966689326988;1,19
2019;"2481";"Kvinnor";0;59;2659;2718;0,0217071376011773;2,17
2019;"2482";"Män";0;372;17119;17491;0,0212680807272311;2,13
2019;"2482";"Kvinnor";0;450;14107;14557;0,0309129628357491;3,09
2019;"2505";"Män";0;16;1292;1308;0,0122324159021407;1,22
2019;"2505";"Kvinnor";0;32;1216;1248;0,0256410256410256;2,56
2019;"2506";"Män";0;0;765;765;0;0
2019;"2506";"Kvinnor";0;17;541;558;0,0304659498207885;3,05
2019;"2510";"Män";0;29;968;997;0,0290872617853561;2,91
2019;"2510";"Kvinnor";0;49;872;921;0,0532030401737242;5,32
2019;"2513";"Män";0;6;617;623;0,00963081861958266;0,96
2019;"2513";"Kvinnor";0;9;545;554;0,0162454873646209;1,62
2019;"2514";"Män";0;49;3079;3128;0,0156649616368286;1,57
2019;"2514";"Kvinnor";0;89;2692;2781;0,0320028766630708;3,2
2019;"2518";"Män";0;15;711;726;0,0206611570247934;2,07
2019;"2518";"Kvinnor";0;19;607;626;0,0303514376996805;3,04
2019;"2521";"Män";0;40;1139;1179;0,0339270568278202;3,39
2019;"2521";"Kvinnor";0;19;884;903;0,0210409745293466;2,1
2019;"2523";"Män";0;52;4831;4883;0,0106491910710629;1,06
2019;"2523";"Kvinnor";0;65;3667;3732;0,017416934619507;1,74
2019;"2560";"Män";0;5;1388;1393;0,00358937544867193;0,36
2019;"2560";"Kvinnor";0;23;1281;1304;0,0176380368098159;1,76
2019;"2580";"Män";0;592;21018;21610;0,0273947246645072;2,74
2019;"2580";"Kvinnor";0;849;18211;19060;0,0445435466946485;4,45
2019;"2581";"Män";0;153;8774;8927;0,0171390164668982;1,71
2019;"2581";"Kvinnor";0;262;7555;7817;0,0335166943840348;3,35
2019;"2582";"Män";0;57;5153;5210;0,0109404990403071;1,09
2019;"2582";"Kvinnor";0;90;4427;4517;0,0199247288023024;1,99
2019;"2583";"Män";0;25;1400;1425;0,0175438596491228;1,75
2019;"2583";"Kvinnor";0;35;1512;1547;0,0226244343891403;2,26
2019;"2584";"Män";0;119;6645;6764;0,0175931401537552;1,76
2019;"2584";"Kvinnor";0;244;4991;5235;0,0466093600764088;4,66
2019;"9999";"Män";0;1957;176639;178596;0,0109576922215503;1,1
2019;"9999";"Kvinnor";0;2645;201290;203935;0,0129698188148184;1,3
2020;"0114";"Män";0;161;7152;7313;0,0220155886776973;2,2
2020;"0114";"Kvinnor";0;196;6388;6584;0,0297691373025516;2,98
2020;"0115";"Män";0;88;4295;4383;0,0200775724389687;2,01
2020;"0115";"Kvinnor";0;102;3866;3968;0,0257056451612903;2,57
2020;"0117";"Män";0;146;5167;5313;0,0274797666102014;2,75
2020;"0117";"Kvinnor";0;179;5122;5301;0,0337672137332579;3,38
2020;"0120";"Män";0;233;5606;5839;0,0399040931666381;3,99
2020;"0120";"Kvinnor";0;256;5295;5551;0,0461178166096199;4,61
2020;"0123";"Män";0;438;13937;14375;0,0304695652173913;3,05
2020;"0123";"Kvinnor";0;590;9815;10405;0,0567035079288803;5,67
2020;"0125";"Män";0;111;3820;3931;0,0282370897990333;2,82
2020;"0125";"Kvinnor";0;137;3681;3818;0,035882661079099;3,59
2020;"0126";"Män";0;444;22000;22444;0,0197825699518802;1,98
2020;"0126";"Kvinnor";0;506;22333;22839;0,0221550855991944;2,22
2020;"0127";"Män";0;380;12550;12930;0,0293890177880897;2,94
2020;"0127";"Kvinnor";0;457;9744;10201;0,0447995294578963;4,48
2020;"0128";"Män";0;48;1097;1145;0,0419213973799127;4,19
2020;"0128";"Kvinnor";0;40;1384;1424;0,0280898876404494;2,81
2020;"0136";"Män";0;271;15888;16159;0,0167708397796893;1,68
2020;"0136";"Kvinnor";0;325;11994;12319;0,0263820115269097;2,64
2020;"0138";"Män";0;185;5354;5539;0,0333995306011916;3,34
2020;"0138";"Kvinnor";0;248;4897;5145;0,0482021379980564;4,82
2020;"0139";"Män";0;60;6480;6540;0,00917431192660551;0,92
2020;"0139";"Kvinnor";0;46;4007;4053;0,0113496175672341;1,13
2020;"0140";"Män";0;17;1600;1617;0,0105132962275819;1,05
2020;"0140";"Kvinnor";0;21;1259;1280;0,01640625;1,64
2020;"0160";"Män";0;526;12013;12539;0,0419491187495016;4,19
2020;"0160";"Kvinnor";0;723;10873;11596;0,0623490858916868;6,23
2020;"0162";"Män";0;207;7807;8014;0,0258297978537559;2,58
2020;"0162";"Kvinnor";0;277;11283;11560;0,023961937716263;2,4
2020;"0163";"Män";0;324;12644;12968;0,0249845774213448;2,5
2020;"0163";"Kvinnor";0;379;11328;11707;0,0323737934569061;3,24
2020;"0180";"Män";0;31039;315649;346688;0,0895300673804689;8,95
2020;"0180";"Kvinnor";0;36049;289449;325498;0,110750296468796;11,08
2020;"0181";"Män";0;433;28119;28552;0,0151653124124405;1,52
2020;"0181";"Kvinnor";0;460;21149;21609;0,0212874265352399;2,13
2020;"0182";"Män";0;900;15883;16783;0,0536256926651969;5,36
2020;"0182";"Kvinnor";0;1068;15799;16867;0,0633189067409735;6,33
2020;"0183";"Män";0;269;11064;11333;0,0237359922350657;2,37
2020;"0183";"Kvinnor";0;246;11071;11317;0,0217372095078201;2,17
2020;"0184";"Män";0;971;50807;51778;0,0187531383985476;1,88
2020;"0184";"Kvinnor";0;1316;50120;51436;0,0255851932498639;2,56
2020;"0186";"Män";0;291;4853;5144;0,0565707620528771;5,66
2020;"0186";"Kvinnor";0;312;5675;5987;0,0521129113078336;5,21
2020;"0187";"Män";0;53;1232;1285;0,0412451361867704;4,12
2020;"0187";"Kvinnor";0;72;1293;1365;0,0527472527472527;5,27
2020;"0188";"Män";0;208;10480;10688;0,0194610778443114;1,95
2020;"0188";"Kvinnor";0;285;10781;11066;0,0257545635279234;2,58
2020;"0191";"Män";0;172;15433;15605;0,0110221082986222;1,1
2020;"0191";"Kvinnor";0;242;10203;10445;0,0231689803733844;2,32
2020;"0192";"Män";0;59;3144;3203;0,0184202310334062;1,84
2020;"0192";"Kvinnor";0;92;3400;3492;0,0263459335624284;2,63
2020;"0305";"Män";0;50;2654;2704;0,018491124260355;1,85
2020;"0305";"Kvinnor";0;82;2537;2619;0,0313096601756396;3,13
2020;"0319";"Män";0;12;1285;1297;0,00925212027756361;0,93
2020;"0319";"Kvinnor";0;18;1130;1148;0,0156794425087108;1,57
2020;"0330";"Män";0;51;1902;1953;0,0261136712749616;2,61
2020;"0330";"Kvinnor";0;55;1969;2024;0,0271739130434783;2,72
2020;"0331";"Män";0;349;2091;2440;0,143032786885246;14,3
2020;"0331";"Kvinnor";0;266;1898;2164;0,122920517560074;12,29
2020;"0360";"Män";0;46;3462;3508;0,0131128848346636;1,31
2020;"0360";"Kvinnor";0;51;2832;2883;0,0176899063475546;1,77
2020;"0380";"Män";0;1789;48680;50469;0,0354475024272326;3,54
2020;"0380";"Kvinnor";0;2081;50782;52863;0,0393659081020752;3,94
2020;"0381";"Män";0;139;8860;8999;0,0154461606845205;1,54
2020;"0381";"Kvinnor";0;165;7780;7945;0,0207677784770296;2,08
2020;"0382";"Män";0;29;5166;5195;0,0055822906641001;0,56
2020;"0382";"Kvinnor";0;54;3823;3877;0,0139282950735104;1,39
2020;"0428";"Män";0;66;1335;1401;0,0471092077087794;4,71
2020;"0428";"Kvinnor";0;104;1226;1330;0,0781954887218045;7,82
2020;"0461";"Män";0;42;1182;1224;0,0343137254901961;3,43
2020;"0461";"Kvinnor";0;57;1361;1418;0,040197461212976;4,02
2020;"0480";"Män";0;256;10238;10494;0,0243948923194206;2,44
2020;"0480";"Kvinnor";0;348;11214;11562;0,030098598858329;3,01
2020;"0481";"Män";0;19;2940;2959;0,00642108820547482;0,64
2020;"0481";"Kvinnor";0;29;1799;1828;0,0158643326039387;1,59
2020;"0482";"Män";0;23;2604;2627;0,00875523410734678;0,88
2020;"0482";"Kvinnor";0;44;2302;2346;0,0187553282182438;1,88
2020;"0483";"Män";0;155;6941;7096;0,0218432919954904;2,18
2020;"0483";"Kvinnor";0;134;6443;6577;0,0203740307130911;2,04
2020;"0484";"Män";0;609;20923;21532;0,0282834850455137;2,83
2020;"0484";"Kvinnor";0;837;20161;20998;0,0398609391370607;3,99
2020;"0486";"Män";0;138;5322;5460;0,0252747252747253;2,53
2020;"0486";"Kvinnor";0;190;5022;5212;0,0364543361473523;3,65
2020;"0488";"Män";0;62;1819;1881;0,0329611908559277;3,3
2020;"0488";"Kvinnor";0;88;1880;1968;0,0447154471544715;4,47
2020;"0509";"Män";0;32;718;750;0,0426666666666667;4,27
2020;"0509";"Kvinnor";0;26;665;691;0,0376266280752533;3,76
2020;"0512";"Män";0;11;548;559;0,0196779964221825;1,97
2020;"0512";"Kvinnor";0;16;376;392;0,0408163265306122;4,08
2020;"0513";"Män";0;27;1627;1654;0,0163240628778718;1,63
2020;"0513";"Kvinnor";0;29;1466;1495;0,0193979933110368;1,94
2020;"0560";"Män";0;8;953;961;0,00832466181061394;0,83
2020;"0560";"Kvinnor";0;12;578;590;0,0203389830508475;2,03
2020;"0561";"Män";0;41;1548;1589;0,025802391441158;2,58
2020;"0561";"Kvinnor";0;35;1289;1324;0,0264350453172205;2,64
2020;"0562";"Män";0;29;5181;5210;0,00556621880998081;0,56
2020;"0562";"Kvinnor";0;37;3614;3651;0,0101342098055327;1,01
2020;"0563";"Män";0;13;1245;1258;0,0103338632750397;1,03
2020;"0563";"Kvinnor";0;17;969;986;0,0172413793103448;1,72
2020;"0580";"Män";0;877;44198;45075;0,0194564614531337;1,95
2020;"0580";"Kvinnor";0;1126;39517;40643;0,0277046477868268;2,77
2020;"0581";"Män";0;858;32353;33211;0,0258348137665231;2,58
2020;"0581";"Kvinnor";0;1061;29468;30529;0,034753840610567;3,48
2020;"0582";"Män";0;41;1891;1932;0,0212215320910973;2,12
2020;"0582";"Kvinnor";0;44;1861;1905;0,0230971128608924;2,31
2020;"0583";"Män";0;122;6676;6798;0,0179464548396587;1,79
2020;"0583";"Kvinnor";0;157;6972;7129;0,0220227240847244;2,2
2020;"0584";"Män";0;39;1459;1498;0,0260347129506008;2,6
2020;"0584";"Kvinnor";0;41;1339;1380;0,0297101449275362;2,97
2020;"0586";"Män";0;40;7270;7310;0,00547195622435021;0,55
2020;"0586";"Kvinnor";0;98;4550;4648;0,0210843373493976;2,11
2020;"0604";"Män";0;19;1207;1226;0,0154975530179445;1,55
2020;"0604";"Kvinnor";0;22;1049;1071;0,0205415499533147;2,05
2020;"0617";"Män";0;40;3610;3650;0,010958904109589;1,1
2020;"0617";"Kvinnor";0;58;2417;2475;0,0234343434343434;2,34
2020;"0642";"Män";0;13;1220;1233;0,0105433901054339;1,05
2020;"0642";"Kvinnor";0;44;1194;1238;0,0355411954765751;3,55
2020;"0643";"Män";0;27;1859;1886;0,0143160127253446;1,43
2020;"0643";"Kvinnor";0;36;1626;1662;0,0216606498194946;2,17
2020;"0662";"Män";0;71;7962;8033;0,00883854101829951;0,88
2020;"0662";"Kvinnor";0;122;5811;5933;0,0205629529748862;2,06
2020;"0665";"Män";0;25;2978;3003;0,00832500832500833;0,83
2020;"0665";"Kvinnor";0;39;2191;2230;0,0174887892376682;1,75
2020;"0680";"Män";0;1012;37194;38206;0,0264879861801811;2,65
2020;"0680";"Kvinnor";0;1255;33253;34508;0,03636837834705;3,64
2020;"0682";"Män";0;91;6577;6668;0,0136472705458908;1,36
2020;"0682";"Kvinnor";0;100;5310;5410;0,0184842883548983;1,85
2020;"0683";"Män";0;124;8409;8533;0,0145318176491269;1,45
2020;"0683";"Kvinnor";0;208;7822;8030;0,0259028642590286;2,59
2020;"0684";"Män";0;27;2407;2434;0,0110928512736237;1,11
2020;"0684";"Kvinnor";0;59;1816;1875;0,0314666666666667;3,15
2020;"0685";"Män";0;77;6479;6556;0,011744966442953;1,17
2020;"0685";"Kvinnor";0;111;4684;4795;0,0231491136600626;2,31
2020;"0686";"Män";0;48;4459;4507;0,010650099844686;1,07
2020;"0686";"Kvinnor";0;80;4489;4569;0,0175093018165901;1,75
2020;"0687";"Män";0;89;4307;4396;0,02024567788899;2,02
2020;"0687";"Kvinnor";0;85;3607;3692;0,0230227518959913;2,3
2020;"0760";"Män";0;15;2858;2873;0,00522102332057083;0,52
2020;"0760";"Kvinnor";0;10;1769;1779;0,00562113546936481;0,56
2020;"0761";"Män";0;12;1111;1123;0,0106856634016028;1,07
2020;"0761";"Kvinnor";0;49;1050;1099;0,0445859872611465;4,46
2020;"0763";"Män";0;35;2924;2959;0,0118283203785063;1,18
2020;"0763";"Kvinnor";0;29;2409;2438;0,0118949958982773;1,19
2020;"0764";"Män";0;40;4045;4085;0,00979192166462668;0,98
2020;"0764";"Kvinnor";0;48;3057;3105;0,0154589371980676;1,55
2020;"0765";"Män";0;1430;4207;5637;0,253681036012063;25,37
2020;"0765";"Kvinnor";0;1519;3693;5212;0,291442824251727;29,14
2020;"0767";"Män";0;53;3211;3264;0,0162377450980392;1,62
2020;"0767";"Kvinnor";0;52;2010;2062;0,0252182347235693;2,52
2020;"0780";"Män";0;775;23037;23812;0,0325466151520242;3,25
2020;"0780";"Kvinnor";0;872;21025;21897;0,0398228067771841;3,98
2020;"0781";"Män";0;275;6302;6577;0,0418123764634332;4,18
2020;"0781";"Kvinnor";0;186;5422;5608;0,0331669044222539;3,32
2020;"0821";"Män";0;8;751;759;0,0105401844532279;1,05
2020;"0821";"Kvinnor";0;5;776;781;0,00640204865556978;0,64
2020;"0834";"Män";0;6;1137;1143;0,005249343832021;0,52
2020;"0834";"Kvinnor";0;17;959;976;0,0174180327868852;1,74
2020;"0840";"Män";0;38;2239;2277;0,0166886253842776;1,67
2020;"0840";"Kvinnor";0;88;2275;2363;0,0372407955988151;3,72
2020;"0860";"Män";0;17;2630;2647;0,00642236494144314;0,64
2020;"0860";"Kvinnor";0;22;2187;2209;0,00995925758261657;1
2020;"0861";"Män";0;25;2380;2405;0,0103950103950104;1,04
2020;"0861";"Kvinnor";0;47;1950;1997;0,0235353029544316;2,35
2020;"0862";"Män";0;27;2394;2421;0,0111524163568773;1,12
2020;"0862";"Kvinnor";0;34;1626;1660;0,0204819277108434;2,05
2020;"0880";"Män";0;630;16766;17396;0,0362152218900897;3,62
2020;"0880";"Kvinnor";0;774;16281;17055;0,0453825857519789;4,54
2020;"0881";"Män";0;39;3820;3859;0,0101062451412283;1,01
2020;"0881";"Kvinnor";0;59;3372;3431;0,017196152725153;1,72
2020;"0882";"Män";0;60;7425;7485;0,00801603206412826;0,8
2020;"0882";"Kvinnor";0;104;5695;5799;0,0179341265735472;1,79
2020;"0883";"Män";0;93;7004;7097;0,0131041285050021;1,31
2020;"0883";"Kvinnor";0;167;6724;6891;0,0242345087795676;2,42
2020;"0884";"Män";0;239;3704;3943;0,0606137458787725;6,06
2020;"0884";"Kvinnor";0;222;2886;3108;0,0714285714285714;7,14
2020;"0885";"Män";0;57;1801;1858;0,0306781485468245;3,07
2020;"0885";"Kvinnor";0;77;1533;1610;0,0478260869565217;4,78
2020;"0980";"Män";0;400;12428;12828;0,0311817898347365;3,12
2020;"0980";"Kvinnor";0;510;11978;12488;0,0408392056374119;4,08
2020;"1060";"Män";0;24;4274;4298;0,00558399255467659;0,56
2020;"1060";"Kvinnor";0;40;2382;2422;0,0165152766308836;1,65
2020;"1080";"Män";0;375;15409;15784;0,0237582361885454;2,38
2020;"1080";"Kvinnor";0;413;13386;13799;0,0299297050510907;2,99
2020;"1081";"Män";0;75;5224;5299;0,0141536138894131;1,42
2020;"1081";"Kvinnor";0;83;4214;4297;0,0193158017221317;1,93
2020;"1082";"Män";0;124;5990;6114;0,0202813215570821;2,03
2020;"1082";"Kvinnor";0;147;5942;6089;0,0241418952208901;2,41
2020;"1083";"Män";0;56;2957;3013;0,0185861267839363;1,86
2020;"1083";"Kvinnor";0;68;2443;2511;0,0270808442851454;2,71
2020;"1214";"Män";0;26;1759;1785;0,0145658263305322;1,46
2020;"1214";"Kvinnor";0;39;1808;1847;0,0211153221440173;2,11
2020;"1230";"Män";0;61;3751;3812;0,0160020986358867;1,6
2020;"1230";"Kvinnor";0;49;2901;2950;0,0166101694915254;1,66
2020;"1231";"Män";0;62;5323;5385;0,0115134633240483;1,15
2020;"1231";"Kvinnor";0;111;3093;3204;0,0346441947565543;3,46
2020;"1233";"Män";0;138;3869;4007;0,0344397304716746;3,44
2020;"1233";"Kvinnor";0;178;4316;4494;0,0396083667111704;3,96
2020;"1256";"Män";0;44;2003;2047;0,021494870542257;2,15
2020;"1256";"Kvinnor";0;52;1618;1670;0,0311377245508982;3,11
2020;"1257";"Män";0;10;1828;1838;0,00544069640914037;0,54
2020;"1257";"Kvinnor";0;22;1477;1499;0,0146764509673115;1,47
2020;"1260";"Män";0;9;2371;2380;0,00378151260504202;0,38
2020;"1260";"Kvinnor";0;18;1935;1953;0,00921658986175115;0,92
2020;"1261";"Män";0;86;3708;3794;0,0226673695308382;2,27
2020;"1261";"Kvinnor";0;203;3552;3755;0,0540612516644474;5,41
2020;"1262";"Män";0;101;2487;2588;0,0390262751159196;3,9
2020;"1262";"Kvinnor";0;125;3030;3155;0,0396196513470681;3,96
2020;"1263";"Män";0;67;3390;3457;0,0193809661556263;1,94
2020;"1263";"Kvinnor";0;76;2758;2834;0,0268172194777699;2,68
2020;"1264";"Män";0;57;2047;2104;0,0270912547528517;2,71
2020;"1264";"Kvinnor";0;56;1894;1950;0,0287179487179487;2,87
2020;"1265";"Män";0;49;2794;2843;0,0172353148083011;1,72
2020;"1265";"Kvinnor";0;44;2763;2807;0,0156750979693623;1,57
2020;"1266";"Män";0;33;2285;2318;0,0142364106988783;1,42
2020;"1266";"Kvinnor";0;47;2161;2208;0,021286231884058;2,13
2020;"1267";"Män";0;52;1924;1976;0,0263157894736842;2,63
2020;"1267";"Kvinnor";0;56;2429;2485;0,0225352112676056;2,25
2020;"1270";"Män";0;57;2333;2390;0,0238493723849372;2,38
2020;"1270";"Kvinnor";0;67;2092;2159;0,031032885595183;3,1
2020;"1272";"Män";0;28;2229;2257;0,0124058484714222;1,24
2020;"1272";"Kvinnor";0;31;1780;1811;0,0171176145775814;1,71
2020;"1273";"Män";0;35;2078;2113;0,0165641268338855;1,66
2020;"1273";"Kvinnor";0;50;1864;1914;0,0261233019853709;2,61
2020;"1275";"Män";0;6;1766;1772;0,00338600451467269;0,34
2020;"1275";"Kvinnor";0;10;1192;1202;0,00831946755407654;0,83
2020;"1276";"Män";0;76;2799;2875;0,0264347826086957;2,64
2020;"1276";"Kvinnor";0;52;2380;2432;0,0213815789473684;2,14
2020;"1277";"Män";0;20;3024;3044;0,00657030223390276;0,66
2020;"1277";"Kvinnor";0;34;2607;2641;0,012873911397198;1,29
2020;"1278";"Män";0;65;3192;3257;0,0199570156585815;2
2020;"1278";"Kvinnor";0;86;2797;2883;0,0298300381547;2,98
2020;"1280";"Män";0;5142;87762;92904;0,0553474554378714;5,53
2020;"1280";"Kvinnor";0;5489;82037;87526;0,0627127939126659;6,27
2020;"1281";"Män";0;831;33667;34498;0,024088352947997;2,41
2020;"1281";"Kvinnor";0;1200;34037;35237;0,0340551125237676;3,41
2020;"1282";"Män";0;179;8091;8270;0,0216444981862152;2,16
2020;"1282";"Kvinnor";0;200;6674;6874;0,0290951411114344;2,91
2020;"1283";"Män";0;1331;36024;37355;0,0356311069468612;3,56
2020;"1283";"Kvinnor";0;1608;32147;33755;0,0476373870537698;4,76
2020;"1284";"Män";0;125;3954;4079;0,0306447658739887;3,06
2020;"1284";"Kvinnor";0;175;3797;3972;0,0440584088620342;4,41
2020;"1285";"Män";0;146;5272;5418;0,0269472129937246;2,69
2020;"1285";"Kvinnor";0;141;4774;4915;0,0286876907426246;2,87
2020;"1286";"Män";0;169;5845;6014;0,0281010974393083;2,81
2020;"1286";"Kvinnor";0;249;6027;6276;0,0396749521988528;3,97
2020;"1287";"Män";0;131;5996;6127;0,0213807736249388;2,14
2020;"1287";"Kvinnor";0;161;6172;6333;0,0254223906521396;2,54
2020;"1290";"Män";0;445;18015;18460;0,0241061755146262;2,41
2020;"1290";"Kvinnor";0;685;17631;18316;0,0373989954138458;3,74
2020;"1291";"Män";0;112;3294;3406;0,0328831473869642;3,29
2020;"1291";"Kvinnor";0;141;3206;3347;0,0421272781595459;4,21
2020;"1292";"Män";0;226;8403;8629;0,0261907521149612;2,62
2020;"1292";"Kvinnor";0;300;8477;8777;0,0341802438190726;3,42
2020;"1293";"Män";0;187;10027;10214;0,0183082044252986;1,83
2020;"1293";"Kvinnor";0;217;8743;8960;0,02421875;2,42
2020;"1315";"Män";0;30;2325;2355;0,0127388535031847;1,27
2020;"1315";"Kvinnor";0;31;1838;1869;0,0165864098448368;1,66
2020;"1380";"Män";0;582;24585;25167;0,0231255215162713;2,31
2020;"1380";"Kvinnor";0;774;22472;23246;0,0332960509334939;3,33
2020;"1381";"Män";0;122;4069;4191;0,0291099976139346;2,91
2020;"1381";"Kvinnor";0;122;3786;3908;0,0312180143295803;3,12
2020;"1382";"Män";0;250;9609;9859;0,0253575413327924;2,54
2020;"1382";"Kvinnor";0;387;9105;9492;0,0407711757269279;4,08
2020;"1383";"Män";0;433;14559;14992;0,0288820704375667;2,89
2020;"1383";"Kvinnor";0;686;13571;14257;0,0481167145963386;4,81
2020;"1384";"Män";0;455;10814;11269;0,040376253438637;4,04
2020;"1384";"Kvinnor";0;776;11767;12543;0,0618671769114247;6,19
2020;"1401";"Män";0;246;8113;8359;0,0294293575786577;2,94
2020;"1401";"Kvinnor";0;194;6313;6507;0,0298140464115568;2,98
2020;"1402";"Män";0;256;5724;5980;0,042809364548495;4,28
2020;"1402";"Kvinnor";0;356;5120;5476;0,0650109569028488;6,5
2020;"1407";"Män";0;33;1634;1667;0,0197960407918416;1,98
2020;"1407";"Kvinnor";0;48;1491;1539;0,0311890838206628;3,12
2020;"1415";"Män";0;90;6778;6868;0,0131042516016308;1,31
2020;"1415";"Kvinnor";0;174;4782;4956;0,0351089588377724;3,51
2020;"1419";"Män";0;30;2261;2291;0,013094718463553;1,31
2020;"1419";"Kvinnor";0;51;2208;2259;0,0225763612217795;2,26
2020;"1421";"Män";0;26;2280;2306;0,0112749349522984;1,13
2020;"1421";"Kvinnor";0;50;1952;2002;0,024975024975025;2,5
2020;"1427";"Män";0;26;1900;1926;0,0134994807892004;1,35
2020;"1427";"Kvinnor";0;35;1717;1752;0,0199771689497717;2
2020;"1430";"Män";0;67;1748;1815;0,0369146005509642;3,69
2020;"1430";"Kvinnor";0;61;1664;1725;0,0353623188405797;3,54
2020;"1435";"Män";0;78;2395;2473;0,0315406389001213;3,15
2020;"1435";"Kvinnor";0;131;2088;2219;0,0590356016223524;5,9
2020;"1438";"Män";0;7;1148;1155;0,00606060606060606;0,61
2020;"1438";"Kvinnor";0;13;865;878;0,0148063781321185;1,48
2020;"1439";"Män";0;4;1040;1044;0,00383141762452107;0,38
2020;"1439";"Kvinnor";0;5;940;945;0,00529100529100529;0,53
2020;"1440";"Män";0;62;3534;3596;0,0172413793103448;1,72
2020;"1440";"Kvinnor";0;82;3486;3568;0,0229820627802691;2,3
2020;"1441";"Män";0;149;4256;4405;0,0338251986379115;3,38
2020;"1441";"Kvinnor";0;200;4987;5187;0,0385579332947754;3,86
2020;"1442";"Män";0;21;2972;2993;0,00701637153357835;0,7
2020;"1442";"Kvinnor";0;21;1883;1904;0,0110294117647059;1,1
2020;"1443";"Män";0;61;1233;1294;0,0471406491499227;4,71
2020;"1443";"Kvinnor";0;53;1072;1125;0,0471111111111111;4,71
2020;"1444";"Män";0;3;740;743;0,00403768506056528;0,4
2020;"1444";"Kvinnor";0;37;792;829;0,0446320868516285;4,46
2020;"1445";"Män";0;29;952;981;0,0295616717635066;2,96
2020;"1445";"Kvinnor";0;40;875;915;0,0437158469945355;4,37
2020;"1446";"Män";0;26;1647;1673;0,0155409444112373;1,55
2020;"1446";"Kvinnor";0;26;1102;1128;0,0230496453900709;2,3
2020;"1447";"Män";0;5;860;865;0,00578034682080925;0,58
2020;"1447";"Kvinnor";0;8;634;642;0,0124610591900312;1,25
2020;"1452";"Män";0;61;3363;3424;0,0178154205607477;1,78
2020;"1452";"Kvinnor";0;100;2151;2251;0,0444247001332741;4,44
2020;"1460";"Män";0;49;1928;1977;0,0247850278199292;2,48
2020;"1460";"Kvinnor";0;70;1728;1798;0,0389321468298109;3,89
2020;"1461";"Män";0;15;1542;1557;0,00963391136801541;0,96
2020;"1461";"Kvinnor";0;56;1338;1394;0,0401721664275466;4,02
2020;"1462";"Män";0;22;1828;1850;0,0118918918918919;1,19
2020;"1462";"Kvinnor";0;27;1771;1798;0,0150166852057842;1,5
2020;"1463";"Män";0;159;5206;5365;0,0296365330848089;2,96
2020;"1463";"Kvinnor";0;184;4865;5049;0,0364428599722717;3,64
2020;"1465";"Män";0;221;1669;1890;0,116931216931217;11,69
2020;"1465";"Kvinnor";0;197;1576;1773;0,111111111111111;11,11
2020;"1466";"Män";0;12;1975;1987;0,00603925515853045;0,6
2020;"1466";"Kvinnor";0;20;1405;1425;0,0140350877192982;1,4
2020;"1470";"Män";0;48;4347;4395;0,0109215017064846;1,09
2020;"1470";"Kvinnor";0;65;2870;2935;0,0221465076660988;2,21
2020;"1471";"Män";0;24;3452;3476;0,00690448791714614;0,69
2020;"1471";"Kvinnor";0;28;2374;2402;0,0116569525395504;1,17
2020;"1472";"Män";0;22;1667;1689;0,0130254588513914;1,3
2020;"1472";"Kvinnor";0;13;1644;1657;0,00784550392275196;0,78
2020;"1473";"Män";0;11;1698;1709;0,00643651258045641;0,64
2020;"1473";"Kvinnor";0;30;1443;1473;0,0203665987780041;2,04
2020;"1480";"Män";0;7014;176599;183613;0,0381999095924581;3,82
2020;"1480";"Kvinnor";0;9293;154427;163720;0,0567615440996824;5,68
2020;"1481";"Män";0;652;21126;21778;0,0299384700156121;2,99
2020;"1481";"Kvinnor";0;954;17851;18805;0,0507311885136932;5,07
2020;"1482";"Män";0;214;8507;8721;0,0245384703589038;2,45
2020;"1482";"Kvinnor";0;235;8287;8522;0,0275756864585778;2,76
2020;"1484";"Män";0;42;3014;3056;0,0137434554973822;1,37
2020;"1484";"Kvinnor";0;61;2467;2528;0,024129746835443;2,41
2020;"1485";"Män";0;281;11522;11803;0,0238075065661273;2,38
2020;"1485";"Kvinnor";0;486;11314;11800;0,0411864406779661;4,12
2020;"1486";"Män";0;47;2538;2585;0,0181818181818182;1,82
2020;"1486";"Kvinnor";0;167;2499;2666;0,0626406601650413;6,26
2020;"1487";"Män";0;157;6069;6226;0,0252168326373273;2,52
2020;"1487";"Kvinnor";0;194;6466;6660;0,0291291291291291;2,91
2020;"1488";"Män";0;279;13478;13757;0,0202805844297449;2,03
2020;"1488";"Kvinnor";0;402;13000;13402;0,0299955230562603;3
2020;"1489";"Män";0;211;6903;7114;0,0296598256958111;2,97
2020;"1489";"Kvinnor";0;254;7576;7830;0,0324393358876117;3,24
2020;"1490";"Män";0;2113;25288;27401;0,0771139739425568;7,71
2020;"1490";"Kvinnor";0;2815;24279;27094;0,103897541891194;10,39
2020;"1491";"Män";0;236;4654;4890;0,0482617586912065;4,83
2020;"1491";"Kvinnor";0;381;3723;4104;0,0928362573099415;9,28
2020;"1492";"Män";0;31;2120;2151;0,0144119014411901;1,44
2020;"1492";"Kvinnor";0;54;1924;1978;0,0273003033367037;2,73
2020;"1493";"Män";0;84;4501;4585;0,0183206106870229;1,83
2020;"1493";"Kvinnor";0;104;3989;4093;0,0254092352797459;2,54
2020;"1494";"Män";0;200;8801;9001;0,0222197533607377;2,22
2020;"1494";"Kvinnor";0;242;7912;8154;0,0296786853078244;2,97
2020;"1495";"Män";0;77;4169;4246;0,0181347150259067;1,81
2020;"1495";"Kvinnor";0;102;3606;3708;0,0275080906148867;2,75
2020;"1496";"Män";0;429;16988;17417;0,0246311075386117;2,46
2020;"1496";"Kvinnor";0;399;14973;15372;0,0259562841530055;2,6
2020;"1497";"Män";0;17;1327;1344;0,0126488095238095;1,26
2020;"1497";"Kvinnor";0;23;1388;1411;0,0163004961020553;1,63
2020;"1498";"Män";0;46;2285;2331;0,0197340197340197;1,97
2020;"1498";"Kvinnor";0;57;1991;2048;0,02783203125;2,78
2020;"1499";"Män";0;96;6325;6421;0,0149509422208379;1,5
2020;"1499";"Kvinnor";0;120;5486;5606;0,0214056368176953;2,14
2020;"1715";"Män";0;29;1684;1713;0,0169293636894337;1,69
2020;"1715";"Kvinnor";0;29;1384;1413;0,0205237084217976;2,05
2020;"1730";"Män";0;8;1544;1552;0,00515463917525773;0,52
2020;"1730";"Kvinnor";0;108;1636;1744;0,0619266055045872;6,19
2020;"1737";"Män";0;28;2344;2372;0,0118043844856661;1,18
2020;"1737";"Kvinnor";0;39;2275;2314;0,0168539325842697;1,69
2020;"1760";"Män";0;5;491;496;0,0100806451612903;1,01
2020;"1760";"Kvinnor";0;3;418;421;0,00712589073634204;0,71
2020;"1761";"Män";0;30;1899;1929;0,015552099533437;1,56
2020;"1761";"Kvinnor";0;47;1849;1896;0,024789029535865;2,48
2020;"1762";"Män";0;9;783;792;0,0113636363636364;1,14
2020;"1762";"Kvinnor";0;8;690;698;0,0114613180515759;1,15
2020;"1763";"Män";0;12;1009;1021;0,0117531831537708;1,18
2020;"1763";"Kvinnor";0;24;1368;1392;0,0172413793103448;1,72
2020;"1764";"Män";0;9;1981;1990;0,00452261306532663;0,45
2020;"1764";"Kvinnor";0;15;1238;1253;0,0119712689545092;1,2
2020;"1765";"Män";0;19;1837;1856;0,0102370689655172;1,02
2020;"1765";"Kvinnor";0;72;1667;1739;0,0414031052328925;4,14
2020;"1766";"Män";0;129;2472;2601;0,04959630911188;4,96
2020;"1766";"Kvinnor";0;123;2111;2234;0,0550581915846016;5,51
2020;"1780";"Män";0;780;25711;26491;0,029443962100336;2,94
2020;"1780";"Kvinnor";0;948;23987;24935;0,0380188490074193;3,8
2020;"1781";"Män";0;50;4187;4237;0,0118008024545669;1,18
2020;"1781";"Kvinnor";0;96;3405;3501;0,0274207369323051;2,74
2020;"1782";"Män";0;16;1632;1648;0,00970873786407767;0,97
2020;"1782";"Kvinnor";0;39;1497;1536;0,025390625;2,54
2020;"1783";"Män";0;17;2304;2321;0,00732442912537699;0,73
2020;"1783";"Kvinnor";0;40;1743;1783;0,0224340998317443;2,24
2020;"1784";"Män";0;88;5173;5261;0,0167268580117848;1,67
2020;"1784";"Kvinnor";0;125;4728;4853;0,0257572635483206;2,58
2020;"1785";"Män";0;23;2854;2877;0,00799443865137296;0,8
2020;"1785";"Kvinnor";0;51;2483;2534;0,0201262825572218;2,01
2020;"1814";"Män";0;9;1027;1036;0,00868725868725869;0,87
2020;"1814";"Kvinnor";0;17;1003;1020;0,0166666666666667;1,67
2020;"1860";"Män";0;2;1220;1222;0,0016366612111293;0,16
2020;"1860";"Kvinnor";0;11;818;829;0,0132689987937274;1,33
2020;"1861";"Män";0;47;4055;4102;0,0114578254509995;1,15
2020;"1861";"Kvinnor";0;38;3142;3180;0,0119496855345912;1,19
2020;"1862";"Män";0;5;1350;1355;0,003690036900369;0,37
2020;"1862";"Kvinnor";0;17;1121;1138;0,0149384885764499;1,49
2020;"1863";"Män";0;14;1243;1257;0,0111376292760541;1,11
2020;"1863";"Kvinnor";0;21;1072;1093;0,0192131747483989;1,92
2020;"1864";"Män";0;13;782;795;0,0163522012578616;1,64
2020;"1864";"Kvinnor";0;11;706;717;0,0153417015341702;1,53
2020;"1880";"Män";0;1118;39676;40794;0,0274059910771192;2,74
2020;"1880";"Kvinnor";0;1316;37225;38541;0,0341454554889598;3,41
2020;"1881";"Män";0;80;3372;3452;0,0231749710312862;2,32
2020;"1881";"Kvinnor";0;81;3146;3227;0,0251007127362876;2,51
2020;"1882";"Män";0;21;2200;2221;0,00945520036019811;0,95
2020;"1882";"Kvinnor";0;50;1601;1651;0,0302846759539673;3,03
2020;"1883";"Män";0;125;7102;7227;0,0172962501729625;1,73
2020;"1883";"Kvinnor";0;158;6111;6269;0,0252033817195725;2,52
2020;"1884";"Män";0;32;1384;1416;0,0225988700564972;2,26
2020;"1884";"Kvinnor";0;61;1455;1516;0,0402374670184697;4,02
2020;"1885";"Män";0;43;4857;4900;0,00877551020408163;0,88
2020;"1885";"Kvinnor";0;63;4461;4524;0,0139257294429708;1,39
2020;"1904";"Män";0;5;787;792;0,00631313131313131;0,63
2020;"1904";"Kvinnor";0;14;602;616;0,0227272727272727;2,27
2020;"1907";"Män";0;3;1302;1305;0,00229885057471264;0,23
2020;"1907";"Kvinnor";0;13;1110;1123;0,0115761353517364;1,16
2020;"1960";"Män";0;17;1302;1319;0,0128885519332828;1,29
2020;"1960";"Kvinnor";0;14;1036;1050;0,0133333333333333;1,33
2020;"1961";"Män";0;28;2390;2418;0,0115798180314309;1,16
2020;"1961";"Kvinnor";0;14;2413;2427;0,0057684384013185;0,58
2020;"1962";"Män";0;10;789;799;0,0125156445556946;1,25
2020;"1962";"Kvinnor";0;13;746;759;0,0171277997364954;1,71
2020;"1980";"Män";0;961;36246;37207;0,0258284731367753;2,58
2020;"1980";"Kvinnor";0;1132;33282;34414;0,0328935898180973;3,29
2020;"1981";"Män";0;74;3686;3760;0,0196808510638298;1,97
2020;"1981";"Kvinnor";0;96;3625;3721;0,0257995162590701;2,58
2020;"1982";"Män";0;23;3250;3273;0,00702719217842958;0,7
2020;"1982";"Kvinnor";0;40;2685;2725;0,0146788990825688;1,47
2020;"1983";"Män";0;76;5929;6005;0,0126561199000833;1,27
2020;"1983";"Kvinnor";0;95;5127;5222;0,0181922635005745;1,82
2020;"1984";"Män";0;21;2437;2458;0,00854353132628153;0,85
2020;"1984";"Kvinnor";0;35;1957;1992;0,017570281124498;1,76
2020;"2021";"Män";0;10;1414;1424;0,00702247191011236;0,7
2020;"2021";"Kvinnor";0;24;1221;1245;0,0192771084337349;1,93
2020;"2023";"Män";0;37;2622;2659;0,0139150056412185;1,39
2020;"2023";"Kvinnor";0;44;2299;2343;0,0187793427230047;1,88
2020;"2026";"Män";0;18;1254;1272;0,0141509433962264;1,42
2020;"2026";"Kvinnor";0;14;1367;1381;0,0101375814627082;1,01
2020;"2029";"Män";0;173;3065;3238;0,0534280420012353;5,34
2020;"2029";"Kvinnor";0;147;2697;2844;0,0516877637130802;5,17
2020;"2031";"Män";0;70;1629;1699;0,0412007062978222;4,12
2020;"2031";"Kvinnor";0;71;1609;1680;0,0422619047619048;4,23
2020;"2034";"Män";0;33;1167;1200;0,0275;2,75
2020;"2034";"Kvinnor";0;21;950;971;0,0216271884654995;2,16
2020;"2039";"Män";0;18;1478;1496;0,0120320855614973;1,2
2020;"2039";"Kvinnor";0;20;1206;1226;0,0163132137030995;1,63
2020;"2061";"Män";0;18;1552;1570;0,0114649681528662;1,15
2020;"2061";"Kvinnor";0;22;1168;1190;0,0184873949579832;1,85
2020;"2062";"Män";0;84;5009;5093;0,0164932259964657;1,65
2020;"2062";"Kvinnor";0;153;4618;4771;0,0320687486900021;3,21
2020;"2080";"Män";0;574;11834;12408;0,0462604771115409;4,63
2020;"2080";"Kvinnor";0;572;13321;13893;0,0411718131433096;4,12
2020;"2081";"Män";0;144;14648;14792;0,00973499188750676;0,97
2020;"2081";"Kvinnor";0;314;11170;11484;0,0273423894113549;2,73
2020;"2082";"Män";0;17;1424;1441;0,0117973629424011;1,18
2020;"2082";"Kvinnor";0;36;1513;1549;0,0232408005164622;2,32
2020;"2083";"Män";0;55;3242;3297;0,0166818319684562;1,67
2020;"2083";"Kvinnor";0;66;2668;2734;0,0241404535479151;2,41
2020;"2084";"Män";0;82;5263;5345;0,0153414405986904;1,53
2020;"2084";"Kvinnor";0;135;4084;4219;0,0319981038160702;3,2
2020;"2085";"Män";0;39;6319;6358;0,0061340044039006;0,61
2020;"2085";"Kvinnor";0;62;4922;4984;0,0124398073836276;1,24
2020;"2101";"Män";0;14;840;854;0,0163934426229508;1,64
2020;"2101";"Kvinnor";0;10;753;763;0,0131061598951507;1,31
2020;"2104";"Män";0;14;1852;1866;0,007502679528403;0,75
2020;"2104";"Kvinnor";0;15;1294;1309;0,0114591291061879;1,15
2020;"2121";"Män";0;20;2849;2869;0,0069710700592541;0,7
2020;"2121";"Kvinnor";0;46;2056;2102;0,021883920076118;2,19
2020;"2132";"Män";0;19;1393;1412;0,0134560906515581;1,35
2020;"2132";"Kvinnor";0;28;1193;1221;0,0229320229320229;2,29
2020;"2161";"Män";0;119;3565;3684;0,0323018458197611;3,23
2020;"2161";"Kvinnor";0;171;3169;3340;0,0511976047904192;5,12
2020;"2180";"Män";0;627;22764;23391;0,0268051814800564;2,68
2020;"2180";"Kvinnor";0;766;22064;22830;0,0335523434077968;3,36
2020;"2181";"Män";0;83;8888;8971;0,0092520343328503;0,93
2020;"2181";"Kvinnor";0;153;6396;6549;0,0233623453962437;2,34
2020;"2182";"Män";0;80;4724;4804;0,0166527893422148;1,67
2020;"2182";"Kvinnor";0;132;3813;3945;0,0334600760456274;3,35
2020;"2183";"Män";0;135;4948;5083;0,0265591186307299;2,66
2020;"2183";"Kvinnor";0;127;5071;5198;0,0244324740284725;2,44
2020;"2184";"Män";0;157;7989;8146;0,0192732629511417;1,93
2020;"2184";"Kvinnor";0;192;7472;7664;0,0250521920668058;2,51
2020;"2260";"Män";0;45;1883;1928;0,0233402489626556;2,33
2020;"2260";"Kvinnor";0;60;1493;1553;0,0386349001931745;3,86
2020;"2262";"Män";0;22;3129;3151;0,00698191050460171;0,7
2020;"2262";"Kvinnor";0;24;2063;2087;0,0114997604216579;1,15
2020;"2280";"Män";0;144;4141;4285;0,0336056009334889;3,36
2020;"2280";"Kvinnor";0;183;4380;4563;0,0401051939513478;4,01
2020;"2281";"Män";0;503;24318;24821;0,0202650981024133;2,03
2020;"2281";"Kvinnor";0;788;22655;23443;0,0336134453781513;3,36
2020;"2282";"Män";0;32;3870;3902;0,00820092260379293;0,82
2020;"2282";"Kvinnor";0;47;3026;3073;0,0152945004881224;1,53
2020;"2283";"Män";0;60;3540;3600;0,0166666666666667;1,67
2020;"2283";"Kvinnor";0;79;3217;3296;0,0239684466019417;2,4
2020;"2284";"Män";0;237;12060;12297;0,0192729934130276;1,93
2020;"2284";"Kvinnor";0;352;9988;10340;0,0340425531914894;3,4
2020;"2303";"Män";0;8;1074;1082;0,00739371534195933;0,74
2020;"2303";"Kvinnor";0;9;873;882;0,0102040816326531;1,02
2020;"2305";"Män";0;20;1071;1091;0,0183318056828598;1,83
2020;"2305";"Kvinnor";0;22;834;856;0,0257009345794393;2,57
2020;"2309";"Män";0;25;2344;2369;0,0105529759392149;1,06
2020;"2309";"Kvinnor";0;21;1889;1910;0,0109947643979058;1,1
2020;"2313";"Män";0;10;2384;2394;0,00417710944026733;0,42
2020;"2313";"Kvinnor";0;26;1950;1976;0,0131578947368421;1,32
2020;"2321";"Män";0;92;2689;2781;0,033081625314635;3,31
2020;"2321";"Kvinnor";0;103;2296;2399;0,0429345560650271;4,29
2020;"2326";"Män";0;14;1259;1273;0,0109976433621367;1,1
2020;"2326";"Kvinnor";0;9;1085;1094;0,00822669104204753;0,82
2020;"2361";"Män";0;12;2212;2224;0,00539568345323741;0,54
2020;"2361";"Kvinnor";0;14;1998;2012;0,00695825049701789;0,7
2020;"2380";"Män";0;554;15766;16320;0,0339460784313725;3,39
2020;"2380";"Kvinnor";0;633;15901;16534;0,0382847465827991;3,83
2020;"2401";"Män";0;24;965;989;0,0242669362992922;2,43
2020;"2401";"Kvinnor";0;21;896;917;0,0229007633587786;2,29
2020;"2403";"Män";0;4;312;316;0,0126582278481013;1,27
2020;"2403";"Kvinnor";0;6;358;364;0,0164835164835165;1,65
2020;"2404";"Män";0;18;1157;1175;0,0153191489361702;1,53
2020;"2404";"Kvinnor";0;12;862;874;0,0137299771167048;1,37
2020;"2409";"Män";0;12;974;986;0,0121703853955375;1,22
2020;"2409";"Kvinnor";0;5;942;947;0,00527983104540655;0,53
2020;"2417";"Män";0;9;778;787;0,01143583227446;1,14
2020;"2417";"Kvinnor";0;13;681;694;0,0187319884726225;1,87
2020;"2418";"Män";0;1;638;639;0,00156494522691706;0,16
2020;"2418";"Kvinnor";0;14;489;503;0,0278330019880716;2,78
2020;"2421";"Män";0;10;1266;1276;0,00783699059561128;0,78
2020;"2421";"Kvinnor";0;20;1083;1103;0,0181323662737987;1,81
2020;"2422";"Män";0;2;484;486;0,00411522633744856;0,41
2020;"2422";"Kvinnor";0;4;413;417;0,00959232613908873;0,96
2020;"2425";"Män";0;3;493;496;0,00604838709677419;0,6
2020;"2425";"Kvinnor";0;7;434;441;0,0158730158730159;1,59
2020;"2460";"Män";0;8;1246;1254;0,00637958532695375;0,64
2020;"2460";"Kvinnor";0;15;1141;1156;0,0129757785467128;1,3
2020;"2462";"Män";0;20;1156;1176;0,0170068027210884;1,7
2020;"2462";"Kvinnor";0;19;1172;1191;0,0159529806884971;1,6
2020;"2463";"Män";0;3;491;494;0,00607287449392713;0,61
2020;"2463";"Kvinnor";0;13;445;458;0,0283842794759825;2,84
2020;"2480";"Män";0;980;31766;32746;0,029927319367251;2,99
2020;"2480";"Kvinnor";0;1188;29488;30676;0,0387273438518712;3,87
2020;"2481";"Män";0;29;2913;2942;0,00985723997280761;0,99
2020;"2481";"Kvinnor";0;57;2692;2749;0,0207348126591488;2,07
2020;"2482";"Män";0;317;16953;17270;0,018355529820498;1,84
2020;"2482";"Kvinnor";0;404;13805;14209;0,0284326835104511;2,84
2020;"2505";"Män";0;14;1055;1069;0,0130963517305893;1,31
2020;"2505";"Kvinnor";0;23;1093;1116;0,0206093189964158;2,06
2020;"2506";"Män";0;4;719;723;0,00553250345781466;0,55
2020;"2506";"Kvinnor";0;16;540;556;0,0287769784172662;2,88
2020;"2510";"Män";0;29;959;988;0,0293522267206478;2,94
2020;"2510";"Kvinnor";0;48;822;870;0,0551724137931034;5,52
2020;"2513";"Män";0;5;672;677;0,00738552437223043;0,74
2020;"2513";"Kvinnor";0;10;577;587;0,0170357751277683;1,7
2020;"2514";"Män";0;46;2915;2961;0,0155352921310368;1,55
2020;"2514";"Kvinnor";0;75;2654;2729;0,0274825943569073;2,75
2020;"2518";"Män";0;16;698;714;0,0224089635854342;2,24
2020;"2518";"Kvinnor";0;17;594;611;0,027823240589198;2,78
2020;"2521";"Män";0;29;1172;1201;0,0241465445462115;2,41
2020;"2521";"Kvinnor";0;17;876;893;0,019036954087346;1,9
2020;"2523";"Män";0;56;4889;4945;0,011324570273003;1,13
2020;"2523";"Kvinnor";0;60;3655;3715;0,0161507402422611;1,62
2020;"2560";"Män";0;6;1343;1349;0,0044477390659748;0,44
2020;"2560";"Kvinnor";0;22;1249;1271;0,017309205350118;1,73
2020;"2580";"Män";0;565;20955;21520;0,0262546468401487;2,63
2020;"2580";"Kvinnor";0;775;18328;19103;0,0405695440506727;4,06
2020;"2581";"Män";0;132;8674;8806;0,014989779695662;1,5
2020;"2581";"Kvinnor";0;221;7467;7688;0,0287460978147763;2,87
2020;"2582";"Män";0;70;5281;5351;0,0130816669781349;1,31
2020;"2582";"Kvinnor";0;85;4550;4635;0,0183387270765912;1,83
2020;"2583";"Män";0;17;1417;1434;0,0118549511854951;1,19
2020;"2583";"Kvinnor";0;29;1449;1478;0,0196211096075778;1,96
2020;"2584";"Män";0;80;6587;6667;0,0119994000299985;1,2
2020;"2584";"Kvinnor";0;157;5023;5180;0,0303088803088803;3,03
2020;"9999";"Män";0;1831;169354;171185;0,0106960306101586;1,07
2020;"9999";"Kvinnor";0;2300;188617;190917;0,0120471199526496;1,2
2021;"0114";"Män";0;162;7458;7620;0,021259842519685;2,13
2021;"0114";"Kvinnor";0;180;6621;6801;0,0264666960741067;2,65
2021;"0115";"Män";0;86;4485;4571;0,0188142638372347;1,88
2021;"0115";"Kvinnor";0;117;3934;4051;0,0288817575907183;2,89
2021;"0117";"Män";0;159;5346;5505;0,0288828337874659;2,89
2021;"0117";"Kvinnor";0;207;5301;5508;0,0375816993464052;3,76
2021;"0120";"Män";0;224;5918;6142;0,0364702051449039;3,65
2021;"0120";"Kvinnor";0;259;5471;5730;0,0452006980802792;4,52
2021;"0123";"Män";0;379;14754;15133;0,0250446045067072;2,5
2021;"0123";"Kvinnor";0;515;10446;10961;0,0469847641638537;4,7
2021;"0125";"Män";0;109;3839;3948;0,0276089159067882;2,76
2021;"0125";"Kvinnor";0;144;3860;4004;0,035964035964036;3,6
2021;"0126";"Män";0;450;22551;23001;0,0195643667666623;1,96
2021;"0126";"Kvinnor";0;519;22983;23502;0,0220832269594077;2,21
2021;"0127";"Män";0;399;12850;13249;0,0301154804136161;3,01
2021;"0127";"Kvinnor";0;447;9838;10285;0,0434613514827419;4,35
2021;"0128";"Män";0;56;1194;1250;0,0448;4,48
2021;"0128";"Kvinnor";0;54;1513;1567;0,0344607530312699;3,45
2021;"0136";"Män";0;346;16794;17140;0,0201866977829638;2,02
2021;"0136";"Kvinnor";0;343;12498;12841;0,0267113153181216;2,67
2021;"0138";"Män";0;189;5548;5737;0,0329440474115391;3,29
2021;"0138";"Kvinnor";0;227;5075;5302;0,0428140324405885;4,28
2021;"0139";"Män";0;59;7022;7081;0,00833215647507414;0,83
2021;"0139";"Kvinnor";0;49;4275;4324;0,0113320999074931;1,13
2021;"0140";"Män";0;12;1629;1641;0,00731261425959781;0,73
2021;"0140";"Kvinnor";0;17;1278;1295;0,0131274131274131;1,31
2021;"0160";"Män";0;522;12510;13032;0,0400552486187845;4,01
2021;"0160";"Kvinnor";0;695;11065;11760;0,0590986394557823;5,91
2021;"0162";"Män";0;206;7884;8090;0,0254635352286774;2,55
2021;"0162";"Kvinnor";0;292;11264;11556;0,0252682589131187;2,53
2021;"0163";"Män";0;327;12745;13072;0,025015299877601;2,5
2021;"0163";"Kvinnor";0;405;11887;12292;0,0329482590302636;3,29
2021;"0180";"Män";0;31764;325559;357323;0,0888943616839666;8,89
2021;"0180";"Kvinnor";0;36654;300854;337508;0,108601870177892;10,86
2021;"0181";"Män";0;437;29510;29947;0,0145924466557585;1,46
2021;"0181";"Kvinnor";0;475;21828;22303;0,0212975832847599;2,13
2021;"0182";"Män";0;881;16199;17080;0,0515807962529274;5,16
2021;"0182";"Kvinnor";0;1070;16110;17180;0,0622817229336438;6,23
2021;"0183";"Män";0;288;11917;12205;0,0235968865219172;2,36
2021;"0183";"Kvinnor";0;268;12284;12552;0,0213511790949649;2,14
2021;"0184";"Män";0;1021;52412;53433;0,0191080418467988;1,91
2021;"0184";"Kvinnor";0;1409;51017;52426;0,0268759775683821;2,69
2021;"0186";"Män";0;316;5101;5417;0,0583348717002031;5,83
2021;"0186";"Kvinnor";0;351;5696;6047;0,0580453117248222;5,8
2021;"0187";"Män";0;54;1266;1320;0,0409090909090909;4,09
2021;"0187";"Kvinnor";0;62;1290;1352;0,0458579881656805;4,59
2021;"0188";"Män";0;234;10771;11005;0,0212630622444343;2,13
2021;"0188";"Kvinnor";0;294;10932;11226;0,0261892036344201;2,62
2021;"0191";"Män";0;156;14650;14806;0,0105362690801027;1,05
2021;"0191";"Kvinnor";0;231;9792;10023;0,0230469919185873;2,3
2021;"0192";"Män";0;64;3277;3341;0,0191559413349297;1,92
2021;"0192";"Kvinnor";0;98;3515;3613;0,027124273456961;2,71
2021;"0305";"Män";0;58;2915;2973;0,0195089135553313;1,95
2021;"0305";"Kvinnor";0;98;2699;2797;0,0350375402216661;3,5
2021;"0319";"Män";0;15;1287;1302;0,0115207373271889;1,15
2021;"0319";"Kvinnor";0;23;1125;1148;0,0200348432055749;2
2021;"0330";"Män";0;50;2022;2072;0,0241312741312741;2,41
2021;"0330";"Kvinnor";0;47;2044;2091;0,0224772835963654;2,25
2021;"0331";"Män";0;356;2238;2594;0,137239784117194;13,72
2021;"0331";"Kvinnor";0;240;1964;2204;0,108892921960073;10,89
2021;"0360";"Män";0;49;3502;3551;0,0137989298789073;1,38
2021;"0360";"Kvinnor";0;54;2877;2931;0,0184237461617195;1,84
2021;"0380";"Män";0;1747;50058;51805;0,0337226136473313;3,37
2021;"0380";"Kvinnor";0;2034;52553;54587;0,0372616190668108;3,73
2021;"0381";"Män";0;145;9202;9347;0,0155129988231518;1,55
2021;"0381";"Kvinnor";0;161;8078;8239;0,0195412064570943;1,95
2021;"0382";"Män";0;29;5122;5151;0,0056299747621821;0,56
2021;"0382";"Kvinnor";0;48;3772;3820;0,012565445026178;1,26
2021;"0428";"Män";0;68;1359;1427;0,0476524176594254;4,77
2021;"0428";"Kvinnor";0;115;1163;1278;0,0899843505477308;9
2021;"0461";"Män";0;36;1257;1293;0,0278422273781903;2,78
2021;"0461";"Kvinnor";0;62;1366;1428;0,0434173669467787;4,34
2021;"0480";"Män";0;242;10426;10668;0,0226846644169479;2,27
2021;"0480";"Kvinnor";0;347;11555;11902;0,029154763905226;2,92
2021;"0481";"Män";0;26;3053;3079;0,00844430009743423;0,84
2021;"0481";"Kvinnor";0;28;1810;1838;0,015233949945593;1,52
2021;"0482";"Män";0;28;2626;2654;0,0105501130369254;1,06
2021;"0482";"Kvinnor";0;50;2301;2351;0,0212675457252233;2,13
2021;"0483";"Män";0;146;6986;7132;0,0204711160964666;2,05
2021;"0483";"Kvinnor";0;149;6567;6716;0,0221858248957713;2,22
2021;"0484";"Män";0;586;21658;22244;0,0263441827009531;2,63
2021;"0484";"Kvinnor";0;792;20684;21476;0,0368783758614267;3,69
2021;"0486";"Män";0;131;5544;5675;0,0230837004405286;2,31
2021;"0486";"Kvinnor";0;209;5197;5406;0,038660747317795;3,87
2021;"0488";"Män";0;49;2038;2087;0,0234786775275515;2,35
2021;"0488";"Kvinnor";0;77;2036;2113;0,036441079034548;3,64
2021;"0509";"Män";0;27;765;792;0,0340909090909091;3,41
2021;"0509";"Kvinnor";0;20;680;700;0,0285714285714286;2,86
2021;"0512";"Män";0;6;597;603;0,00995024875621891;1
2021;"0512";"Kvinnor";0;17;432;449;0,0378619153674833;3,79
2021;"0513";"Män";0;27;1654;1681;0,0160618679357525;1,61
2021;"0513";"Kvinnor";0;23;1532;1555;0,0147909967845659;1,48
2021;"0560";"Män";0;10;941;951;0,010515247108307;1,05
2021;"0560";"Kvinnor";0;10;617;627;0,0159489633173844;1,59
2021;"0561";"Män";0;38;1627;1665;0,0228228228228228;2,28
2021;"0561";"Kvinnor";0;34;1312;1346;0,025260029717682;2,53
2021;"0562";"Män";0;34;5228;5262;0,0064614215127328;0,65
2021;"0562";"Kvinnor";0;49;3640;3689;0,0132827324478178;1,33
2021;"0563";"Män";0;13;1286;1299;0,0100076982294072;1
2021;"0563";"Kvinnor";0;19;956;975;0,0194871794871795;1,95
2021;"0580";"Män";0;844;45281;46125;0,0182981029810298;1,83
2021;"0580";"Kvinnor";0;1099;40754;41853;0,0262585716675029;2,63
2021;"0581";"Män";0;881;33297;34178;0,0257768154953479;2,58
2021;"0581";"Kvinnor";0;1065;30522;31587;0,0337164023174091;3,37
2021;"0582";"Män";0;47;1955;2002;0,0234765234765235;2,35
2021;"0582";"Kvinnor";0;50;1910;1960;0,0255102040816327;2,55
2021;"0583";"Män";0;123;6866;6989;0,0175990842752897;1,76
2021;"0583";"Kvinnor";0;154;7100;7254;0,0212296663909567;2,12
2021;"0584";"Män";0;43;1469;1512;0,0284391534391534;2,84
2021;"0584";"Kvinnor";0;53;1299;1352;0,0392011834319527;3,92
2021;"0586";"Män";0;45;7407;7452;0,00603864734299517;0,6
2021;"0586";"Kvinnor";0;89;4740;4829;0,0184303168357838;1,84
2021;"0604";"Män";0;9;1200;1209;0,00744416873449132;0,74
2021;"0604";"Kvinnor";0;19;1026;1045;0,0181818181818182;1,82
2021;"0617";"Män";0;77;3737;3814;0,0201887781856319;2,02
2021;"0617";"Kvinnor";0;96;2486;2582;0,0371804802478699;3,72
2021;"0642";"Män";0;7;1236;1243;0,00563153660498793;0,56
2021;"0642";"Kvinnor";0;41;1185;1226;0,033442088091354;3,34
2021;"0643";"Män";0;30;1861;1891;0,0158646218931782;1,59
2021;"0643";"Kvinnor";0;37;1620;1657;0,0223295111647556;2,23
2021;"0662";"Män";0;62;8263;8325;0,00744744744744745;0,74
2021;"0662";"Kvinnor";0;117;6085;6202;0,0188648822960335;1,89
2021;"0665";"Män";0;23;2891;2914;0,00789293067947838;0,79
2021;"0665";"Kvinnor";0;35;2217;2252;0,0155417406749556;1,55
2021;"0680";"Män";0;966;38423;39389;0,024524613470766;2,45
2021;"0680";"Kvinnor";0;1157;34154;35311;0,0327659935997281;3,28
2021;"0682";"Män";0;94;6759;6853;0,0137166204581935;1,37
2021;"0682";"Kvinnor";0;105;5490;5595;0,0187667560321716;1,88
2021;"0683";"Män";0;140;8612;8752;0,0159963436928702;1,6
2021;"0683";"Kvinnor";0;208;7955;8163;0,0254808281269141;2,55
2021;"0684";"Män";0;25;2473;2498;0,0100080064051241;1
2021;"0684";"Kvinnor";0;65;1840;1905;0,0341207349081365;3,41
2021;"0685";"Män";0;74;6614;6688;0,0110645933014354;1,11
2021;"0685";"Kvinnor";0;104;4746;4850;0,0214432989690722;2,14
2021;"0686";"Män";0;51;4555;4606;0,0110725141120278;1,11
2021;"0686";"Kvinnor";0;88;4588;4676;0,018819503849444;1,88
2021;"0687";"Män";0;87;4379;4466;0,0194805194805195;1,95
2021;"0687";"Kvinnor";0;84;3701;3785;0,0221928665785997;2,22
2021;"0760";"Män";0;15;2954;2969;0,0050522061300101;0,51
2021;"0760";"Kvinnor";0;11;1800;1811;0,00607399226946438;0,61
2021;"0761";"Män";0;14;1131;1145;0,0122270742358079;1,22
2021;"0761";"Kvinnor";0;45;1113;1158;0,038860103626943;3,89
2021;"0763";"Män";0;32;3000;3032;0,0105540897097625;1,06
2021;"0763";"Kvinnor";0;31;2419;2450;0,0126530612244898;1,27
2021;"0764";"Män";0;36;4006;4042;0,00890648193963384;0,89
2021;"0764";"Kvinnor";0;53;3087;3140;0,0168789808917197;1,69
2021;"0765";"Män";0;1548;4214;5762;0,26865671641791;26,87
2021;"0765";"Kvinnor";0;1658;3632;5290;0,313421550094518;31,34
2021;"0767";"Män";0;56;3459;3515;0,0159317211948791;1,59
2021;"0767";"Kvinnor";0;53;2112;2165;0,0244803695150115;2,45
2021;"0780";"Män";0;763;24135;24898;0,0306450317294562;3,06
2021;"0780";"Kvinnor";0;848;21761;22609;0,0375071874032465;3,75
2021;"0781";"Män";0;293;6552;6845;0,0428049671292915;4,28
2021;"0781";"Kvinnor";0;188;5501;5689;0,0330462295658288;3,3
2021;"0821";"Män";0;8;701;709;0,0112834978843441;1,13
2021;"0821";"Kvinnor";0;6;762;768;0,0078125;0,78
2021;"0834";"Män";0;8;1186;1194;0,0067001675041876;0,67
2021;"0834";"Kvinnor";0;15;968;983;0,0152594099694812;1,53
2021;"0840";"Män";0;48;2345;2393;0,0200585039699122;2,01
2021;"0840";"Kvinnor";0;79;2353;2432;0,0324835526315789;3,25
2021;"0860";"Män";0;16;2656;2672;0,00598802395209581;0,6
2021;"0860";"Kvinnor";0;24;2191;2215;0,0108352144469526;1,08
2021;"0861";"Män";0;22;2309;2331;0,00943800943800944;0,94
2021;"0861";"Kvinnor";0;44;1916;1960;0,0224489795918367;2,24
2021;"0862";"Män";0;31;2466;2497;0,0124148978774529;1,24
2021;"0862";"Kvinnor";0;38;1654;1692;0,0224586288416076;2,25
2021;"0880";"Män";0;640;17251;17891;0,0357721759543905;3,58
2021;"0880";"Kvinnor";0;789;16936;17725;0,0445133991537377;4,45
2021;"0881";"Män";0;39;3962;4001;0,00974756310922269;0,97
2021;"0881";"Kvinnor";0;60;3426;3486;0,0172117039586919;1,72
2021;"0882";"Män";0;63;7634;7697;0,00818500714564116;0,82
2021;"0882";"Kvinnor";0;104;5731;5835;0,0178234790059983;1,78
2021;"0883";"Män";0;114;7210;7324;0,0155652648825778;1,56
2021;"0883";"Kvinnor";0;161;6889;7050;0,0228368794326241;2,28
2021;"0884";"Män";0;275;3783;4058;0,0677673730901922;6,78
2021;"0884";"Kvinnor";0;315;2965;3280;0,0960365853658537;9,6
2021;"0885";"Män";0;53;1852;1905;0,0278215223097113;2,78
2021;"0885";"Kvinnor";0;80;1657;1737;0,0460564191134139;4,61
2021;"0980";"Män";0;398;12962;13360;0,0297904191616766;2,98
2021;"0980";"Kvinnor";0;506;12451;12957;0,0390522497491703;3,91
2021;"1060";"Män";0;28;4190;4218;0,00663821716453295;0,66
2021;"1060";"Kvinnor";0;31;2413;2444;0,012684124386252;1,27
2021;"1080";"Män";0;377;15791;16168;0,0233176645225136;2,33
2021;"1080";"Kvinnor";0;414;13776;14190;0,0291754756871036;2,92
2021;"1081";"Män";0;76;5228;5304;0,0143288084464555;1,43
2021;"1081";"Kvinnor";0;78;4228;4306;0,0181142591732466;1,81
2021;"1082";"Män";0;123;6101;6224;0,0197622107969152;1,98
2021;"1082";"Kvinnor";0;135;5988;6123;0,0220480156785889;2,2
2021;"1083";"Män";0;58;3098;3156;0,0183776932826362;1,84
2021;"1083";"Kvinnor";0;70;2529;2599;0,0269334359368988;2,69
2021;"1214";"Män";0;22;1874;1896;0,0116033755274262;1,16
2021;"1214";"Kvinnor";0;38;1904;1942;0,01956745623069;1,96
2021;"1230";"Män";0;59;3820;3879;0,0152101056973447;1,52
2021;"1230";"Kvinnor";0;44;2875;2919;0,0150736553614251;1,51
2021;"1231";"Män";0;57;5430;5487;0,010388190267906;1,04
2021;"1231";"Kvinnor";0;112;3206;3318;0,0337552742616034;3,38
2021;"1233";"Män";0;138;4043;4181;0,0330064577852188;3,3
2021;"1233";"Kvinnor";0;164;4437;4601;0,0356444251249728;3,56
2021;"1256";"Män";0;46;2028;2074;0,0221793635486982;2,22
2021;"1256";"Kvinnor";0;56;1594;1650;0,0339393939393939;3,39
2021;"1257";"Män";0;16;1877;1893;0,00845219228737454;0,85
2021;"1257";"Kvinnor";0;26;1506;1532;0,0169712793733681;1,7
2021;"1260";"Män";0;13;2684;2697;0,00482017055988135;0,48
2021;"1260";"Kvinnor";0;17;2232;2249;0,00755891507336594;0,76
2021;"1261";"Män";0;83;3925;4008;0,0207085828343313;2,07
2021;"1261";"Kvinnor";0;190;3646;3836;0,0495307612095933;4,95
2021;"1262";"Män";0;88;2525;2613;0,0336777650210486;3,37
2021;"1262";"Kvinnor";0;113;3108;3221;0,0350822725861534;3,51
2021;"1263";"Män";0;74;3537;3611;0,0204929382442537;2,05
2021;"1263";"Kvinnor";0;91;2841;2932;0,0310368349249659;3,1
2021;"1264";"Män";0;58;2019;2077;0,0279248916706789;2,79
2021;"1264";"Kvinnor";0;55;1977;2032;0,0270669291338583;2,71
2021;"1265";"Män";0;50;2778;2828;0,0176803394625177;1,77
2021;"1265";"Kvinnor";0;41;2795;2836;0,0144569816643159;1,45
2021;"1266";"Män";0;31;2288;2319;0,0133678309616214;1,34
2021;"1266";"Kvinnor";0;47;2188;2235;0,0210290827740492;2,1
2021;"1267";"Män";0;52;2003;2055;0,0253041362530414;2,53
2021;"1267";"Kvinnor";0;58;2566;2624;0,0221036585365854;2,21
2021;"1270";"Män";0;52;2421;2473;0,0210270926000809;2,1
2021;"1270";"Kvinnor";0;63;2166;2229;0,0282637954239569;2,83
2021;"1272";"Män";0;29;2260;2289;0,0126692878986457;1,27
2021;"1272";"Kvinnor";0;31;1826;1857;0,016693591814755;1,67
2021;"1273";"Män";0;33;2092;2125;0,0155294117647059;1,55
2021;"1273";"Kvinnor";0;50;1918;1968;0,0254065040650406;2,54
2021;"1275";"Män";0;4;1801;1805;0,00221606648199446;0,22
2021;"1275";"Kvinnor";0;9;1201;1210;0,00743801652892562;0,74
2021;"1276";"Män";0;72;2860;2932;0,0245566166439291;2,46
2021;"1276";"Kvinnor";0;51;2396;2447;0,0208418471597875;2,08
2021;"1277";"Män";0;25;3139;3164;0,00790139064475348;0,79
2021;"1277";"Kvinnor";0;36;2547;2583;0,0139372822299652;1,39
2021;"1278";"Män";0;72;3391;3463;0,0207912214842622;2,08
2021;"1278";"Kvinnor";0;100;2938;3038;0,032916392363397;3,29
2021;"1280";"Män";0;5278;91665;96943;0,0544443642140227;5,44
2021;"1280";"Kvinnor";0;5590;85514;91104;0,0613584474885845;6,14
2021;"1281";"Män";0;837;34075;34912;0,023974564619615;2,4
2021;"1281";"Kvinnor";0;1254;34863;36117;0,034720491735194;3,47
2021;"1282";"Män";0;203;8182;8385;0,0242098986285033;2,42
2021;"1282";"Kvinnor";0;206;6838;7044;0,0292447473026689;2,92
2021;"1283";"Män";0;1306;36543;37849;0,0345055351528442;3,45
2021;"1283";"Kvinnor";0;1582;32924;34506;0,0458470990552368;4,58
2021;"1284";"Män";0;120;4131;4251;0,0282286520818631;2,82
2021;"1284";"Kvinnor";0;162;3907;4069;0,0398132219218481;3,98
2021;"1285";"Män";0;136;5258;5394;0,0252131998516871;2,52
2021;"1285";"Kvinnor";0;164;4839;5003;0,0327803318009195;3,28
2021;"1286";"Män";0;169;5987;6156;0,0274528914879792;2,75
2021;"1286";"Kvinnor";0;267;6234;6501;0,0410706045223812;4,11
2021;"1287";"Män";0;138;6250;6388;0,0216030056355667;2,16
2021;"1287";"Kvinnor";0;159;6217;6376;0,0249372647427854;2,49
2021;"1290";"Män";0;445;18322;18767;0,023711834603293;2,37
2021;"1290";"Kvinnor";0;649;18038;18687;0,0347300262214374;3,47
2021;"1291";"Män";0;124;3302;3426;0,0361938120256859;3,62
2021;"1291";"Kvinnor";0;162;3332;3494;0,0463651974813967;4,64
2021;"1292";"Män";0;248;8822;9070;0,0273428886438809;2,73
2021;"1292";"Kvinnor";0;319;8689;9008;0,0354129662522202;3,54
2021;"1293";"Män";0;175;10496;10671;0,0163995876675101;1,64
2021;"1293";"Kvinnor";0;215;9021;9236;0,0232784755305327;2,33
2021;"1315";"Män";0;30;2379;2409;0,012453300124533;1,25
2021;"1315";"Kvinnor";0;35;1851;1886;0,0185577942735949;1,86
2021;"1380";"Män";0;585;25536;26121;0,0223957735155622;2,24
2021;"1380";"Kvinnor";0;759;23148;23907;0,0317480235914167;3,17
2021;"1381";"Män";0;132;4266;4398;0,0300136425648022;3
2021;"1381";"Kvinnor";0;123;3875;3998;0,0307653826913457;3,08
2021;"1382";"Män";0;264;9785;10049;0,0262712707732113;2,63
2021;"1382";"Kvinnor";0;370;9345;9715;0,0380854348944931;3,81
2021;"1383";"Män";0;428;14839;15267;0,0280343223947075;2,8
2021;"1383";"Kvinnor";0;670;13968;14638;0,0457712802295396;4,58
2021;"1384";"Män";0;477;11092;11569;0,04123087561587;4,12
2021;"1384";"Kvinnor";0;753;12073;12826;0,0587088726025261;5,87
2021;"1401";"Män";0;201;8815;9016;0,0222937000887311;2,23
2021;"1401";"Kvinnor";0;189;6429;6618;0,028558476881233;2,86
2021;"1402";"Män";0;244;5752;5996;0,0406937958639093;4,07
2021;"1402";"Kvinnor";0;370;5261;5631;0,0657076895755638;6,57
2021;"1407";"Män";0;28;1650;1678;0,0166865315852205;1,67
2021;"1407";"Kvinnor";0;56;1516;1572;0,0356234096692112;3,56
2021;"1415";"Män";0;80;6905;6985;0,0114531138153185;1,15
2021;"1415";"Kvinnor";0;158;4895;5053;0,0312685533346527;3,13
2021;"1419";"Män";0;29;2260;2289;0,0126692878986457;1,27
2021;"1419";"Kvinnor";0;53;2260;2313;0,0229139645482058;2,29
2021;"1421";"Män";0;30;2287;2317;0,0129477772982305;1,29
2021;"1421";"Kvinnor";0;46;2024;2070;0,0222222222222222;2,22
2021;"1427";"Män";0;25;1950;1975;0,0126582278481013;1,27
2021;"1427";"Kvinnor";0;44;1750;1794;0,0245261984392419;2,45
2021;"1430";"Män";0;80;1720;1800;0,0444444444444444;4,44
2021;"1430";"Kvinnor";0;67;1722;1789;0,0374510899944103;3,75
2021;"1435";"Män";0;70;2514;2584;0,0270897832817337;2,71
2021;"1435";"Kvinnor";0;126;2161;2287;0,055094009619589;5,51
2021;"1438";"Män";0;6;1135;1141;0,00525854513584575;0,53
2021;"1438";"Kvinnor";0;13;852;865;0,015028901734104;1,5
2021;"1439";"Män";0;4;1040;1044;0,00383141762452107;0,38
2021;"1439";"Kvinnor";0;5;942;947;0,00527983104540655;0,53
2021;"1440";"Män";0;68;3647;3715;0,0183041722745626;1,83
2021;"1440";"Kvinnor";0;85;3671;3756;0,0226304579339723;2,26
2021;"1441";"Män";0;152;4413;4565;0,0332968236582694;3,33
2021;"1441";"Kvinnor";0;209;5227;5436;0,0384473877851361;3,84
2021;"1442";"Män";0;21;3136;3157;0,00665188470066519;0,67
2021;"1442";"Kvinnor";0;23;1960;1983;0,0115985879979829;1,16
2021;"1443";"Män";0;57;1255;1312;0,0434451219512195;4,34
2021;"1443";"Kvinnor";0;54;1099;1153;0,0468343451864701;4,68
2021;"1444";"Män";0;3;804;807;0,00371747211895911;0,37
2021;"1444";"Kvinnor";0;22;816;838;0,0262529832935561;2,63
2021;"1445";"Män";0;25;979;1004;0,0249003984063745;2,49
2021;"1445";"Kvinnor";0;36;893;929;0,038751345532831;3,88
2021;"1446";"Män";0;29;1507;1536;0,0188802083333333;1,89
2021;"1446";"Kvinnor";0;29;1114;1143;0,0253718285214348;2,54
2021;"1447";"Män";0;5;862;867;0,00576701268742791;0,58
2021;"1447";"Kvinnor";0;10;664;674;0,0148367952522255;1,48
2021;"1452";"Män";0;68;3345;3413;0,0199238206856138;1,99
2021;"1452";"Kvinnor";0;97;2138;2235;0,0434004474272931;4,34
2021;"1460";"Män";0;46;1931;1977;0,0232675771370764;2,33
2021;"1460";"Kvinnor";0;72;1786;1858;0,038751345532831;3,88
2021;"1461";"Män";0;17;1578;1595;0,0106583072100313;1,07
2021;"1461";"Kvinnor";0;53;1344;1397;0,0379384395132427;3,79
2021;"1462";"Män";0;20;1802;1822;0,0109769484083425;1,1
2021;"1462";"Kvinnor";0;30;1769;1799;0,0166759310728182;1,67
2021;"1463";"Män";0;161;5219;5380;0,0299256505576208;2,99
2021;"1463";"Kvinnor";0;193;4955;5148;0,0374902874902875;3,75
2021;"1465";"Män";0;243;1754;1997;0,121682523785679;12,17
2021;"1465";"Kvinnor";0;206;1653;1859;0,110812264658419;11,08
2021;"1466";"Män";0;14;2017;2031;0,0068931560807484;0,69
2021;"1466";"Kvinnor";0;19;1436;1455;0,0130584192439863;1,31
2021;"1470";"Män";0;50;4343;4393;0,0113817436831323;1,14
2021;"1470";"Kvinnor";0;62;2874;2936;0,0211171662125341;2,11
2021;"1471";"Män";0;25;3602;3627;0,0068927488282327;0,69
2021;"1471";"Kvinnor";0;27;2491;2518;0,0107227958697379;1,07
2021;"1472";"Män";0;17;1690;1707;0,00995899238429994;1
2021;"1472";"Kvinnor";0;17;1623;1640;0,0103658536585366;1,04
2021;"1473";"Män";0;12;1736;1748;0,0068649885583524;0,69
2021;"1473";"Kvinnor";0;21;1452;1473;0,0142566191446029;1,43
2021;"1480";"Män";0;7027;182050;189077;0,0371647529842339;3,72
2021;"1480";"Kvinnor";0;8869;159944;168813;0,0525374230657592;5,25
2021;"1481";"Män";0;618;21872;22490;0,0274788795020009;2,75
2021;"1481";"Kvinnor";0;1005;18456;19461;0,0516417450285186;5,16
2021;"1482";"Män";0;190;8644;8834;0,0215078107312656;2,15
2021;"1482";"Kvinnor";0;248;8604;8852;0,0280162675101672;2,8
2021;"1484";"Män";0;42;3021;3063;0,0137120470127326;1,37
2021;"1484";"Kvinnor";0;59;2394;2453;0,0240521810028537;2,41
2021;"1485";"Män";0;274;11896;12170;0,0225143796220214;2,25
2021;"1485";"Kvinnor";0;499;11556;12055;0,041393612608876;4,14
2021;"1486";"Män";0;50;2568;2618;0,0190985485103132;1,91
2021;"1486";"Kvinnor";0;163;2519;2682;0,0607755406413125;6,08
2021;"1487";"Män";0;152;6271;6423;0,0236649540713062;2,37
2021;"1487";"Kvinnor";0;190;6697;6887;0,0275882096703935;2,76
2021;"1488";"Män";0;259;13575;13834;0,0187219893017204;1,87
2021;"1488";"Kvinnor";0;394;13096;13490;0,0292068198665678;2,92
2021;"1489";"Män";0;203;6644;6847;0,0296480210311085;2,96
2021;"1489";"Kvinnor";0;287;7673;7960;0,0360552763819095;3,61
2021;"1490";"Män";0;2093;26577;28670;0,073003139169864;7,3
2021;"1490";"Kvinnor";0;2758;25225;27983;0,0985598399027981;9,86
2021;"1491";"Män";0;244;4750;4994;0,0488586303564277;4,89
2021;"1491";"Kvinnor";0;375;3844;4219;0,088883621711306;8,89
2021;"1492";"Män";0;24;2191;2215;0,0108352144469526;1,08
2021;"1492";"Kvinnor";0;44;1910;1954;0,022517911975435;2,25
2021;"1493";"Män";0;78;4699;4777;0,0163282394808457;1,63
2021;"1493";"Kvinnor";0;105;4104;4209;0,0249465431218817;2,49
2021;"1494";"Män";0;178;9075;9253;0,0192370042148492;1,92
2021;"1494";"Kvinnor";0;249;8112;8361;0,0297811266594905;2,98
2021;"1495";"Män";0;86;4202;4288;0,0200559701492537;2,01
2021;"1495";"Kvinnor";0;107;3709;3816;0,0280398322851153;2,8
2021;"1496";"Män";0;431;17223;17654;0,0244137305992976;2,44
2021;"1496";"Kvinnor";0;413;15460;15873;0,026019026019026;2,6
2021;"1497";"Män";0;16;1373;1389;0,0115190784737221;1,15
2021;"1497";"Kvinnor";0;21;1417;1438;0,0146036161335188;1,46
2021;"1498";"Män";0;49;2386;2435;0,0201232032854209;2,01
2021;"1498";"Kvinnor";0;64;2061;2125;0,0301176470588235;3,01
2021;"1499";"Män";0;92;6268;6360;0,0144654088050314;1,45
2021;"1499";"Kvinnor";0;127;5504;5631;0,0225537204759368;2,26
2021;"1715";"Män";0;29;1662;1691;0,0171496156120639;1,71
2021;"1715";"Kvinnor";0;32;1399;1431;0,0223619846261356;2,24
2021;"1730";"Män";0;9;1480;1489;0,00604432505036938;0,6
2021;"1730";"Kvinnor";0;87;1636;1723;0,0504933255948926;5,05
2021;"1737";"Män";0;23;2340;2363;0,00973338975878121;0,97
2021;"1737";"Kvinnor";0;50;2292;2342;0,0213492741246798;2,13
2021;"1760";"Män";0;5;486;491;0,010183299389002;1,02
2021;"1760";"Kvinnor";0;5;422;427;0,0117096018735363;1,17
2021;"1761";"Män";0;28;1918;1946;0,0143884892086331;1,44
2021;"1761";"Kvinnor";0;51;1864;1915;0,0266318537859008;2,66
2021;"1762";"Män";0;12;816;828;0,0144927536231884;1,45
2021;"1762";"Kvinnor";0;6;698;704;0,00852272727272727;0,85
2021;"1763";"Män";0;13;1041;1054;0,0123339658444023;1,23
2021;"1763";"Kvinnor";0;27;1386;1413;0,0191082802547771;1,91
2021;"1764";"Män";0;8;2037;2045;0,0039119804400978;0,39
2021;"1764";"Kvinnor";0;16;1265;1281;0,0124902419984387;1,25
2021;"1765";"Män";0;13;1809;1822;0,00713501646542261;0,71
2021;"1765";"Kvinnor";0;65;1692;1757;0,0369948776323278;3,7
2021;"1766";"Män";0;123;2525;2648;0,0464501510574018;4,65
2021;"1766";"Kvinnor";0;120;2113;2233;0,0537393640841917;5,37
2021;"1780";"Män";0;767;26591;27358;0,0280356751224505;2,8
2021;"1780";"Kvinnor";0;952;25092;26044;0,0365535248041775;3,66
2021;"1781";"Män";0;52;4271;4323;0,012028683784409;1,2
2021;"1781";"Kvinnor";0;100;3404;3504;0,0285388127853881;2,85
2021;"1782";"Män";0;13;1642;1655;0,00785498489425982;0,79
2021;"1782";"Kvinnor";0;36;1497;1533;0,0234833659491194;2,35
2021;"1783";"Män";0;25;2317;2342;0,0106746370623399;1,07
2021;"1783";"Kvinnor";0;41;1765;1806;0,0227021040974529;2,27
2021;"1784";"Män";0;83;5251;5334;0,0155605549306337;1,56
2021;"1784";"Kvinnor";0;126;4784;4910;0,0256619144602851;2,57
2021;"1785";"Män";0;21;2779;2800;0,0075;0,75
2021;"1785";"Kvinnor";0;60;2572;2632;0,0227963525835866;2,28
2021;"1814";"Män";0;6;1038;1044;0,00574712643678161;0,57
2021;"1814";"Kvinnor";0;18;1044;1062;0,0169491525423729;1,69
2021;"1860";"Män";0;4;1236;1240;0,0032258064516129;0,32
2021;"1860";"Kvinnor";0;12;812;824;0,0145631067961165;1,46
2021;"1861";"Män";0;48;4178;4226;0,0113582584003786;1,14
2021;"1861";"Kvinnor";0;41;3262;3303;0,0124129579170451;1,24
2021;"1862";"Män";0;6;1361;1367;0,00438917337234821;0,44
2021;"1862";"Kvinnor";0;15;1101;1116;0,0134408602150538;1,34
2021;"1863";"Män";0;16;1289;1305;0,0122605363984674;1,23
2021;"1863";"Kvinnor";0;20;1035;1055;0,018957345971564;1,9
2021;"1864";"Män";0;12;744;756;0,0158730158730159;1,59
2021;"1864";"Kvinnor";0;13;706;719;0,0180806675938804;1,81
2021;"1880";"Män";0;1077;40878;41955;0,0256703611011798;2,57
2021;"1880";"Kvinnor";0;1297;38083;39380;0,032935500253936;3,29
2021;"1881";"Män";0;78;3474;3552;0,0219594594594595;2,2
2021;"1881";"Kvinnor";0;79;3181;3260;0,0242331288343558;2,42
2021;"1882";"Män";0;24;2262;2286;0,010498687664042;1,05
2021;"1882";"Kvinnor";0;48;1649;1697;0,028285209192693;2,83
2021;"1883";"Män";0;123;7279;7402;0,0166171305052688;1,66
2021;"1883";"Kvinnor";0;145;6247;6392;0,0226846057571965;2,27
2021;"1884";"Män";0;38;1408;1446;0,0262793914246196;2,63
2021;"1884";"Kvinnor";0;64;1512;1576;0,0406091370558376;4,06
2021;"1885";"Män";0;48;4950;4998;0,00960384153661465;0,96
2021;"1885";"Kvinnor";0;63;4549;4612;0,0136600173460538;1,37
2021;"1904";"Män";0;6;831;837;0,00716845878136201;0,72
2021;"1904";"Kvinnor";0;13;602;615;0,0211382113821138;2,11
2021;"1907";"Män";0;3;1327;1330;0,00225563909774436;0,23
2021;"1907";"Kvinnor";0;10;1124;1134;0,00881834215167548;0,88
2021;"1960";"Män";0;16;1324;1340;0,0119402985074627;1,19
2021;"1960";"Kvinnor";0;18;1037;1055;0,0170616113744076;1,71
2021;"1961";"Män";0;25;2428;2453;0,0101916021198532;1,02
2021;"1961";"Kvinnor";0;13;2475;2488;0,00522508038585209;0,52
2021;"1962";"Män";0;9;833;842;0,0106888361045131;1,07
2021;"1962";"Kvinnor";0;15;809;824;0,0182038834951456;1,82
2021;"1980";"Män";0;941;37443;38384;0,0245154230929554;2,45
2021;"1980";"Kvinnor";0;1123;34258;35381;0,0317401995421271;3,17
2021;"1981";"Män";0;62;3807;3869;0,0160248126130783;1,6
2021;"1981";"Kvinnor";0;102;3660;3762;0,0271132376395534;2,71
2021;"1982";"Män";0;19;3203;3222;0,00589695841092489;0,59
2021;"1982";"Kvinnor";0;34;2658;2692;0,012630014858841;1,26
2021;"1983";"Män";0;71;5862;5933;0,0119669644362043;1,2
2021;"1983";"Kvinnor";0;86;5023;5109;0,0168330397338031;1,68
2021;"1984";"Män";0;17;2453;2470;0,00688259109311741;0,69
2021;"1984";"Kvinnor";0;34;1962;1996;0,0170340681362725;1,7
2021;"2021";"Män";0;8;1506;1514;0,00528401585204756;0,53
2021;"2021";"Kvinnor";0;19;1306;1325;0,0143396226415094;1,43
2021;"2023";"Män";0;29;2668;2697;0,010752688172043;1,08
2021;"2023";"Kvinnor";0;45;2335;2380;0,0189075630252101;1,89
2021;"2026";"Män";0;16;1297;1313;0,0121858339680122;1,22
2021;"2026";"Kvinnor";0;16;1395;1411;0,0113394755492558;1,13
2021;"2029";"Män";0;177;3173;3350;0,0528358208955224;5,28
2021;"2029";"Kvinnor";0;166;2781;2947;0,0563284696301323;5,63
2021;"2031";"Män";0;80;1810;1890;0,0423280423280423;4,23
2021;"2031";"Kvinnor";0;88;1733;1821;0,0483250961010434;4,83
2021;"2034";"Män";0;30;1023;1053;0,0284900284900285;2,85
2021;"2034";"Kvinnor";0;17;936;953;0,0178384050367261;1,78
2021;"2039";"Män";0;17;1499;1516;0,0112137203166227;1,12
2021;"2039";"Kvinnor";0;20;1247;1267;0,015785319652723;1,58
2021;"2061";"Män";0;14;1527;1541;0,009085009733939;0,91
2021;"2061";"Kvinnor";0;23;1201;1224;0,0187908496732026;1,88
2021;"2062";"Män";0;75;5134;5209;0,0143981570358994;1,44
2021;"2062";"Kvinnor";0;143;4686;4829;0,0296127562642369;2,96
2021;"2080";"Män";0;557;12019;12576;0,0442907124681934;4,43
2021;"2080";"Kvinnor";0;544;13853;14397;0,0377856497881503;3,78
2021;"2081";"Män";0;163;15004;15167;0,0107470165490868;1,07
2021;"2081";"Kvinnor";0;341;11195;11536;0,0295596393897365;2,96
2021;"2082";"Män";0;20;1457;1477;0,01354096140826;1,35
2021;"2082";"Kvinnor";0;37;1492;1529;0,0241988227599738;2,42
2021;"2083";"Män";0;45;3240;3285;0,0136986301369863;1,37
2021;"2083";"Kvinnor";0;72;2646;2718;0,0264900662251656;2,65
2021;"2084";"Män";0;78;5263;5341;0,0146040067403108;1,46
2021;"2084";"Kvinnor";0;136;4117;4253;0,0319774276980955;3,2
2021;"2085";"Män";0;42;6355;6397;0,0065655776145068;0,66
2021;"2085";"Kvinnor";0;68;4993;5061;0,0134360798261213;1,34
2021;"2101";"Män";0;14;848;862;0,0162412993039443;1,62
2021;"2101";"Kvinnor";0;12;753;765;0,0156862745098039;1,57
2021;"2104";"Män";0;14;1846;1860;0,00752688172043011;0,75
2021;"2104";"Kvinnor";0;19;1339;1358;0,0139911634756996;1,4
2021;"2121";"Män";0;26;2920;2946;0,0088255261371351;0,88
2021;"2121";"Kvinnor";0;48;2073;2121;0,0226308345120226;2,26
2021;"2132";"Män";0;16;1369;1385;0,0115523465703971;1,16
2021;"2132";"Kvinnor";0;32;1109;1141;0,028045574057844;2,8
2021;"2161";"Män";0;102;3600;3702;0,0275526742301459;2,76
2021;"2161";"Kvinnor";0;184;3185;3369;0,0546156129415257;5,46
2021;"2180";"Män";0;612;23304;23916;0,0255895634721525;2,56
2021;"2180";"Kvinnor";0;776;22926;23702;0,0327398531769471;3,27
2021;"2181";"Män";0;89;8861;8950;0,00994413407821229;0,99
2021;"2181";"Kvinnor";0;149;6394;6543;0,022772428549595;2,28
2021;"2182";"Män";0;88;4829;4917;0,0178970917225951;1,79
2021;"2182";"Kvinnor";0;139;3894;4033;0,0344656583188693;3,45
2021;"2183";"Män";0;132;4975;5107;0,0258468768357157;2,58
2021;"2183";"Kvinnor";0;122;5112;5234;0,0233091325945739;2,33
2021;"2184";"Män";0;167;8417;8584;0,0194547996272134;1,95
2021;"2184";"Kvinnor";0;191;7653;7844;0,0243498215196328;2,43
2021;"2260";"Män";0;44;1887;1931;0,0227861211807354;2,28
2021;"2260";"Kvinnor";0;60;1522;1582;0,0379266750948167;3,79
2021;"2262";"Män";0;22;3111;3133;0,00702202361953399;0,7
2021;"2262";"Kvinnor";0;24;2103;2127;0,0112834978843441;1,13
2021;"2280";"Män";0;143;4145;4288;0,0333488805970149;3,33
2021;"2280";"Kvinnor";0;210;4482;4692;0,0447570332480818;4,48
2021;"2281";"Män";0;496;24617;25113;0,0197507267152471;1,98
2021;"2281";"Kvinnor";0;704;23035;23739;0,0296558405998568;2,97
2021;"2282";"Män";0;33;3908;3941;0,00837350926160873;0,84
2021;"2282";"Kvinnor";0;48;3057;3105;0,0154589371980676;1,55
2021;"2283";"Män";0;60;3526;3586;0,0167317345231456;1,67
2021;"2283";"Kvinnor";0;77;3319;3396;0,0226737338044759;2,27
2021;"2284";"Män";0;232;12292;12524;0,0185244330884701;1,85
2021;"2284";"Kvinnor";0;378;10202;10580;0,0357277882797732;3,57
2021;"2303";"Män";0;7;1041;1048;0,0066793893129771;0,67
2021;"2303";"Kvinnor";0;9;862;871;0,0103329506314581;1,03
2021;"2305";"Män";0;28;1059;1087;0,0257589696412144;2,58
2021;"2305";"Kvinnor";0;24;841;865;0,0277456647398844;2,77
2021;"2309";"Män";0;23;2356;2379;0,00966792770071459;0,97
2021;"2309";"Kvinnor";0;19;1917;1936;0,00981404958677686;0,98
2021;"2313";"Män";0;15;2375;2390;0,00627615062761506;0,63
2021;"2313";"Kvinnor";0;30;1977;2007;0,0149476831091181;1,49
2021;"2321";"Män";0;105;2790;2895;0,0362694300518135;3,63
2021;"2321";"Kvinnor";0;105;2459;2564;0,0409516380655226;4,1
2021;"2326";"Män";0;14;1295;1309;0,0106951871657754;1,07
2021;"2326";"Kvinnor";0;17;1115;1132;0,015017667844523;1,5
2021;"2361";"Män";0;19;2239;2258;0,00841452612931798;0,84
2021;"2361";"Kvinnor";0;22;2096;2118;0,0103871576959396;1,04
2021;"2380";"Män";0;548;16436;16984;0,0322656617993406;3,23
2021;"2380";"Kvinnor";0;629;16429;17058;0,0368741939266034;3,69
2021;"2401";"Män";0;24;977;1001;0,023976023976024;2,4
2021;"2401";"Kvinnor";0;27;883;910;0,0296703296703297;2,97
2021;"2403";"Män";0;5;329;334;0,0149700598802395;1,5
2021;"2403";"Kvinnor";0;4;371;375;0,0106666666666667;1,07
2021;"2404";"Män";0;12;1143;1155;0,0103896103896104;1,04
2021;"2404";"Kvinnor";0;15;868;883;0,0169875424688562;1,7
2021;"2409";"Män";0;12;993;1005;0,0119402985074627;1,19
2021;"2409";"Kvinnor";0;6;948;954;0,00628930817610063;0,63
2021;"2417";"Män";0;7;842;849;0,00824499411071849;0,82
2021;"2417";"Kvinnor";0;15;647;662;0,0226586102719033;2,27
2021;"2418";"Män";0;2;605;607;0,00329489291598023;0,33
2021;"2418";"Kvinnor";0;11;488;499;0,0220440881763527;2,2
2021;"2421";"Män";0;15;1240;1255;0,0119521912350598;1,2
2021;"2421";"Kvinnor";0;19;1089;1108;0,0171480144404332;1,71
2021;"2422";"Män";0;3;457;460;0,00652173913043478;0,65
2021;"2422";"Kvinnor";0;3;403;406;0,00738916256157635;0,74
2021;"2425";"Män";0;2;488;490;0,00408163265306122;0,41
2021;"2425";"Kvinnor";0;6;439;445;0,0134831460674157;1,35
2021;"2460";"Män";0;8;1220;1228;0,00651465798045603;0,65
2021;"2460";"Kvinnor";0;14;1156;1170;0,011965811965812;1,2
2021;"2462";"Män";0;18;1100;1118;0,0161001788908766;1,61
2021;"2462";"Kvinnor";0;17;1128;1145;0,0148471615720524;1,48
2021;"2463";"Män";0;8;476;484;0,0165289256198347;1,65
2021;"2463";"Kvinnor";0;18;445;463;0,0388768898488121;3,89
2021;"2480";"Män";0;946;32887;33833;0,0279608666095232;2,8
2021;"2480";"Kvinnor";0;1056;30173;31229;0,0338147234941881;3,38
2021;"2481";"Män";0;33;2940;2973;0,0110998990918264;1,11
2021;"2481";"Kvinnor";0;56;2758;2814;0,0199004975124378;1,99
2021;"2482";"Män";0;334;17603;17937;0,0186207281039193;1,86
2021;"2482";"Kvinnor";0;415;14223;14638;0,0283508676048641;2,84
2021;"2505";"Män";0;12;1033;1045;0,0114832535885167;1,15
2021;"2505";"Kvinnor";0;26;1097;1123;0,0231522707034728;2,32
2021;"2506";"Män";0;4;689;693;0,00577200577200577;0,58
2021;"2506";"Kvinnor";0;19;550;569;0,0333919156414763;3,34
2021;"2510";"Män";0;25;953;978;0,0255623721881391;2,56
2021;"2510";"Kvinnor";0;49;804;853;0,0574443141852286;5,74
2021;"2513";"Män";0;7;678;685;0,0102189781021898;1,02
2021;"2513";"Kvinnor";0;13;568;581;0,0223752151462995;2,24
2021;"2514";"Män";0;42;3004;3046;0,0137885751805647;1,38
2021;"2514";"Kvinnor";0;67;2722;2789;0,0240229472929365;2,4
2021;"2518";"Män";0;19;695;714;0,0266106442577031;2,66
2021;"2518";"Kvinnor";0;26;589;615;0,0422764227642276;4,23
2021;"2521";"Män";0;31;1198;1229;0,0252237591537836;2,52
2021;"2521";"Kvinnor";0;17;897;914;0,0185995623632385;1,86
2021;"2523";"Män";0;50;4995;5045;0,00991080277502478;0,99
2021;"2523";"Kvinnor";0;57;3775;3832;0,014874739039666;1,49
2021;"2560";"Män";0;6;1345;1351;0,00444115470022206;0,44
2021;"2560";"Kvinnor";0;20;1204;1224;0,0163398692810458;1,63
2021;"2580";"Män";0;573;21492;22065;0,0259687287559483;2,6
2021;"2580";"Kvinnor";0;754;18884;19638;0,0383949485691007;3,84
2021;"2581";"Män";0;132;8687;8819;0,0149676834108176;1,5
2021;"2581";"Kvinnor";0;234;7562;7796;0,030015392508979;3
2021;"2582";"Män";0;79;5527;5606;0,0140920442383161;1,41
2021;"2582";"Kvinnor";0;94;4646;4740;0,019831223628692;1,98
2021;"2583";"Män";0;18;1476;1494;0,0120481927710843;1,2
2021;"2583";"Kvinnor";0;28;1491;1519;0,0184331797235023;1,84
2021;"2584";"Män";0;81;6818;6899;0,0117408320046384;1,17
2021;"2584";"Kvinnor";0;174;5133;5307;0,0327868852459016;3,28
2021;"9999";"Män";0;1487;170647;172134;0,00863861875050832;0,86
2021;"9999";"Kvinnor";0;1928;189604;191532;0,0100662030365683;1,01
2022;"0114";"Män";0;160;7533;7693;0,0207981281684648;2,08
2022;"0114";"Kvinnor";0;176;6895;7071;0,0248903973978221;2,49
2022;"0115";"Män";0;102;4654;4756;0,0214465937762826;2,14
2022;"0115";"Kvinnor";0;118;4273;4391;0,0268731496242314;2,69
2022;"0117";"Män";0;178;5675;5853;0,0304117546557321;3,04
2022;"0117";"Kvinnor";0;215;5427;5642;0,0381070542360865;3,81
2022;"0120";"Män";0;239;6005;6244;0,0382767456758488;3,83
2022;"0120";"Kvinnor";0;291;5599;5890;0,0494057724957555;4,94
2022;"0123";"Män";0;415;15213;15628;0,0265549014589199;2,66
2022;"0123";"Kvinnor";0;513;10784;11297;0,045410285916615;4,54
2022;"0125";"Män";0;124;3876;4000;0,031;3,1
2022;"0125";"Kvinnor";0;148;3776;3924;0,0377166156982671;3,77
2022;"0126";"Män";0;472;22768;23240;0,0203098106712565;2,03
2022;"0126";"Kvinnor";0;567;23151;23718;0,0239058942575259;2,39
2022;"0127";"Män";0;407;12995;13402;0,0303686017012386;3,04
2022;"0127";"Kvinnor";0;464;10099;10563;0,0439269147022626;4,39
2022;"0128";"Män";0;45;1193;1238;0,0363489499192246;3,63
2022;"0128";"Kvinnor";0;47;1578;1625;0,0289230769230769;2,89
2022;"0136";"Män";0;380;16290;16670;0,0227954409118176;2,28
2022;"0136";"Kvinnor";0;366;12426;12792;0,0286116322701689;2,86
2022;"0138";"Män";0;198;5659;5857;0,0338057025781117;3,38
2022;"0138";"Kvinnor";0;257;5206;5463;0,04704374885594;4,7
2022;"0139";"Män";0;64;7546;7610;0,00840998685939553;0,84
2022;"0139";"Kvinnor";0;53;4594;4647;0,0114052076608565;1,14
2022;"0140";"Män";0;20;1702;1722;0,0116144018583043;1,16
2022;"0140";"Kvinnor";0;22;1278;1300;0,0169230769230769;1,69
2022;"0160";"Män";0;496;12653;13149;0,0377214997338201;3,77
2022;"0160";"Kvinnor";0;712;11205;11917;0,0597465805152303;5,97
2022;"0162";"Män";0;206;8127;8333;0,0247209888395536;2,47
2022;"0162";"Kvinnor";0;281;11752;12033;0,0233524474362171;2,34
2022;"0163";"Män";0;392;12623;13015;0,0301190933538225;3,01
2022;"0163";"Kvinnor";0;468;12508;12976;0,0360665844636252;3,61
2022;"0180";"Män";0;34504;337685;372189;0,0927055877524591;9,27
2022;"0180";"Kvinnor";0;40380;314995;355375;0,113626450932114;11,36
2022;"0181";"Män";0;416;30507;30923;0,0134527697830094;1,35
2022;"0181";"Kvinnor";0;475;22409;22884;0,0207568606886908;2,08
2022;"0182";"Män";0;882;16777;17659;0,0499462030692565;4,99
2022;"0182";"Kvinnor";0;1052;16875;17927;0,0586824343169521;5,87
2022;"0183";"Män";0;276;12697;12973;0,0212749556771757;2,13
2022;"0183";"Kvinnor";0;261;13350;13611;0,0191756667401367;1,92
2022;"0184";"Män";0;988;54067;55055;0,0179456906729634;1,79
2022;"0184";"Kvinnor";0;1464;52378;53842;0,0271906689944653;2,72
2022;"0186";"Män";0;316;5139;5455;0,0579285059578368;5,79
2022;"0186";"Kvinnor";0;347;5745;6092;0,0569599474720945;5,7
2022;"0187";"Män";0;49;1242;1291;0,0379550735863672;3,8
2022;"0187";"Kvinnor";0;70;1295;1365;0,0512820512820513;5,13
2022;"0188";"Män";0;224;11011;11235;0,0199376947040498;1,99
2022;"0188";"Kvinnor";0;308;11238;11546;0,0266759050753508;2,67
2022;"0191";"Män";0;209;15953;16162;0,012931567875263;1,29
2022;"0191";"Kvinnor";0;303;11070;11373;0,0266420469533105;2,66
2022;"0192";"Män";0;64;3373;3437;0,018620890311318;1,86
2022;"0192";"Kvinnor";0;102;3543;3645;0,0279835390946502;2,8
2022;"0305";"Män";0;58;3008;3066;0,0189171559034573;1,89
2022;"0305";"Kvinnor";0;99;2797;2896;0,0341850828729282;3,42
2022;"0319";"Män";0;12;1305;1317;0,00911161731207289;0,91
2022;"0319";"Kvinnor";0;23;1173;1196;0,0192307692307692;1,92
2022;"0330";"Män";0;52;2113;2165;0,0240184757505774;2,4
2022;"0330";"Kvinnor";0;48;2108;2156;0,0222634508348794;2,23
2022;"0331";"Män";0;268;2239;2507;0,106900678101316;10,69
2022;"0331";"Kvinnor";0;225;1978;2203;0,10213345438039;10,21
2022;"0360";"Män";0;48;3570;3618;0,0132669983416252;1,33
2022;"0360";"Kvinnor";0;60;3004;3064;0,0195822454308094;1,96
2022;"0380";"Män";0;1903;51744;53647;0,0354726266147222;3,55
2022;"0380";"Kvinnor";0;2160;54531;56691;0,0381012859183997;3,81
2022;"0381";"Män";0;158;9415;9573;0,016504752951008;1,65
2022;"0381";"Kvinnor";0;178;8386;8564;0,0207846800560486;2,08
2022;"0382";"Män";0;33;5251;5284;0,00624526873580621;0,62
2022;"0382";"Kvinnor";0;47;3897;3944;0,0119168356997972;1,19
2022;"0428";"Män";0;64;1406;1470;0,0435374149659864;4,35
2022;"0428";"Kvinnor";0;113;1276;1389;0,0813534917206623;8,14
2022;"0461";"Män";0;44;1338;1382;0,0318379160636758;3,18
2022;"0461";"Kvinnor";0;63;1477;1540;0,0409090909090909;4,09
2022;"0480";"Män";0;237;10665;10902;0,0217391304347826;2,17
2022;"0480";"Kvinnor";0;373;11789;12162;0,0306692978128597;3,07
2022;"0481";"Män";0;27;3146;3173;0,00850929719508352;0,85
2022;"0481";"Kvinnor";0;27;1892;1919;0,0140698280354351;1,41
2022;"0482";"Män";0;36;2736;2772;0,012987012987013;1,3
2022;"0482";"Kvinnor";0;49;2378;2427;0,0201895344046147;2,02
2022;"0483";"Män";0;172;7129;7301;0,0235584166552527;2,36
2022;"0483";"Kvinnor";0;166;6620;6786;0,0244621279104038;2,45
2022;"0484";"Män";0;634;22662;23296;0,0272149725274725;2,72
2022;"0484";"Kvinnor";0;871;21448;22319;0,0390250459249966;3,9
2022;"0486";"Män";0;144;5676;5820;0,0247422680412371;2,47
2022;"0486";"Kvinnor";0;207;5244;5451;0,0379746835443038;3,8
2022;"0488";"Män";0;52;2038;2090;0,0248803827751196;2,49
2022;"0488";"Kvinnor";0;85;2148;2233;0,0380653828929691;3,81
2022;"0509";"Män";0;30;826;856;0,0350467289719626;3,5
2022;"0509";"Kvinnor";0;25;708;733;0,034106412005457;3,41
2022;"0512";"Män";0;8;621;629;0,0127186009538951;1,27
2022;"0512";"Kvinnor";0;20;505;525;0,0380952380952381;3,81
2022;"0513";"Män";0;33;1672;1705;0,0193548387096774;1,94
2022;"0513";"Kvinnor";0;31;1602;1633;0,0189834660134721;1,9
2022;"0560";"Män";0;10;996;1006;0,0099403578528827;0,99
2022;"0560";"Kvinnor";0;7;634;641;0,0109204368174727;1,09
2022;"0561";"Män";0;39;1548;1587;0,0245746691871456;2,46
2022;"0561";"Kvinnor";0;35;1349;1384;0,0252890173410405;2,53
2022;"0562";"Män";0;33;5391;5424;0,00608407079646018;0,61
2022;"0562";"Kvinnor";0;53;3790;3843;0,0137913088732761;1,38
2022;"0563";"Män";0;11;1318;1329;0,00827689992475546;0,83
2022;"0563";"Kvinnor";0;24;1023;1047;0,0229226361031519;2,29
2022;"0580";"Män";0;913;46439;47352;0,019281128569015;1,93
2022;"0580";"Kvinnor";0;1141;41890;43031;0,0265157677023541;2,65
2022;"0581";"Män";0;973;33857;34830;0,0279356876256101;2,79
2022;"0581";"Kvinnor";0;1168;31403;32571;0,0358601209665039;3,59
2022;"0582";"Män";0;57;1964;2021;0,0282038594755072;2,82
2022;"0582";"Kvinnor";0;56;1939;1995;0,0280701754385965;2,81
2022;"0583";"Män";0;139;7182;7321;0,0189864772572053;1,9
2022;"0583";"Kvinnor";0;164;7361;7525;0,0217940199335548;2,18
2022;"0584";"Män";0;34;1535;1569;0,0216698534098152;2,17
2022;"0584";"Kvinnor";0;51;1314;1365;0,0373626373626374;3,74
2022;"0586";"Män";0;37;7810;7847;0,00471517777494584;0,47
2022;"0586";"Kvinnor";0;108;4987;5095;0,0211972522080471;2,12
2022;"0604";"Män";0;13;1280;1293;0,0100541376643465;1,01
2022;"0604";"Kvinnor";0;17;1075;1092;0,0155677655677656;1,56
2022;"0617";"Män";0;85;3831;3916;0,02170582226762;2,17
2022;"0617";"Kvinnor";0;95;2533;2628;0,0361491628614916;3,61
2022;"0642";"Män";0;39;1180;1219;0,0319934372436423;3,2
2022;"0642";"Kvinnor";0;46;1243;1289;0,0356865787432118;3,57
2022;"0643";"Män";0;40;1987;2027;0,0197335964479526;1,97
2022;"0643";"Kvinnor";0;42;1678;1720;0,0244186046511628;2,44
2022;"0662";"Män";0;77;8370;8447;0,00911566236533681;0,91
2022;"0662";"Kvinnor";0;118;6191;6309;0,018703439530829;1,87
2022;"0665";"Män";0;24;3089;3113;0,00770960488274976;0,77
2022;"0665";"Kvinnor";0;39;2322;2361;0,0165184243964422;1,65
2022;"0680";"Män";0;990;39680;40670;0,0243422670272928;2,43
2022;"0680";"Kvinnor";0;1266;35610;36876;0,0343312723722747;3,43
2022;"0682";"Män";0;100;6792;6892;0,0145095763203714;1,45
2022;"0682";"Kvinnor";0;103;5644;5747;0,0179223942926744;1,79
2022;"0683";"Män";0;154;8888;9042;0,0170316301703163;1,7
2022;"0683";"Kvinnor";0;220;8112;8332;0,0264042246759482;2,64
2022;"0684";"Män";0;25;2479;2504;0,00998402555910543;1
2022;"0684";"Kvinnor";0;65;1942;2007;0,0323866467364225;3,24
2022;"0685";"Män";0;78;6802;6880;0,0113372093023256;1,13
2022;"0685";"Kvinnor";0;113;5013;5126;0,0220444791260242;2,2
2022;"0686";"Män";0;52;4654;4706;0,0110497237569061;1,1
2022;"0686";"Kvinnor";0;79;4706;4785;0,0165099268547544;1,65
2022;"0687";"Män";0;77;4579;4656;0,0165378006872852;1,65
2022;"0687";"Kvinnor";0;83;3881;3964;0,0209384460141271;2,09
2022;"0760";"Män";0;18;3080;3098;0,00581020012911556;0,58
2022;"0760";"Kvinnor";0;19;1980;1999;0,00950475237618809;0,95
2022;"0761";"Män";0;22;1218;1240;0,017741935483871;1,77
2022;"0761";"Kvinnor";0;57;1168;1225;0,046530612244898;4,65
2022;"0763";"Män";0;37;3095;3132;0,0118135376756066;1,18
2022;"0763";"Kvinnor";0;34;2459;2493;0,0136381869233855;1,36
2022;"0764";"Män";0;37;4089;4126;0,00896752302472128;0,9
2022;"0764";"Kvinnor";0;53;3146;3199;0,0165676773991872;1,66
2022;"0765";"Män";0;1233;4276;5509;0,223815574514431;22,38
2022;"0765";"Kvinnor";0;1317;3660;4977;0,264617239300784;26,46
2022;"0767";"Män";0;18;3562;3580;0,00502793296089385;0,5
2022;"0767";"Kvinnor";0;32;2129;2161;0,014807959278112;1,48
2022;"0780";"Män";0;773;24799;25572;0,030228374784921;3,02
2022;"0780";"Kvinnor";0;846;22609;23455;0,0360690684289064;3,61
2022;"0781";"Män";0;298;6814;7112;0,0419010123734533;4,19
2022;"0781";"Kvinnor";0;200;5708;5908;0,03385240352065;3,39
2022;"0821";"Män";0;8;720;728;0,010989010989011;1,1
2022;"0821";"Kvinnor";0;5;772;777;0,00643500643500643;0,64
2022;"0834";"Män";0;9;1245;1254;0,00717703349282297;0,72
2022;"0834";"Kvinnor";0;13;991;1004;0,0129482071713147;1,29
2022;"0840";"Män";0;56;2508;2564;0,0218408736349454;2,18
2022;"0840";"Kvinnor";0;89;2437;2526;0,0352335708630245;3,52
2022;"0860";"Män";0;13;2736;2749;0,00472899236085849;0,47
2022;"0860";"Kvinnor";0;27;2233;2260;0,0119469026548673;1,19
2022;"0861";"Män";0;20;2344;2364;0,00846023688663283;0,85
2022;"0861";"Kvinnor";0;42;1970;2012;0,0208747514910537;2,09
2022;"0862";"Män";0;32;2564;2596;0,012326656394453;1,23
2022;"0862";"Kvinnor";0;36;1752;1788;0,0201342281879195;2,01
2022;"0880";"Män";0;598;17715;18313;0,0326543985147163;3,27
2022;"0880";"Kvinnor";0;828;17530;18358;0,045102952391328;4,51
2022;"0881";"Män";0;40;4121;4161;0,00961307378034126;0,96
2022;"0881";"Kvinnor";0;54;3460;3514;0,0153671030165054;1,54
2022;"0882";"Män";0;60;7705;7765;0,0077269800386349;0,77
2022;"0882";"Kvinnor";0;117;5938;6055;0,0193228736581338;1,93
2022;"0883";"Män";0;99;7362;7461;0,0132689987937274;1,33
2022;"0883";"Kvinnor";0;165;7239;7404;0,0222852512155592;2,23
2022;"0884";"Män";0;263;3966;4229;0,0621896429415938;6,22
2022;"0884";"Kvinnor";0;335;3023;3358;0,0997617629541394;9,98
2022;"0885";"Män";0;54;1912;1966;0,0274669379450661;2,75
2022;"0885";"Kvinnor";0;85;1768;1853;0,0458715596330275;4,59
2022;"0980";"Män";0;414;13274;13688;0,0302454704850964;3,02
2022;"0980";"Kvinnor";0;525;12791;13316;0,0394262541303695;3,94
2022;"1060";"Män";0;27;4074;4101;0,00658376005852231;0,66
2022;"1060";"Kvinnor";0;39;2442;2481;0,0157194679564692;1,57
2022;"1080";"Män";0;419;16217;16636;0,0251863428708824;2,52
2022;"1080";"Kvinnor";0;414;14097;14511;0,0285300806284887;2,85
2022;"1081";"Män";0;78;5338;5416;0,0144017725258493;1,44
2022;"1081";"Kvinnor";0;83;4309;4392;0,0188979963570127;1,89
2022;"1082";"Män";0;115;6292;6407;0,0179491181520212;1,79
2022;"1082";"Kvinnor";0;132;6082;6214;0,0212423559703894;2,12
2022;"1083";"Män";0;54;3146;3200;0,016875;1,69
2022;"1083";"Kvinnor";0;79;2566;2645;0,0298676748582231;2,99
2022;"1214";"Män";0;20;1756;1776;0,0112612612612613;1,13
2022;"1214";"Kvinnor";0;26;1806;1832;0,0141921397379913;1,42
2022;"1230";"Män";0;65;3900;3965;0,0163934426229508;1,64
2022;"1230";"Kvinnor";0;44;2935;2979;0,0147700570661296;1,48
2022;"1231";"Män";0;56;5559;5615;0,00997328584149599;1
2022;"1231";"Kvinnor";0;110;3253;3363;0,0327088908712459;3,27
2022;"1233";"Män";0;132;4270;4402;0,0299863698318946;3
2022;"1233";"Kvinnor";0;194;4553;4747;0,0408679165788919;4,09
2022;"1256";"Män";0;48;1949;1997;0,0240360540811217;2,4
2022;"1256";"Kvinnor";0;64;1652;1716;0,0372960372960373;3,73
2022;"1257";"Män";0;20;1814;1834;0,0109051254089422;1,09
2022;"1257";"Kvinnor";0;32;1514;1546;0,0206985769728331;2,07
2022;"1260";"Män";0;12;2804;2816;0,00426136363636364;0,43
2022;"1260";"Kvinnor";0;19;2337;2356;0,00806451612903226;0,81
2022;"1261";"Män";0;83;4011;4094;0,0202735710796287;2,03
2022;"1261";"Kvinnor";0;188;3773;3961;0,0474627619288059;4,75
2022;"1262";"Män";0;115;2637;2752;0,0417877906976744;4,18
2022;"1262";"Kvinnor";0;137;3237;3374;0,0406046235921755;4,06
2022;"1263";"Män";0;77;3645;3722;0,0206878022568512;2,07
2022;"1263";"Kvinnor";0;91;3108;3199;0,0284463894967177;2,84
2022;"1264";"Män";0;54;2081;2135;0,0252927400468384;2,53
2022;"1264";"Kvinnor";0;64;2026;2090;0,030622009569378;3,06
2022;"1265";"Män";0;52;2860;2912;0,0178571428571429;1,79
2022;"1265";"Kvinnor";0;48;2914;2962;0,0162052667116813;1,62
2022;"1266";"Män";0;29;2413;2442;0,0118755118755119;1,19
2022;"1266";"Kvinnor";0;43;2266;2309;0,0186227804244262;1,86
2022;"1267";"Män";0;56;2031;2087;0,0268327743172017;2,68
2022;"1267";"Kvinnor";0;61;2572;2633;0,02316748955564;2,32
2022;"1270";"Män";0;63;2659;2722;0,0231447465099192;2,31
2022;"1270";"Kvinnor";0;69;2249;2318;0,0297670405522002;2,98
2022;"1272";"Män";0;34;2375;2409;0,0141137401411374;1,41
2022;"1272";"Kvinnor";0;39;1838;1877;0,0207778369738945;2,08
2022;"1273";"Män";0;37;2134;2171;0,0170428374021188;1,7
2022;"1273";"Kvinnor";0;44;1963;2007;0,0219232685600399;2,19
2022;"1275";"Män";0;4;1852;1856;0,0021551724137931;0,22
2022;"1275";"Kvinnor";0;10;1231;1241;0,008058017727639;0,81
2022;"1276";"Män";0;81;3274;3355;0,0241430700447094;2,41
2022;"1276";"Kvinnor";0;57;2804;2861;0,0199231038098567;1,99
2022;"1277";"Män";0;25;3097;3122;0,00800768737988469;0,8
2022;"1277";"Kvinnor";0;38;2629;2667;0,0142482189726284;1,42
2022;"1278";"Män";0;66;3463;3529;0,0187021819212241;1,87
2022;"1278";"Kvinnor";0;107;3154;3261;0,0328120208524992;3,28
2022;"1280";"Män";0;5811;95669;101480;0,0572625147812377;5,73
2022;"1280";"Kvinnor";0;6288;90114;96402;0,0652268625132259;6,52
2022;"1281";"Män";0;894;35193;36087;0,0247734641283565;2,48
2022;"1281";"Kvinnor";0;1305;35828;37133;0,0351439420461584;3,51
2022;"1282";"Män";0;192;8477;8669;0,0221478832621986;2,21
2022;"1282";"Kvinnor";0;198;6957;7155;0,0276729559748428;2,77
2022;"1283";"Män";0;1429;37228;38657;0,0369661380862457;3,7
2022;"1283";"Kvinnor";0;1745;33581;35326;0,0493970446696484;4,94
2022;"1284";"Män";0;130;4228;4358;0,0298301973382285;2,98
2022;"1284";"Kvinnor";0;182;4042;4224;0,0430871212121212;4,31
2022;"1285";"Män";0;271;5406;5677;0,0477364805354941;4,77
2022;"1285";"Kvinnor";0;225;5051;5276;0,0426459438968916;4,26
2022;"1286";"Män";0;161;6125;6286;0,0256124721603563;2,56
2022;"1286";"Kvinnor";0;256;6489;6745;0,0379540400296516;3,8
2022;"1287";"Män";0;127;6287;6414;0,0198004365450577;1,98
2022;"1287";"Kvinnor";0;164;6310;6474;0,0253320976212542;2,53
2022;"1290";"Män";0;484;18803;19287;0,0250946233214082;2,51
2022;"1290";"Kvinnor";0;695;18436;19131;0,0363284721133239;3,63
2022;"1291";"Män";0;123;3384;3507;0,0350727117194183;3,51
2022;"1291";"Kvinnor";0;175;3396;3571;0,0490058807056847;4,9
2022;"1292";"Män";0;256;9212;9468;0,0270384452893959;2,7
2022;"1292";"Kvinnor";0;337;9077;9414;0,0357977480348417;3,58
2022;"1293";"Män";0;183;10596;10779;0,0169774561647648;1,7
2022;"1293";"Kvinnor";0;213;9317;9530;0,0223504721930745;2,24
2022;"1315";"Män";0;32;2447;2479;0,0129084308188786;1,29
2022;"1315";"Kvinnor";0;33;1858;1891;0,017451084082496;1,75
2022;"1380";"Män";0;592;25870;26462;0,0223717028191369;2,24
2022;"1380";"Kvinnor";0;809;23856;24665;0,0327995134806406;3,28
2022;"1381";"Män";0;137;4300;4437;0,0308767185034934;3,09
2022;"1381";"Kvinnor";0;124;4003;4127;0,0300460382844681;3
2022;"1382";"Män";0;307;10121;10428;0,029439969313387;2,94
2022;"1382";"Kvinnor";0;423;9842;10265;0,0412079883097905;4,12
2022;"1383";"Män";0;404;15060;15464;0,0261251939989653;2,61
2022;"1383";"Kvinnor";0;679;14377;15056;0,0450982996811902;4,51
2022;"1384";"Män";0;515;11474;11989;0,0429560430394528;4,3
2022;"1384";"Kvinnor";0;804;12597;13401;0,0599955227221849;6
2022;"1401";"Män";0;191;9064;9255;0,0206374932468936;2,06
2022;"1401";"Kvinnor";0;194;6816;7010;0,0276747503566334;2,77
2022;"1402";"Män";0;261;6159;6420;0,0406542056074766;4,07
2022;"1402";"Kvinnor";0;388;5274;5662;0,0685270222536206;6,85
2022;"1407";"Män";0;27;1659;1686;0,0160142348754448;1,6
2022;"1407";"Kvinnor";0;55;1587;1642;0,0334957369062119;3,35
2022;"1415";"Män";0;83;7011;7094;0,011700028192839;1,17
2022;"1415";"Kvinnor";0;173;5136;5309;0,0325861744207949;3,26
2022;"1419";"Män";0;28;2198;2226;0,0125786163522013;1,26
2022;"1419";"Kvinnor";0;65;2188;2253;0,0288504216600089;2,89
2022;"1421";"Män";0;31;2374;2405;0,0128898128898129;1,29
2022;"1421";"Kvinnor";0;43;2083;2126;0,0202257761053622;2,02
2022;"1427";"Män";0;23;1913;1936;0,0118801652892562;1,19
2022;"1427";"Kvinnor";0;41;1812;1853;0,0221262817053427;2,21
2022;"1430";"Män";0;80;1757;1837;0,0435492651061513;4,35
2022;"1430";"Kvinnor";0;86;1722;1808;0,0475663716814159;4,76
2022;"1435";"Män";0;72;2649;2721;0,0264608599779493;2,65
2022;"1435";"Kvinnor";0;127;2220;2347;0,0541116318704729;5,41
2022;"1438";"Män";0;5;1103;1108;0,00451263537906137;0,45
2022;"1438";"Kvinnor";0;11;849;860;0,0127906976744186;1,28
2022;"1439";"Män";0;4;1107;1111;0,0036003600360036;0,36
2022;"1439";"Kvinnor";0;4;958;962;0,00415800415800416;0,42
2022;"1440";"Män";0;72;3785;3857;0,0186673580502982;1,87
2022;"1440";"Kvinnor";0;102;3881;3983;0,0256088375596284;2,56
2022;"1441";"Män";0;164;4599;4763;0,0344320806214571;3,44
2022;"1441";"Kvinnor";0;233;5509;5742;0,0405781957506095;4,06
2022;"1442";"Män";0;24;3372;3396;0,00706713780918728;0,71
2022;"1442";"Kvinnor";0;19;2125;2144;0,00886194029850746;0,89
2022;"1443";"Män";0;48;1284;1332;0,036036036036036;3,6
2022;"1443";"Kvinnor";0;63;1131;1194;0,0527638190954774;5,28
2022;"1444";"Män";0;3;894;897;0,00334448160535117;0,33
2022;"1444";"Kvinnor";0;21;860;881;0,0238365493757094;2,38
2022;"1445";"Män";0;25;1089;1114;0,0224416517055655;2,24
2022;"1445";"Kvinnor";0;38;925;963;0,039460020768432;3,95
2022;"1446";"Män";0;27;1633;1660;0,0162650602409639;1,63
2022;"1446";"Kvinnor";0;30;1183;1213;0,0247320692497939;2,47
2022;"1447";"Män";0;5;883;888;0,00563063063063063;0,56
2022;"1447";"Kvinnor";0;10;720;730;0,0136986301369863;1,37
2022;"1452";"Män";0;77;3390;3467;0,0222094029420248;2,22
2022;"1452";"Kvinnor";0;110;2224;2334;0,0471293916023993;4,71
2022;"1460";"Män";0;44;2008;2052;0,0214424951267057;2,14
2022;"1460";"Kvinnor";0;73;1772;1845;0,0395663956639566;3,96
2022;"1461";"Män";0;19;1597;1616;0,0117574257425743;1,18
2022;"1461";"Kvinnor";0;59;1341;1400;0,0421428571428571;4,21
2022;"1462";"Män";0;19;1866;1885;0,010079575596817;1,01
2022;"1462";"Kvinnor";0;27;1803;1830;0,0147540983606557;1,48
2022;"1463";"Män";0;171;5477;5648;0,0302762039660057;3,03
2022;"1463";"Kvinnor";0;192;5341;5533;0,0347008855955178;3,47
2022;"1465";"Män";0;265;1837;2102;0,126070409134158;12,61
2022;"1465";"Kvinnor";0;246;1758;2004;0,122754491017964;12,28
2022;"1466";"Män";0;13;2105;2118;0,00613786591123702;0,61
2022;"1466";"Kvinnor";0;25;1497;1522;0,0164257555847569;1,64
2022;"1470";"Män";0;57;4499;4556;0,0125109745390694;1,25
2022;"1470";"Kvinnor";0;69;2983;3052;0,022608125819135;2,26
2022;"1471";"Män";0;28;3944;3972;0,00704934541792548;0,7
2022;"1471";"Kvinnor";0;32;2574;2606;0,012279355333845;1,23
2022;"1472";"Män";0;16;1695;1711;0,00935125657510228;0,94
2022;"1472";"Kvinnor";0;22;1685;1707;0,012888107791447;1,29
2022;"1473";"Män";0;15;1771;1786;0,0083986562150056;0,84
2022;"1473";"Kvinnor";0;25;1464;1489;0,0167897918065816;1,68
2022;"1480";"Män";0;7325;188719;196044;0,0373640611291343;3,74
2022;"1480";"Kvinnor";0;9452;167154;176606;0,053520265449645;5,35
2022;"1481";"Män";0;637;22965;23602;0,0269892382001525;2,7
2022;"1481";"Kvinnor";0;1050;19370;20420;0,0514201762977473;5,14
2022;"1482";"Män";0;205;8934;9139;0,0224313382208119;2,24
2022;"1482";"Kvinnor";0;236;8762;8998;0,0262280506779284;2,62
2022;"1484";"Män";0;49;3137;3186;0,0153797865662272;1,54
2022;"1484";"Kvinnor";0;61;2468;2529;0,0241202056148675;2,41
2022;"1485";"Män";0;287;12089;12376;0,0231900452488688;2,32
2022;"1485";"Kvinnor";0;526;11830;12356;0,0425704111362901;4,26
2022;"1486";"Män";0;50;2794;2844;0,0175808720112518;1,76
2022;"1486";"Kvinnor";0;183;2762;2945;0,0621392190152801;6,21
2022;"1487";"Män";0;151;6420;6571;0,0229797595495358;2,3
2022;"1487";"Kvinnor";0;218;6871;7089;0,0307518690929609;3,08
2022;"1488";"Män";0;287;13888;14175;0,0202469135802469;2,02
2022;"1488";"Kvinnor";0;402;13574;13976;0,0287635947338294;2,88
2022;"1489";"Män";0;218;6740;6958;0,0313308421960333;3,13
2022;"1489";"Kvinnor";0;313;7787;8100;0,038641975308642;3,86
2022;"1490";"Män";0;2246;26837;29083;0,0772272461575491;7,72
2022;"1490";"Kvinnor";0;2900;25889;28789;0,100732918823162;10,07
2022;"1491";"Män";0;248;4916;5164;0,0480247869868319;4,8
2022;"1491";"Kvinnor";0;397;3977;4374;0,0907636031092821;9,08
2022;"1492";"Män";0;28;2245;2273;0,0123185217773867;1,23
2022;"1492";"Kvinnor";0;44;1943;1987;0,0221439355812783;2,21
2022;"1493";"Män";0;99;4958;5057;0,0195768242040736;1,96
2022;"1493";"Kvinnor";0;123;4222;4345;0,0283084004602992;2,83
2022;"1494";"Män";0;186;9186;9372;0,0198463508322663;1,98
2022;"1494";"Kvinnor";0;267;8567;8834;0,0302241340276206;3,02
2022;"1495";"Män";0;79;4345;4424;0,0178571428571429;1,79
2022;"1495";"Kvinnor";0;101;4009;4110;0,0245742092457421;2,46
2022;"1496";"Män";0;477;17889;18366;0,0259719046063378;2,6
2022;"1496";"Kvinnor";0;434;16174;16608;0,0261319845857418;2,61
2022;"1497";"Män";0;18;1487;1505;0,0119601328903654;1,2
2022;"1497";"Kvinnor";0;21;1437;1458;0,01440329218107;1,44
2022;"1498";"Män";0;40;2524;2564;0,015600624024961;1,56
2022;"1498";"Kvinnor";0;71;2142;2213;0,0320831450519657;3,21
2022;"1499";"Män";0;99;6410;6509;0,0152097096328161;1,52
2022;"1499";"Kvinnor";0;143;5646;5789;0,0247020210744515;2,47
2022;"1715";"Män";0;30;1644;1674;0,017921146953405;1,79
2022;"1715";"Kvinnor";0;35;1439;1474;0,0237449118046133;2,37
2022;"1730";"Män";0;14;1430;1444;0,00969529085872576;0,97
2022;"1730";"Kvinnor";0;94;1721;1815;0,0517906336088154;5,18
2022;"1737";"Män";0;26;2330;2356;0,0110356536502547;1,1
2022;"1737";"Kvinnor";0;47;2368;2415;0,0194616977225673;1,95
2022;"1760";"Män";0;8;477;485;0,0164948453608247;1,65
2022;"1760";"Kvinnor";0;5;424;429;0,0116550116550117;1,17
2022;"1761";"Män";0;37;1917;1954;0,018935516888434;1,89
2022;"1761";"Kvinnor";0;53;1942;1995;0,0265664160401003;2,66
2022;"1762";"Män";0;11;819;830;0,0132530120481928;1,33
2022;"1762";"Kvinnor";0;4;713;717;0,00557880055788006;0,56
2022;"1763";"Män";0;14;1085;1099;0,0127388535031847;1,27
2022;"1763";"Kvinnor";0;24;1480;1504;0,0159574468085106;1,6
2022;"1764";"Män";0;9;2077;2086;0,00431447746883989;0,43
2022;"1764";"Kvinnor";0;16;1268;1284;0,0124610591900312;1,25
2022;"1765";"Män";0;15;1960;1975;0,00759493670886076;0,76
2022;"1765";"Kvinnor";0;81;1820;1901;0,0426091530773277;4,26
2022;"1766";"Män";0;133;2609;2742;0,0485047410649161;4,85
2022;"1766";"Kvinnor";0;138;2233;2371;0,0582032897511598;5,82
2022;"1780";"Män";0;830;27898;28728;0,0288916736285157;2,89
2022;"1780";"Kvinnor";0;1050;26234;27284;0,0384840932414602;3,85
2022;"1781";"Män";0;47;4188;4235;0,0110979929161747;1,11
2022;"1781";"Kvinnor";0;108;3475;3583;0,030142338822216;3,01
2022;"1782";"Män";0;16;1680;1696;0,00943396226415094;0,94
2022;"1782";"Kvinnor";0;43;1490;1533;0,0280495759947815;2,8
2022;"1783";"Män";0;30;2433;2463;0,0121802679658952;1,22
2022;"1783";"Kvinnor";0;37;1750;1787;0,0207050923335199;2,07
2022;"1784";"Män";0;79;5465;5544;0,0142496392496392;1,42
2022;"1784";"Kvinnor";0;133;4952;5085;0,0261553588987217;2,62
2022;"1785";"Män";0;24;2789;2813;0,00853181656594383;0,85
2022;"1785";"Kvinnor";0;70;2432;2502;0,0279776179056755;2,8
2022;"1814";"Män";0;13;1127;1140;0,0114035087719298;1,14
2022;"1814";"Kvinnor";0;16;1059;1075;0,0148837209302326;1,49
2022;"1860";"Män";0;4;1246;1250;0,0032;0,32
2022;"1860";"Kvinnor";0;13;813;826;0,0157384987893462;1,57
2022;"1861";"Män";0;48;4193;4241;0,0113180853572271;1,13
2022;"1861";"Kvinnor";0;45;3265;3310;0,013595166163142;1,36
2022;"1862";"Män";0;7;1436;1443;0,00485100485100485;0,49
2022;"1862";"Kvinnor";0;14;1094;1108;0,0126353790613718;1,26
2022;"1863";"Män";0;14;1312;1326;0,0105580693815988;1,06
2022;"1863";"Kvinnor";0;22;1107;1129;0,0194862710363153;1,95
2022;"1864";"Män";0;15;767;782;0,0191815856777494;1,92
2022;"1864";"Kvinnor";0;15;704;719;0,0208623087621697;2,09
2022;"1880";"Män";0;1168;41805;42973;0,0271798571195867;2,72
2022;"1880";"Kvinnor";0;1419;39239;40658;0,0349008805155197;3,49
2022;"1881";"Män";0;76;3512;3588;0,0211817168338907;2,12
2022;"1881";"Kvinnor";0;81;3338;3419;0,0236911377595788;2,37
2022;"1882";"Män";0;22;2352;2374;0,0092670598146588;0,93
2022;"1882";"Kvinnor";0;49;1704;1753;0,0279520821448945;2,8
2022;"1883";"Män";0;134;7502;7636;0,0175484546883185;1,75
2022;"1883";"Kvinnor";0;162;6375;6537;0,0247820100963745;2,48
2022;"1884";"Män";0;37;1506;1543;0,0239792611795204;2,4
2022;"1884";"Kvinnor";0;67;1549;1616;0,041460396039604;4,15
2022;"1885";"Män";0;45;5002;5047;0,00891618783435704;0,89
2022;"1885";"Kvinnor";0;60;4660;4720;0,0127118644067797;1,27
2022;"1904";"Män";0;6;872;878;0,00683371298405467;0,68
2022;"1904";"Kvinnor";0;7;645;652;0,0107361963190184;1,07
2022;"1907";"Män";0;6;1293;1299;0,0046189376443418;0,46
2022;"1907";"Kvinnor";0;7;1153;1160;0,00603448275862069;0,6
2022;"1960";"Män";0;14;1391;1405;0,0099644128113879;1
2022;"1960";"Kvinnor";0;16;1060;1076;0,0148698884758364;1,49
2022;"1961";"Män";0;24;2418;2442;0,00982800982800983;0,98
2022;"1961";"Kvinnor";0;15;2540;2555;0,00587084148727984;0,59
2022;"1962";"Män";0;10;805;815;0,0122699386503067;1,23
2022;"1962";"Kvinnor";0;17;740;757;0,0224570673712021;2,25
2022;"1980";"Män";0;889;38752;39641;0,0224262758255342;2,24
2022;"1980";"Kvinnor";0;1193;35427;36620;0,0325778263244129;3,26
2022;"1981";"Män";0;70;3996;4066;0,0172159370388588;1,72
2022;"1981";"Kvinnor";0;105;3814;3919;0,0267925491196734;2,68
2022;"1982";"Män";0;21;3223;3244;0,00647348951911221;0,65
2022;"1982";"Kvinnor";0;37;2692;2729;0,0135580798827409;1,36
2022;"1983";"Män";0;71;5986;6057;0,011721974574872;1,17
2022;"1983";"Kvinnor";0;92;5150;5242;0,0175505532239603;1,76
2022;"1984";"Män";0;22;2477;2499;0,00880352140856343;0,88
2022;"1984";"Kvinnor";0;33;1976;2009;0,0164260826281732;1,64
2022;"2021";"Män";0;9;1539;1548;0,00581395348837209;0,58
2022;"2021";"Kvinnor";0;21;1404;1425;0,0147368421052632;1,47
2022;"2023";"Män";0;34;2794;2828;0,012022630834512;1,2
2022;"2023";"Kvinnor";0;42;2527;2569;0,0163487738419619;1,63
2022;"2026";"Män";0;21;1318;1339;0,0156833457804332;1,57
2022;"2026";"Kvinnor";0;20;1334;1354;0,0147710487444609;1,48
2022;"2029";"Män";0;173;3188;3361;0,0514727759595359;5,15
2022;"2029";"Kvinnor";0;181;2885;3066;0,0590345727332029;5,9
2022;"2031";"Män";0;88;1896;1984;0,0443548387096774;4,44
2022;"2031";"Kvinnor";0;90;1880;1970;0,0456852791878173;4,57
2022;"2034";"Män";0;32;1013;1045;0,030622009569378;3,06
2022;"2034";"Kvinnor";0;19;939;958;0,0198329853862213;1,98
2022;"2039";"Män";0;20;1555;1575;0,0126984126984127;1,27
2022;"2039";"Kvinnor";0;23;1307;1330;0,0172932330827068;1,73
2022;"2061";"Män";0;20;1530;1550;0,0129032258064516;1,29
2022;"2061";"Kvinnor";0;21;1286;1307;0,0160673297628156;1,61
2022;"2062";"Män";0;95;5251;5346;0,0177702955480733;1,78
2022;"2062";"Kvinnor";0;157;4756;4913;0,0319560350091594;3,2
2022;"2080";"Män";0;535;12474;13009;0,0411253747405642;4,11
2022;"2080";"Kvinnor";0;540;14276;14816;0,0364470842332613;3,64
2022;"2081";"Män";0;181;14848;15029;0,0120433827932664;1,2
2022;"2081";"Kvinnor";0;342;11414;11756;0,0290915277305206;2,91
2022;"2082";"Män";0;23;1548;1571;0,014640356460853;1,46
2022;"2082";"Kvinnor";0;38;1540;1578;0,0240811153358682;2,41
2022;"2083";"Män";0;58;3277;3335;0,0173913043478261;1,74
2022;"2083";"Kvinnor";0;75;2688;2763;0,0271444082519001;2,71
2022;"2084";"Män";0;107;5309;5416;0,0197562776957164;1,98
2022;"2084";"Kvinnor";0;155;4187;4342;0,0356978350990327;3,57
2022;"2085";"Män";0;39;6573;6612;0,0058983666061706;0,59
2022;"2085";"Kvinnor";0;74;5207;5281;0,014012497633024;1,4
2022;"2101";"Män";0;15;916;931;0,0161117078410312;1,61
2022;"2101";"Kvinnor";0;15;789;804;0,0186567164179104;1,87
2022;"2104";"Män";0;13;1800;1813;0,00717043574186431;0,72
2022;"2104";"Kvinnor";0;23;1326;1349;0,0170496664195701;1,7
2022;"2121";"Män";0;22;2959;2981;0,00738007380073801;0,74
2022;"2121";"Kvinnor";0;45;2164;2209;0,0203712086917157;2,04
2022;"2132";"Män";0;20;1437;1457;0,0137268359643102;1,37
2022;"2132";"Kvinnor";0;33;1104;1137;0,029023746701847;2,9
2022;"2161";"Män";0;141;3687;3828;0,036833855799373;3,68
2022;"2161";"Kvinnor";0;223;3315;3538;0,0630299604296213;6,3
2022;"2180";"Män";0;604;23781;24385;0,0247693254049621;2,48
2022;"2180";"Kvinnor";0;776;23488;24264;0,031981536432575;3,2
2022;"2181";"Män";0;96;8935;9031;0,0106300520429631;1,06
2022;"2181";"Kvinnor";0;159;6713;6872;0,0231373690337602;2,31
2022;"2182";"Män";0;90;4945;5035;0,0178748758689176;1,79
2022;"2182";"Kvinnor";0;132;3929;4061;0,0325043092834277;3,25
2022;"2183";"Män";0;135;5041;5176;0,0260819165378671;2,61
2022;"2183";"Kvinnor";0;127;5252;5379;0,0236103364937721;2,36
2022;"2184";"Män";0;162;8562;8724;0,0185694635488308;1,86
2022;"2184";"Kvinnor";0;198;7813;8011;0,0247160154787168;2,47
2022;"2260";"Män";0;55;1927;1982;0,0277497477295661;2,77
2022;"2260";"Kvinnor";0;59;1639;1698;0,0347467608951708;3,47
2022;"2262";"Män";0;23;3063;3086;0,00745301360985094;0,75
2022;"2262";"Kvinnor";0;23;2149;2172;0,0105893186003683;1,06
2022;"2280";"Män";0;156;4388;4544;0,034330985915493;3,43
2022;"2280";"Kvinnor";0;225;4788;5013;0,0448833034111311;4,49
2022;"2281";"Män";0;500;24821;25321;0,0197464555112357;1,97
2022;"2281";"Kvinnor";0;728;23373;24101;0,0302062155097299;3,02
2022;"2282";"Män";0;39;3990;4029;0,00967982129560685;0,97
2022;"2282";"Kvinnor";0;49;3173;3222;0,0152079453755431;1,52
2022;"2283";"Män";0;51;3660;3711;0,0137429264349232;1,37
2022;"2283";"Kvinnor";0;77;3401;3478;0,0221391604370328;2,21
2022;"2284";"Män";0;236;12515;12751;0,0185083522860952;1,85
2022;"2284";"Kvinnor";0;369;10582;10951;0,0336955529175418;3,37
2022;"2303";"Män";0;6;1058;1064;0,0056390977443609;0,56
2022;"2303";"Kvinnor";0;10;871;881;0,0113507377979569;1,14
2022;"2305";"Män";0;29;1117;1146;0,0253054101221641;2,53
2022;"2305";"Kvinnor";0;24;948;972;0,0246913580246914;2,47
2022;"2309";"Män";0;29;2376;2405;0,0120582120582121;1,21
2022;"2309";"Kvinnor";0;22;2058;2080;0,0105769230769231;1,06
2022;"2313";"Män";0;12;2480;2492;0,00481540930979133;0,48
2022;"2313";"Kvinnor";0;31;2110;2141;0,014479215319944;1,45
2022;"2321";"Män";0;114;2869;2983;0,0382165605095541;3,82
2022;"2321";"Kvinnor";0;103;2633;2736;0,0376461988304094;3,76
2022;"2326";"Män";0;18;1311;1329;0,0135440180586907;1,35
2022;"2326";"Kvinnor";0;18;1102;1120;0,0160714285714286;1,61
2022;"2361";"Män";0;18;2286;2304;0,0078125;0,78
2022;"2361";"Kvinnor";0;24;2148;2172;0,0110497237569061;1,1
2022;"2380";"Män";0;559;16912;17471;0,0319958788850094;3,2
2022;"2380";"Kvinnor";0;718;17146;17864;0,040192566054635;4,02
2022;"2401";"Män";0;23;1025;1048;0,0219465648854962;2,19
2022;"2401";"Kvinnor";0;28;944;972;0,0288065843621399;2,88
2022;"2403";"Män";0;1;350;351;0,00284900284900285;0,28
2022;"2403";"Kvinnor";0;4;370;374;0,0106951871657754;1,07
2022;"2404";"Män";0;12;1206;1218;0,00985221674876847;0,99
2022;"2404";"Kvinnor";0;12;924;936;0,0128205128205128;1,28
2022;"2409";"Män";0;12;1034;1046;0,011472275334608;1,15
2022;"2409";"Kvinnor";0;5;974;979;0,00510725229826353;0,51
2022;"2417";"Män";0;7;791;798;0,0087719298245614;0,88
2022;"2417";"Kvinnor";0;15;683;698;0,0214899713467049;2,15
2022;"2418";"Män";0;1;548;549;0,00182149362477231;0,18
2022;"2418";"Kvinnor";0;14;490;504;0,0277777777777778;2,78
2022;"2421";"Män";0;14;1237;1251;0,0111910471622702;1,12
2022;"2421";"Kvinnor";0;17;1078;1095;0,0155251141552511;1,55
2022;"2422";"Män";0;3;455;458;0,00655021834061135;0,66
2022;"2422";"Kvinnor";0;7;408;415;0,0168674698795181;1,69
2022;"2425";"Män";0;3;535;538;0,00557620817843866;0,56
2022;"2425";"Kvinnor";0;8;471;479;0,0167014613778706;1,67
2022;"2460";"Män";0;8;1180;1188;0,00673400673400673;0,67
2022;"2460";"Kvinnor";0;16;1187;1203;0,0133000831255195;1,33
2022;"2462";"Män";0;19;1106;1125;0,0168888888888889;1,69
2022;"2462";"Kvinnor";0;19;1145;1164;0,0163230240549828;1,63
2022;"2463";"Män";0;6;506;512;0,01171875;1,17
2022;"2463";"Kvinnor";0;17;446;463;0,0367170626349892;3,67
2022;"2480";"Män";0;954;33704;34658;0,0275261122973051;2,75
2022;"2480";"Kvinnor";0;1105;31755;32860;0,0336275106512477;3,36
2022;"2481";"Män";0;25;3031;3056;0,00818062827225131;0,82
2022;"2481";"Kvinnor";0;54;2832;2886;0,0187110187110187;1,87
2022;"2482";"Män";0;367;18301;18668;0,0196593100492822;1,97
2022;"2482";"Kvinnor";0;471;15128;15599;0,0301942432207193;3,02
2022;"2505";"Män";0;11;1255;1266;0,00868878357030016;0,87
2022;"2505";"Kvinnor";0;29;1141;1170;0,0247863247863248;2,48
2022;"2506";"Män";0;4;692;696;0,00574712643678161;0,57
2022;"2506";"Kvinnor";0;19;539;558;0,0340501792114695;3,41
2022;"2510";"Män";0;28;919;947;0,0295670538542767;2,96
2022;"2510";"Kvinnor";0;52;824;876;0,0593607305936073;5,94
2022;"2513";"Män";0;4;707;711;0,00562587904360056;0,56
2022;"2513";"Kvinnor";0;16;543;559;0,0286225402504472;2,86
2022;"2514";"Män";0;41;3210;3251;0,0126115041525684;1,26
2022;"2514";"Kvinnor";0;66;2784;2850;0,0231578947368421;2,32
2022;"2518";"Män";0;15;688;703;0,0213371266002845;2,13
2022;"2518";"Kvinnor";0;19;612;631;0,0301109350237718;3,01
2022;"2521";"Män";0;36;1146;1182;0,0304568527918782;3,05
2022;"2521";"Kvinnor";0;23;925;948;0,0242616033755274;2,43
2022;"2523";"Män";0;52;4853;4905;0,0106014271151886;1,06
2022;"2523";"Kvinnor";0;65;3772;3837;0,016940317956737;1,69
2022;"2560";"Män";0;2;1420;1422;0,00140646976090014;0,14
2022;"2560";"Kvinnor";0;24;1219;1243;0,0193081255028158;1,93
2022;"2580";"Män";0;618;21732;22350;0,0276510067114094;2,77
2022;"2580";"Kvinnor";0;844;19319;20163;0,0418588503694887;4,19
2022;"2581";"Män";0;155;8848;9003;0,0172164833944241;1,72
2022;"2581";"Kvinnor";0;211;7831;8042;0,0262372544143248;2,62
2022;"2582";"Män";0;99;5477;5576;0,0177546628407461;1,78
2022;"2582";"Kvinnor";0;102;4873;4975;0,0205025125628141;2,05
2022;"2583";"Män";0;22;1490;1512;0,0145502645502645;1,46
2022;"2583";"Kvinnor";0;35;1504;1539;0,0227420402858999;2,27
2022;"2584";"Män";0;78;6635;6713;0,0116192462386414;1,16
2022;"2584";"Kvinnor";0;152;5192;5344;0,0284431137724551;2,84
2022;"9999";"Män";0;2861;244908;247769;0,0115470458370498;1,15
2022;"9999";"Kvinnor";0;2988;213914;216902;0,0137758065854626;1,38
2007;"01";"Män";1;37403;476733;514136;0,0727492336658005;7,27
2007;"01";"Kvinnor";1;41073;435556;476629;0,0861739424164287;8,62
2007;"03";"Män";1;2340;61526;63866;0,0366392133529578;3,66
2007;"03";"Kvinnor";1;2884;60466;63350;0,045524861878453;4,55
2007;"04";"Män";1;1756;51602;53358;0,0329097792271075;3,29
2007;"04";"Kvinnor";1;1998;46992;48990;0,040783833435395;4,08
2007;"05";"Män";1;2763;93756;96519;0,0286264880489852;2,86
2007;"05";"Kvinnor";1;3140;79918;83058;0,0378049074140962;3,78
2007;"06";"Män";1;2263;83664;85927;0,0263363087271754;2,63
2007;"06";"Kvinnor";1;2768;69212;71980;0,0384551264240067;3,85
2007;"07";"Män";1;2212;46041;48253;0,0458417093237726;4,58
2007;"07";"Kvinnor";1;2276;38048;40324;0,0564428132129749;5,64
2007;"08";"Män";1;1367;52024;53391;0,0256035661441067;2,56
2007;"08";"Kvinnor";1;1866;44780;46646;0,0400034300904686;4
2007;"09";"Män";1;477;11598;12075;0,0395031055900621;3,95
2007;"09";"Kvinnor";1;560;11360;11920;0,0469798657718121;4,7
2007;"10";"Män";1;923;34618;35541;0,0259700064713992;2,6
2007;"10";"Kvinnor";1;1121;28219;29340;0,0382072256305385;3,82
2007;"12";"Män";1;11530;248247;259777;0,0443842218518191;4,44
2007;"12";"Kvinnor";1;13123;225351;238474;0,0550290597717152;5,5
2007;"13";"Män";1;2695;57336;60031;0,0448934717062851;4,49
2007;"13";"Kvinnor";1;3931;51782;55713;0,0705580385188376;7,06
2007;"14";"Män";1;15727;362830;378557;0,0415446022659732;4,15
2007;"14";"Kvinnor";1;19166;316518;335684;0,0570953634966218;5,71
2007;"17";"Män";1;1506;57547;59053;0,0255025146901936;2,55
2007;"17";"Kvinnor";1;2105;49407;51512;0,0408642646373661;4,09
2007;"18";"Män";1;2018;61310;63328;0,0318658413340071;3,19
2007;"18";"Kvinnor";1;2335;54728;57063;0,0409196852601511;4,09
2007;"19";"Män";1;1559;55453;57012;0,0273451203255455;2,73
2007;"19";"Kvinnor";1;1975;47452;49427;0,0399579177372691;4
2007;"20";"Män";1;1789;60979;62768;0,0285017843487127;2,85
2007;"20";"Kvinnor";1;2031;52703;54734;0,0371067343881317;3,71
2007;"21";"Män";1;1621;60398;62019;0,0261371515180832;2,61
2007;"21";"Kvinnor";1;2149;51284;53433;0,0402185915071211;4,02
2007;"22";"Män";1;1577;54143;55720;0,0283022254127782;2,83
2007;"22";"Kvinnor";1;2114;47052;49166;0,0429971931822804;4,3
2007;"23";"Män";1;922;27757;28679;0,0321489591687297;3,21
2007;"23";"Kvinnor";1;944;26156;27100;0,0348339483394834;3,48
2007;"24";"Män";1;1552;57997;59549;0,0260625703202405;2,61
2007;"24";"Kvinnor";1;1841;50303;52144;0,0353060754832771;3,53
2007;"25";"Män";1;1384;55991;57375;0,0241220043572985;2,41
2007;"25";"Kvinnor";1;1966;46917;48883;0,0402184808624675;4,02
2007;"9999";"Män";1;1548;130104;131652;0,0117582718074925;1,18
2007;"9999";"Kvinnor";1;1483;155490;156973;0,00944748459926229;0,94
2008;"01";"Män";1;37773;488217;525990;0,0718131523412993;7,18
2008;"01";"Kvinnor";1;41904;443026;484930;0,0864124719031613;8,64
2008;"03";"Män";1;2320;60020;62340;0,0372152710940006;3,72
2008;"03";"Kvinnor";1;2866;60281;63147;0,0453861624463553;4,54
2008;"04";"Män";1;1849;51556;53405;0,0346222263832974;3,46
2008;"04";"Kvinnor";1;2159;46726;48885;0,0441648767515598;4,42
2008;"05";"Män";1;2770;94248;97018;0,0285514028324641;2,86
2008;"05";"Kvinnor";1;3227;79865;83092;0,0388364704183315;3,88
2008;"06";"Män";1;2258;83754;86012;0,0262521508626703;2,63
2008;"06";"Kvinnor";1;2763;69284;72047;0,0383499659944203;3,83
2008;"07";"Män";1;2186;46322;48508;0,0450647315906655;4,51
2008;"07";"Kvinnor";1;2312;38355;40667;0,0568519930164507;5,69
2008;"08";"Män";1;1437;51816;53253;0,0269843952453383;2,7
2008;"08";"Kvinnor";1;1839;44054;45893;0,0400714705946441;4,01
2008;"09";"Män";1;482;11654;12136;0,0397165458141068;3,97
2008;"09";"Kvinnor";1;543;11290;11833;0,0458886165807488;4,59
2008;"10";"Män";1;891;33931;34822;0,0255872724139912;2,56
2008;"10";"Kvinnor";1;1169;27591;28760;0,0406467315716273;4,06
2008;"12";"Män";1;12301;249846;262147;0,046924054061271;4,69
2008;"12";"Kvinnor";1;13356;226119;239475;0,0557720012527404;5,58
2008;"13";"Män";1;2686;57647;60333;0,0445195829811214;4,45
2008;"13";"Kvinnor";1;3974;52093;56067;0,070879483475128;7,09
2008;"14";"Män";1;15377;365678;381055;0,0403537547073257;4,04
2008;"14";"Kvinnor";1;19225;318757;337982;0,0568817274292714;5,69
2008;"17";"Män";1;1613;57312;58925;0,0273737802291048;2,74
2008;"17";"Kvinnor";1;2171;49000;51171;0,042426374313576;4,24
2008;"18";"Män";1;2003;61795;63798;0,0313959685256591;3,14
2008;"18";"Kvinnor";1;2325;54672;56997;0,0407916206116111;4,08
2008;"19";"Män";1;1547;55503;57050;0,0271165644171779;2,71
2008;"19";"Kvinnor";1;2038;47028;49066;0,0415358904332939;4,15
2008;"20";"Män";1;1747;60779;62526;0,0279403768032498;2,79
2008;"20";"Kvinnor";1;2083;52865;54948;0,0379085681007498;3,79
2008;"21";"Män";1;1667;61146;62813;0,0265390922261315;2,65
2008;"21";"Kvinnor";1;2264;51475;53739;0,0421295520943821;4,21
2008;"22";"Män";1;1559;53933;55492;0,028094139695812;2,81
2008;"22";"Kvinnor";1;2149;46639;48788;0,0440477166516356;4,4
2008;"23";"Män";1;883;27985;28868;0,0305875017320216;3,06
2008;"23";"Kvinnor";1;927;26120;27047;0,0342736717565719;3,43
2008;"24";"Män";1;1502;58408;59910;0,0250709397429478;2,51
2008;"24";"Kvinnor";1;1847;51192;53039;0,0348234318143253;3,48
2008;"25";"Män";1;1377;55862;57239;0,0240570240570241;2,41
2008;"25";"Kvinnor";1;1977;46737;48714;0,0405838157408548;4,06
2008;"9999";"Män";1;1349;122907;124256;0,0108566185938707;1,09
2008;"9999";"Kvinnor";1;1609;151602;153211;0,0105018569162789;1,05
2009;"01";"Män";1;36826;481606;518432;0,0710334238627245;7,1
2009;"01";"Kvinnor";1;41072;440200;481272;0,0853405143037617;8,53
2009;"03";"Män";1;2323;58919;61242;0,0379314849286437;3,79
2009;"03";"Kvinnor";1;2843;59746;62589;0,0454233171963125;4,54
2009;"04";"Män";1;1677;48402;50079;0,0334870903971725;3,35
2009;"04";"Kvinnor";1;2053;45210;47263;0,0434377843133106;4,34
2009;"05";"Män";1;2578;91486;94064;0,0274068719169927;2,74
2009;"05";"Kvinnor";1;3001;78285;81286;0,036919026646655;3,69
2009;"06";"Män";1;2165;78645;80810;0,0267912387080807;2,68
2009;"06";"Kvinnor";1;2491;66185;68676;0,0362717688857825;3,63
2009;"07";"Män";1;2240;43395;45635;0,0490851320258573;4,91
2009;"07";"Kvinnor";1;2297;36709;39006;0,0588883761472594;5,89
2009;"08";"Män";1;1460;49482;50942;0,0286600447567822;2,87
2009;"08";"Kvinnor";1;1808;42868;44676;0,0404691556988092;4,05
2009;"09";"Män";1;443;11511;11954;0,0370587251129329;3,71
2009;"09";"Kvinnor";1;538;10980;11518;0,0467094981767668;4,67
2009;"10";"Män";1;851;31938;32789;0,0259538259782244;2,6
2009;"10";"Kvinnor";1;1029;26835;27864;0,0369293712316968;3,69
2009;"12";"Män";1;11897;241613;253510;0,0469291152222792;4,69
2009;"12";"Kvinnor";1;13209;221848;235057;0,0561948803907137;5,62
2009;"13";"Män";1;2619;55788;58407;0,0448405156916123;4,48
2009;"13";"Kvinnor";1;3869;51354;55223;0,0700613874653677;7,01
2009;"14";"Män";1;14773;349520;364293;0,0405525222828877;4,06
2009;"14";"Kvinnor";1;18490;310816;329306;0,056148384784972;5,61
2009;"17";"Män";1;1582;53480;55062;0,0287312484108823;2,87
2009;"17";"Kvinnor";1;2023;47274;49297;0,0410369799379273;4,1
2009;"18";"Män";1;1905;58503;60408;0,0315355582042114;3,15
2009;"18";"Kvinnor";1;2197;52235;54432;0,0403622868900647;4,04
2009;"19";"Män";1;1395;52569;53964;0,0258505670446965;2,59
2009;"19";"Kvinnor";1;1915;45373;47288;0,0404965318896972;4,05
2009;"20";"Män";1;1659;58644;60303;0,0275110691010397;2,75
2009;"20";"Kvinnor";1;1958;51185;53143;0,0368439869785296;3,68
2009;"21";"Män";1;1561;57908;59469;0,0262489700516235;2,62
2009;"21";"Kvinnor";1;2114;49352;51466;0,0410756616018342;4,11
2009;"22";"Män";1;1414;51886;53300;0,0265290806754221;2,65
2009;"22";"Kvinnor";1;1965;45620;47585;0,0412945255857938;4,13
2009;"23";"Män";1;842;27059;27901;0,0301781298161356;3,02
2009;"23";"Kvinnor";1;855;25650;26505;0,032258064516129;3,23
2009;"24";"Män";1;1497;55487;56984;0,0262705320791801;2,63
2009;"24";"Kvinnor";1;1816;49294;51110;0,0355312072001565;3,55
2009;"25";"Män";1;1273;53758;55031;0,0231324162744635;2,31
2009;"25";"Kvinnor";1;1835;45429;47264;0,0388244752877454;3,88
2009;"9999";"Män";1;1377;122903;124280;0,0110798197618281;1,11
2009;"9999";"Kvinnor";1;1580;148732;150312;0,0105114694768215;1,05
2010;"01";"Män";1;37477;498655;536132;0,0699025613095283;6,99
2010;"01";"Kvinnor";1;42438;455426;497864;0,0852401459032989;8,52
2010;"03";"Män";1;2341;61519;63860;0,0366583150642029;3,67
2010;"03";"Kvinnor";1;2922;61882;64804;0,0450898092710326;4,51
2010;"04";"Män";1;1701;49749;51450;0,0330612244897959;3,31
2010;"04";"Kvinnor";1;2173;46014;48187;0,0450951501442298;4,51
2010;"05";"Män";1;2596;93324;95920;0,0270642201834862;2,71
2010;"05";"Kvinnor";1;3169;80307;83476;0,0379630073314486;3,8
2010;"06";"Män";1;2205;80945;83150;0,0265183403487673;2,65
2010;"06";"Kvinnor";1;2496;67873;70369;0,0354701644189913;3,55
2010;"07";"Män";1;2254;44133;46387;0,0485912001207235;4,86
2010;"07";"Kvinnor";1;2294;37160;39454;0,0581436609722715;5,81
2010;"08";"Män";1;1507;50581;52088;0,0289318077100292;2,89
2010;"08";"Kvinnor";1;1906;43762;45668;0,0417360077078042;4,17
2010;"09";"Män";1;478;11805;12283;0,038915574371082;3,89
2010;"09";"Kvinnor";1;553;11227;11780;0,0469439728353141;4,69
2010;"10";"Män";1;905;32187;33092;0,0273479995164995;2,73
2010;"10";"Kvinnor";1;1088;27186;28274;0,0384805828676523;3,85
2010;"12";"Män";1;10849;248380;259229;0,0418510274699204;4,19
2010;"12";"Kvinnor";1;13032;227661;240693;0,0541436601812267;5,41
2010;"13";"Män";1;2594;57782;60376;0,0429640916920631;4,3
2010;"13";"Kvinnor";1;4088;52653;56741;0,0720466681940748;7,2
2010;"14";"Män";1;15108;358370;373478;0,0404521819223622;4,05
2010;"14";"Kvinnor";1;18922;317858;336780;0,0561850466179702;5,62
2010;"17";"Män";1;1556;55188;56744;0,0274214013816439;2,74
2010;"17";"Kvinnor";1;2048;48536;50584;0,0404871105487901;4,05
2010;"18";"Män";1;1865;59636;61501;0,0303247101673144;3,03
2010;"18";"Kvinnor";1;2222;53017;55239;0,0402252032078785;4,02
2010;"19";"Män";1;1425;53667;55092;0,02586582443912;2,59
2010;"19";"Kvinnor";1;1942;46171;48113;0,0403633113711471;4,04
2010;"20";"Män";1;1629;60085;61714;0,0263959555368312;2,64
2010;"20";"Kvinnor";1;1969;52109;54078;0,0364103702059987;3,64
2010;"21";"Män";1;1562;59088;60650;0,0257543281121187;2,58
2010;"21";"Kvinnor";1;2095;50563;52658;0,0397850279159862;3,98
2010;"22";"Män";1;1386;51784;53170;0,0260673312018055;2,61
2010;"22";"Kvinnor";1;1888;45936;47824;0,0394780863164938;3,95
2010;"23";"Män";1;831;27200;28031;0,0296457493489351;2,96
2010;"23";"Kvinnor";1;875;25992;26867;0,0325678341459783;3,26
2010;"24";"Män";1;1515;56872;58387;0,0259475568191549;2,59
2010;"24";"Kvinnor";1;1836;50713;52549;0,034938819007022;3,49
2010;"25";"Män";1;1260;55712;56972;0,022116127220389;2,21
2010;"25";"Kvinnor";1;1845;46590;48435;0,0380922886342521;3,81
2010;"9999";"Män";1;1372;124495;125867;0,0109003948612424;1,09
2010;"9999";"Kvinnor";1;1789;154920;156709;0,0114160641698945;1,14
2011;"01";"Män";1;37991;512230;550221;0,0690468011944291;6,9
2011;"01";"Kvinnor";1;43085;462628;505713;0,0851965442849996;8,52
2011;"03";"Män";1;2344;63275;65619;0,0357213611911184;3,57
2011;"03";"Kvinnor";1;2936;62462;65398;0,0448943392764305;4,49
2011;"04";"Män";1;1629;51202;52831;0,0308341693323995;3,08
2011;"04";"Kvinnor";1;2092;46846;48938;0,0427479668151539;4,27
2011;"05";"Män";1;2525;94802;97327;0,0259434689243478;2,59
2011;"05";"Kvinnor";1;3075;80470;83545;0,0368065114608893;3,68
2011;"06";"Män";1;2070;82719;84789;0,0244135442097442;2,44
2011;"06";"Kvinnor";1;2387;68006;70393;0,033909621695339;3,39
2011;"07";"Män";1;2291;44824;47115;0,0486257030669638;4,86
2011;"07";"Kvinnor";1;2376;37293;39669;0,0598956363911367;5,99
2011;"08";"Män";1;1475;51052;52527;0,0280807965427304;2,81
2011;"08";"Kvinnor";1;1843;43868;45711;0,040318522893833;4,03
2011;"09";"Män";1;466;12010;12476;0,0373517152933633;3,74
2011;"09";"Kvinnor";1;563;11213;11776;0,0478091032608696;4,78
2011;"10";"Män";1;872;32510;33382;0,0261218620813612;2,61
2011;"10";"Kvinnor";1;1030;27060;28090;0,0366678533285867;3,67
2011;"12";"Män";1;11089;252510;263599;0,0420676861444846;4,21
2011;"12";"Kvinnor";1;12865;229010;241875;0,0531886304909561;5,32
2011;"13";"Män";1;2328;59907;62235;0,0374066040009641;3,74
2011;"13";"Kvinnor";1;3289;54199;57488;0,057211939883106;5,72
2011;"14";"Män";1;15025;366169;381194;0,0394156256394382;3,94
2011;"14";"Kvinnor";1;18922;319546;338468;0,0559048418166562;5,59
2011;"17";"Män";1;1544;55958;57502;0,0268512399568711;2,69
2011;"17";"Kvinnor";1;2057;48690;50747;0,0405344158275366;4,05
2011;"18";"Män";1;1779;61318;63097;0,0281946843748514;2,82
2011;"18";"Kvinnor";1;2124;53489;55613;0,0381925089457501;3,82
2011;"19";"Män";1;1432;54711;56143;0,0255062964216376;2,55
2011;"19";"Kvinnor";1;1973;46406;48379;0,0407821575476963;4,08
2011;"20";"Män";1;1653;60790;62443;0,0264721425940458;2,65
2011;"20";"Kvinnor";1;1993;52055;54048;0,0368746299585554;3,69
2011;"21";"Män";1;1581;59882;61463;0,0257227925743944;2,57
2011;"21";"Kvinnor";1;2133;50607;52740;0,0404436860068259;4,04
2011;"22";"Män";1;1363;52582;53945;0,0252664751135416;2,53
2011;"22";"Kvinnor";1;1835;45415;47250;0,0388359788359788;3,88
2011;"23";"Män";1;824;27604;28428;0,0289855072463768;2,9
2011;"23";"Kvinnor";1;925;26111;27036;0,0342136410711644;3,42
2011;"24";"Män";1;1497;57918;59415;0,0251956576622065;2,52
2011;"24";"Kvinnor";1;1786;51198;52984;0,0337082892948815;3,37
2011;"25";"Män";1;1284;56878;58162;0,0220762697293766;2,21
2011;"25";"Kvinnor";1;1919;47101;49020;0,0391472868217054;3,91
2011;"9999";"Män";1;1199;159044;160243;0,00748238612607103;0,75
2011;"9999";"Kvinnor";1;1408;174938;176346;0,00798430358499768;0,8
2012;"01";"Män";1;38472;525062;563534;0,0682691727562135;6,83
2012;"01";"Kvinnor";1;43746;476170;519916;0,0841405150062702;8,41
2012;"03";"Män";1;2286;64505;66791;0,0342261681963139;3,42
2012;"03";"Kvinnor";1;2914;63981;66895;0,0435608042454593;4,36
2012;"04";"Män";1;1651;50939;52590;0,0313938011028713;3,14
2012;"04";"Kvinnor";1;2098;47286;49384;0,0424833954317188;4,25
2012;"05";"Män";1;2545;95541;98086;0,0259466182737598;2,59
2012;"05";"Kvinnor";1;3152;82233;85385;0,0369151490308602;3,69
2012;"06";"Män";1;2035;82579;84614;0,0240503935518945;2,41
2012;"06";"Kvinnor";1;2345;68671;71016;0,03302072772333;3,3
2012;"07";"Män";1;2150;44806;46956;0,0457875457875458;4,58
2012;"07";"Kvinnor";1;2222;38186;40408;0,0549891110671154;5,5
2012;"08";"Män";1;1452;50510;51962;0,0279434971710096;2,79
2012;"08";"Kvinnor";1;1854;44096;45950;0,040348204570185;4,03
2012;"09";"Män";1;462;11970;12432;0,0371621621621622;3,72
2012;"09";"Kvinnor";1;558;11382;11940;0,0467336683417085;4,67
2012;"10";"Män";1;861;32236;33097;0,0260144423965918;2,6
2012;"10";"Kvinnor";1;1059;27190;28249;0,037488052674431;3,75
2012;"12";"Män";1;11150;254363;265513;0,0419941773095856;4,2
2012;"12";"Kvinnor";1;13044;233032;246076;0,0530080137843593;5,3
2012;"13";"Män";1;2237;60258;62495;0,0357948635890871;3,58
2012;"13";"Kvinnor";1;3284;55852;59136;0,0555330086580087;5,55
2012;"14";"Män";1;15048;368499;383547;0,0392337836040955;3,92
2012;"14";"Kvinnor";1;19082;326498;345580;0,0552173158168876;5,52
2012;"17";"Män";1;1430;55763;57193;0,0250030598150123;2,5
2012;"17";"Kvinnor";1;1947;49279;51226;0,0380080427907703;3,8
2012;"18";"Män";1;1736;61974;63710;0,0272484696280019;2,72
2012;"18";"Kvinnor";1;2114;55369;57483;0,0367760903223562;3,68
2012;"19";"Män";1;1439;55391;56830;0,0253211332042935;2,53
2012;"19";"Kvinnor";1;1999;47222;49221;0,0406127465919018;4,06
2012;"20";"Män";1;1630;60653;62283;0,0261708652441276;2,62
2012;"20";"Kvinnor";1;1939;52540;54479;0,0355916958828172;3,56
2012;"21";"Män";1;1439;59282;60721;0,0236985556891356;2,37
2012;"21";"Kvinnor";1;2019;50691;52710;0,0383039271485487;3,83
2012;"22";"Män";1;1282;52921;54203;0,0236518273896279;2,37
2012;"22";"Kvinnor";1;1776;45928;47704;0,0372295824249539;3,72
2012;"23";"Män";1;836;27424;28260;0,0295824486907289;2,96
2012;"23";"Kvinnor";1;904;26265;27169;0,0332732157974162;3,33
2012;"24";"Män";1;1517;58463;59980;0,0252917639213071;2,53
2012;"24";"Kvinnor";1;1841;52368;54209;0,0339611503624859;3,4
2012;"25";"Män";1;1327;57953;59280;0,022385290148448;2,24
2012;"25";"Kvinnor";1;1962;48572;50534;0,0388253453120671;3,88
2012;"9999";"Män";1;1221;159886;161107;0,00757881408008342;0,76
2012;"9999";"Kvinnor";1;1704;175415;177119;0,00962065052309464;0,96
2013;"01";"Män";1;38722;534916;573638;0,06750250157765;6,75
2013;"01";"Kvinnor";1;43927;483179;527106;0,0833361790607582;8,33
2013;"03";"Män";1;2241;65832;68073;0,0329205411837292;3,29
2013;"03";"Kvinnor";1;2858;64851;67709;0,0422100459318554;4,22
2013;"04";"Män";1;1605;51286;52891;0,0303454273884026;3,03
2013;"04";"Kvinnor";1;2079;48018;50097;0,0414994909874843;4,15
2013;"05";"Män";1;2469;96571;99040;0,0249293214862682;2,49
2013;"05";"Kvinnor";1;3077;83449;86526;0,0355615653098491;3,56
2013;"06";"Män";1;2013;82317;84330;0,0238705087157595;2,39
2013;"06";"Kvinnor";1;2380;68920;71300;0,0333800841514727;3,34
2013;"07";"Män";1;2111;44346;46457;0,0454398691262888;4,54
2013;"07";"Kvinnor";1;2139;38105;40244;0,0531507802405327;5,32
2013;"08";"Män";1;1462;50359;51821;0,0282125007236449;2,82
2013;"08";"Kvinnor";1;1864;44448;46312;0,0402487476248057;4,02
2013;"09";"Män";1;483;11870;12353;0,0390998138104104;3,91
2013;"09";"Kvinnor";1;528;11372;11900;0,0443697478991597;4,44
2013;"10";"Män";1;864;32316;33180;0,0260397830018083;2,6
2013;"10";"Kvinnor";1;1052;27407;28459;0,0369654590814856;3,7
2013;"12";"Män";1;11053;255996;267049;0,0413894079363712;4,14
2013;"12";"Kvinnor";1;13078;234472;247550;0,0528297313674005;5,28
2013;"13";"Män";1;2174;60193;62367;0,0348581782032164;3,49
2013;"13";"Kvinnor";1;3191;56843;60034;0,0531532131791985;5,32
2013;"14";"Män";1;14881;371539;386420;0,0385099114952642;3,85
2013;"14";"Kvinnor";1;18895;328412;347307;0,0544043166420487;5,44
2013;"17";"Män";1;1406;55548;56954;0,0246865891772307;2,47
2013;"17";"Kvinnor";1;1951;49579;51530;0,0378614399379003;3,79
2013;"18";"Män";1;1702;61842;63544;0,0267845902052121;2,68
2013;"18";"Kvinnor";1;2105;55994;58099;0,0362312604347751;3,62
2013;"19";"Män";1;1410;56134;57544;0,0245029890171;2,45
2013;"19";"Kvinnor";1;1905;47884;49789;0,0382614633754444;3,83
2013;"20";"Män";1;1508;60240;61748;0,0244218436224655;2,44
2013;"20";"Kvinnor";1;1917;52654;54571;0,0351285481299591;3,51
2013;"21";"Män";1;1413;58468;59881;0,0235968003206359;2,36
2013;"21";"Kvinnor";1;1943;50742;52685;0,0368795672392522;3,69
2013;"22";"Män";1;1262;52878;54140;0,0233099371998522;2,33
2013;"22";"Kvinnor";1;1735;45853;47588;0,0364587711187694;3,65
2013;"23";"Män";1;844;27684;28528;0,0295849691531127;2,96
2013;"23";"Kvinnor";1;871;26373;27244;0,031970342093672;3,2
2013;"24";"Män";1;1536;58666;60202;0,0255141025215109;2,55
2013;"24";"Kvinnor";1;1858;52376;54234;0,0342589519489619;3,43
2013;"25";"Män";1;1373;58473;59846;0,0229422183604585;2,29
2013;"25";"Kvinnor";1;2029;48806;50835;0,0399134454608046;3,99
2013;"9999";"Män";1;1588;163674;165262;0,0096089845215476;0,96
2013;"9999";"Kvinnor";1;2026;180685;182711;0,011088549676812;1,11
2014;"01";"Män";1;38553;545247;583800;0,06603802672148;6,6
2014;"01";"Kvinnor";1;44968;492686;537654;0,0836374322519687;8,36
2014;"03";"Män";1;2222;66752;68974;0,0322150375503813;3,22
2014;"03";"Kvinnor";1;2834;65416;68250;0,0415238095238095;4,15
2014;"04";"Män";1;1606;51086;52692;0,0304790100964093;3,05
2014;"04";"Kvinnor";1;2107;48473;50580;0,0416567813364966;4,17
2014;"05";"Män";1;2449;97256;99705;0,0245624592548017;2,46
2014;"05";"Kvinnor";1;3104;84524;87628;0,0354224677043867;3,54
2014;"06";"Män";1;1870;83086;84956;0,0220113941334338;2,2
2014;"06";"Kvinnor";1;2282;69587;71869;0,0317522158371481;3,18
2014;"07";"Män";1;2286;44812;47098;0,0485370928701856;4,85
2014;"07";"Kvinnor";1;2363;38419;40782;0,057942229414938;5,79
2014;"08";"Män";1;1422;50567;51989;0,0273519398334263;2,74
2014;"08";"Kvinnor";1;1828;44736;46564;0,039257795722017;3,93
2014;"09";"Män";1;446;11995;12441;0,0358492082630014;3,58
2014;"09";"Kvinnor";1;533;11484;12017;0,0443538320712324;4,44
2014;"10";"Män";1;852;32273;33125;0,0257207547169811;2,57
2014;"10";"Kvinnor";1;1022;27349;28371;0,0360226992351345;3,6
2014;"12";"Män";1;10543;259157;269700;0,0390915832406377;3,91
2014;"12";"Kvinnor";1;12642;238398;251040;0,0503585086042065;5,04
2014;"13";"Män";1;2141;60572;62713;0,0341396520657599;3,41
2014;"13";"Kvinnor";1;3091;57748;60839;0,0508062262693338;5,08
2014;"14";"Män";1;14811;373015;387826;0,038189806769015;3,82
2014;"14";"Kvinnor";1;18602;330358;348960;0,0533069692801467;5,33
2014;"17";"Män";1;1357;55363;56720;0,0239245416078984;2,39
2014;"17";"Kvinnor";1;1913;49740;51653;0,0370356029659458;3,7
2014;"18";"Män";1;1659;62306;63965;0,0259360587821465;2,59
2014;"18";"Kvinnor";1;2035;56619;58654;0,0346949909639581;3,47
2014;"19";"Män";1;1326;56057;57383;0,0231078890960737;2,31
2014;"19";"Kvinnor";1;1769;48566;50335;0,0351445316380252;3,51
2014;"20";"Män";1;1497;59977;61474;0,0243517584669942;2,44
2014;"20";"Kvinnor";1;1836;52941;54777;0,0335177172901035;3,35
2014;"21";"Män";1;1365;58422;59787;0,0228310502283105;2,28
2014;"21";"Kvinnor";1;1889;51473;53362;0,0353997226490761;3,54
2014;"22";"Män";1;1223;52583;53806;0,0227298070847117;2,27
2014;"22";"Kvinnor";1;1707;46041;47748;0,0357501884895702;3,58
2014;"23";"Män";1;769;27820;28589;0,0268984574486691;2,69
2014;"23";"Kvinnor";1;823;26291;27114;0,0303533230065649;3,04
2014;"24";"Män";1;1504;58474;59978;0,025075861149088;2,51
2014;"24";"Kvinnor";1;1832;52359;54191;0,0338063516082006;3,38
2014;"25";"Män";1;1345;58758;60103;0,0223782506696837;2,24
2014;"25";"Kvinnor";1;1997;49467;51464;0,0388038240323333;3,88
2014;"9999";"Män";1;1669;163911;165580;0,0100797197729194;1,01
2014;"9999";"Kvinnor";1;2201;177370;179571;0,0122569902712576;1,23
2015;"01";"Män";1;38622;557629;596251;0,0647747341304249;6,48
2015;"01";"Kvinnor";1;45553;504155;549708;0,0828676315425644;8,29
2015;"03";"Män";1;2310;68069;70379;0,0328222907401356;3,28
2015;"03";"Kvinnor";1;2880;66708;69588;0,041386445938955;4,14
2015;"04";"Män";1;1384;51458;52842;0,0261912872336399;2,62
2015;"04";"Kvinnor";1;1935;48854;50789;0,0380988009214594;3,81
2015;"05";"Män";1;2400;98433;100833;0,0238017315759722;2,38
2015;"05";"Kvinnor";1;3013;86320;89333;0,0337277377900664;3,37
2015;"06";"Män";1;1750;84446;86196;0,0203025662443733;2,03
2015;"06";"Kvinnor";1;2244;70744;72988;0,0307447799638297;3,07
2015;"07";"Män";1;2161;45591;47752;0,0452546490199363;4,53
2015;"07";"Kvinnor";1;2348;39259;41607;0,0564328117864782;5,64
2015;"08";"Män";1;1386;51144;52530;0,0263849229011993;2,64
2015;"08";"Kvinnor";1;1820;44885;46705;0,0389679905791671;3,9
2015;"09";"Män";1;456;12167;12623;0,0361245345797354;3,61
2015;"09";"Kvinnor";1;542;11571;12113;0,0447453149508792;4,47
2015;"10";"Män";1;828;32600;33428;0,0247696541821228;2,48
2015;"10";"Kvinnor";1;988;27690;28678;0,0344514959202176;3,45
2015;"12";"Män";1;10406;263099;273505;0,0380468364380907;3,8
2015;"12";"Kvinnor";1;12664;243384;256048;0,0494594763481847;4,95
2015;"13";"Män";1;2092;62023;64115;0,0326288699992201;3,26
2015;"13";"Kvinnor";1;3028;58556;61584;0,0491686152247337;4,92
2015;"14";"Män";1;14706;381483;396189;0,0371186479180391;3,71
2015;"14";"Kvinnor";1;18772;337051;355823;0,0527565671696321;5,28
2015;"17";"Män";1;1340;55823;57163;0,0234417367877823;2,34
2015;"17";"Kvinnor";1;1923;50799;52722;0,0364743370888813;3,65
2015;"18";"Män";1;1598;63315;64913;0,0246175650486035;2,46
2015;"18";"Kvinnor";1;2012;57807;59819;0,0336347983082298;3,36
2015;"19";"Män";1;1329;56290;57619;0,0230653083184366;2,31
2015;"19";"Kvinnor";1;1730;49210;50940;0,0339615233608166;3,4
2015;"20";"Män";1;1449;60404;61853;0,0234265112444021;2,34
2015;"20";"Kvinnor";1;1791;53335;55126;0,032489206545006;3,25
2015;"21";"Män";1;1358;58523;59881;0,0226783119854378;2,27
2015;"21";"Kvinnor";1;1845;52077;53922;0,0342160899076444;3,42
2015;"22";"Män";1;1190;53191;54381;0,0218826428348136;2,19
2015;"22";"Kvinnor";1;1627;46618;48245;0,0337237019380247;3,37
2015;"23";"Män";1;775;27945;28720;0,0269846796657382;2,7
2015;"23";"Kvinnor";1;847;26349;27196;0,0311442859244006;3,11
2015;"24";"Män";1;1453;59326;60779;0,0239062834202603;2,39
2015;"24";"Kvinnor";1;1820;52963;54783;0,0332219849223299;3,32
2015;"25";"Män";1;1279;58280;59559;0,0214745042730738;2,15
2015;"25";"Kvinnor";1;1982;49533;51515;0,0384742308065612;3,85
2015;"9999";"Män";1;1657;166715;168372;0,00984130377972585;0,98
2015;"9999";"Kvinnor";1;2178;181934;184112;0,0118297558008169;1,18
2016;"01";"Män";1;38746;572016;610762;0,0634387863030117;6,34
2016;"01";"Kvinnor";1;46610;518023;564633;0,0825491956722331;8,25
2016;"03";"Män";1;2254;70037;72291;0,0311795382551078;3,12
2016;"03";"Kvinnor";1;2953;68748;71701;0,0411849207124029;4,12
2016;"04";"Män";1;1409;52330;53739;0,0262193193025549;2,62
2016;"04";"Kvinnor";1;1910;49958;51868;0,0368242461633377;3,68
2016;"05";"Män";1;2327;100810;103137;0,0225622230625285;2,26
2016;"05";"Kvinnor";1;2902;88869;91771;0,031622190016454;3,16
2016;"06";"Män";1;1862;87009;88871;0,0209517165329523;2,1
2016;"06";"Kvinnor";1;2255;72951;75206;0,0299843097625189;3
2016;"07";"Män";1;2294;46487;48781;0,0470265062216847;4,7
2016;"07";"Kvinnor";1;2450;40259;42709;0,0573649582055304;5,74
2016;"08";"Män";1;1349;51960;53309;0,0253052955410906;2,53
2016;"08";"Kvinnor";1;1769;46032;47801;0,0370075939833895;3,7
2016;"09";"Män";1;450;12362;12812;0,0351233218857321;3,51
2016;"09";"Kvinnor";1;543;11717;12260;0,0442903752039152;4,43
2016;"10";"Män";1;757;33625;34382;0,0220173346518527;2,2
2016;"10";"Kvinnor";1;950;28526;29476;0,0322296105306012;3,22
2016;"12";"Män";1;10403;269037;279440;0,0372280274835385;3,72
2016;"12";"Kvinnor";1;12627;250536;263163;0,0479816691556184;4,8
2016;"13";"Män";1;1982;63502;65484;0,03026693543461;3,03
2016;"13";"Kvinnor";1;2935;60061;62996;0,0465902596990285;4,66
2016;"14";"Män";1;14611;391841;406452;0,0359476641768278;3,59
2016;"14";"Kvinnor";1;19066;346962;366028;0,0520889112308348;5,21
2016;"17";"Män";1;1302;56916;58218;0,0223642172523962;2,24
2016;"17";"Kvinnor";1;1924;51667;53591;0,0359015506335019;3,59
2016;"18";"Män";1;1567;64868;66435;0,0235869647023406;2,36
2016;"18";"Kvinnor";1;2031;59147;61178;0,0331982085063258;3,32
2016;"19";"Män";1;1339;56520;57859;0,0231424670319224;2,31
2016;"19";"Kvinnor";1;1811;50286;52097;0,0347620784306198;3,48
2016;"20";"Män";1;1513;61562;63075;0,0239873166864843;2,4
2016;"20";"Kvinnor";1;1819;54482;56301;0,032308484751603;3,23
2016;"21";"Män";1;1331;59381;60712;0,0219231782843589;2,19
2016;"21";"Kvinnor";1;1807;53075;54882;0,0329251849422397;3,29
2016;"22";"Män";1;1162;53845;55007;0,0211245841438362;2,11
2016;"22";"Kvinnor";1;1594;47705;49299;0,0323333130489462;3,23
2016;"23";"Män";1;773;28422;29195;0,0264771364959753;2,65
2016;"23";"Kvinnor";1;873;26505;27378;0,0318869165023011;3,19
2016;"24";"Män";1;1464;60374;61838;0,0236747630906562;2,37
2016;"24";"Kvinnor";1;1962;54236;56198;0,0349122744581658;3,49
2016;"25";"Män";1;1229;58787;60016;0,0204778725673154;2,05
2016;"25";"Kvinnor";1;1880;50417;52297;0,0359485247719755;3,59
2016;"9999";"Män";1;1616;166989;168605;0,00958453189407194;0,96
2016;"9999";"Kvinnor";1;1907;180907;182814;0,0104313674007461;1,04
2017;"01";"Män";1;39664;584254;623918;0,0635724566369299;6,36
2017;"01";"Kvinnor";1;47601;527147;574748;0,0828206448739274;8,28
2017;"03";"Män";1;2349;71687;74036;0,03172780809336;3,17
2017;"03";"Kvinnor";1;2940;70155;73095;0,0402216293864149;4,02
2017;"04";"Män";1;1388;53461;54849;0,0253058396689092;2,53
2017;"04";"Kvinnor";1;1948;50469;52417;0,0371635156533186;3,72
2017;"05";"Män";1;2344;102743;105087;0,0223053279663517;2,23
2017;"05";"Kvinnor";1;2949;89912;92861;0,0317571423956236;3,18
2017;"06";"Män";1;1796;88733;90529;0,0198389466358846;1,98
2017;"06";"Kvinnor";1;2312;74114;76426;0,0302514850966948;3,03
2017;"07";"Män";1;2476;47535;50011;0,0495091079962408;4,95
2017;"07";"Kvinnor";1;2612;40517;43129;0,0605624985508591;6,06
2017;"08";"Män";1;1312;52716;54028;0,0242837047456874;2,43
2017;"08";"Kvinnor";1;1760;46019;47779;0,0368362669792168;3,68
2017;"09";"Män";1;450;12571;13021;0,0345595576376622;3,46
2017;"09";"Kvinnor";1;529;11795;12324;0,0429243752028562;4,29
2017;"10";"Män";1;778;34503;35281;0,022051529151668;2,21
2017;"10";"Kvinnor";1;896;29103;29999;0,0298676622554085;2,99
2017;"12";"Män";1;10422;274090;284512;0,0366311438533348;3,66
2017;"12";"Kvinnor";1;12635;255321;267956;0,0471532639687113;4,72
2017;"13";"Män";1;1946;64397;66343;0,0293324088449422;2,93
2017;"13";"Kvinnor";1;2888;60922;63810;0,0452593637360915;4,53
2017;"14";"Män";1;14630;403125;417755;0,0350205263850822;3,5
2017;"14";"Kvinnor";1;19264;355633;374897;0,0513847803530036;5,14
2017;"17";"Män";1;1286;57707;58993;0,0217991965148407;2,18
2017;"17";"Kvinnor";1;1951;52142;54093;0,0360675133566266;3,61
2017;"18";"Män";1;1607;66223;67830;0,0236915818959163;2,37
2017;"18";"Kvinnor";1;2053;60296;62349;0,0329275529679706;3,29
2017;"19";"Män";1;1310;57637;58947;0,0222233531816717;2,22
2017;"19";"Kvinnor";1;1749;51054;52803;0,0331231180046588;3,31
2017;"20";"Män";1;1436;62411;63847;0,022491268188012;2,25
2017;"20";"Kvinnor";1;1802;54707;56509;0,0318887256897131;3,19
2017;"21";"Män";1;1334;60180;61514;0,0216861202327925;2,17
2017;"21";"Kvinnor";1;1851;53589;55440;0,0333874458874459;3,34
2017;"22";"Män";1;1122;54036;55158;0,020341564233656;2,03
2017;"22";"Kvinnor";1;1602;47803;49405;0,032425867827143;3,24
2017;"23";"Män";1;767;28890;29657;0,0258623596452777;2,59
2017;"23";"Kvinnor";1;888;26932;27820;0,0319194823867721;3,19
2017;"24";"Män";1;1385;61181;62566;0,022136623725346;2,21
2017;"24";"Kvinnor";1;1892;54803;56695;0,033371549519358;3,34
2017;"25";"Män";1;1194;58507;59701;0,0199996649972362;2
2017;"25";"Kvinnor";1;1853;50282;52135;0,0355423419967392;3,55
2017;"9999";"Män";1;1720;174318;176038;0,00977061770754042;0,98
2017;"9999";"Kvinnor";1;1844;180232;182076;0,0101276390078868;1,01
2018;"01";"Män";1;39762;594104;633866;0,0627293465811386;6,27
2018;"01";"Kvinnor";1;47822;535096;582918;0,0820389831845989;8,2
2018;"03";"Män";1;2421;72334;74755;0,0323857935924018;3,24
2018;"03";"Kvinnor";1;2938;70802;73740;0,0398426905343097;3,98
2018;"04";"Män";1;1415;54307;55722;0,0253939198162306;2,54
2018;"04";"Kvinnor";1;1958;51072;53030;0,0369224966999811;3,69
2018;"05";"Män";1;2210;104922;107132;0,0206287570473808;2,06
2018;"05";"Kvinnor";1;2898;90833;93731;0,03091826610193;3,09
2018;"06";"Män";1;1779;90583;92362;0,0192611680128191;1,93
2018;"06";"Kvinnor";1;2280;75195;77475;0,0294288480154889;2,94
2018;"07";"Män";1;2608;48400;51008;0,051129234629862;5,11
2018;"07";"Kvinnor";1;2741;40916;43657;0,0627848913118171;6,28
2018;"08";"Män";1;1292;53220;54512;0,0237012034047549;2,37
2018;"08";"Kvinnor";1;1706;46430;48136;0,0354412497922553;3,54
2018;"09";"Män";1;406;12868;13274;0,0305861081814073;3,06
2018;"09";"Kvinnor";1;529;11916;12445;0,0425070309361189;4,25
2018;"10";"Män";1;786;34550;35336;0,0222436042562825;2,22
2018;"10";"Kvinnor";1;857;29049;29906;0,0286564568982813;2,87
2018;"12";"Män";1;10411;279966;290377;0,0358533905922301;3,59
2018;"12";"Kvinnor";1;12674;259077;271751;0,0466382828398056;4,66
2018;"13";"Män";1;1958;65086;67044;0,0292047013901319;2,92
2018;"13";"Kvinnor";1;2951;61555;64506;0,0457476823861346;4,57
2018;"14";"Män";1;14595;411536;426131;0,0342500310937247;3,43
2018;"14";"Kvinnor";1;19552;360964;380516;0,051382859065059;5,14
2018;"17";"Män";1;1237;58558;59795;0,0206873484405051;2,07
2018;"17";"Kvinnor";1;1934;52595;54529;0,0354673659887399;3,55
2018;"18";"Män";1;1630;67626;69256;0,0235358669284972;2,35
2018;"18";"Kvinnor";1;2023;61068;63091;0,032064795295684;3,21
2018;"19";"Män";1;1284;58835;60119;0,0213576406793194;2,14
2018;"19";"Kvinnor";1;1699;52010;53709;0,0316334320132566;3,16
2018;"20";"Män";1;1384;62791;64175;0,0215660303856642;2,16
2018;"20";"Kvinnor";1;1770;55148;56918;0,0310973681436452;3,11
2018;"21";"Män";1;1262;61203;62465;0,0202033138557592;2,02
2018;"21";"Kvinnor";1;1783;53798;55581;0,0320793076770839;3,21
2018;"22";"Män";1;1124;54379;55503;0,0202511575950849;2,03
2018;"22";"Kvinnor";1;1581;47911;49492;0,0319445566960317;3,19
2018;"23";"Män";1;758;29283;30041;0,0252321826836657;2,52
2018;"23";"Kvinnor";1;878;27096;27974;0,0313862872667477;3,14
2018;"24";"Män";1;1370;62282;63652;0,0215232828504996;2,15
2018;"24";"Kvinnor";1;1827;55078;56905;0,0321061418153062;3,21
2018;"25";"Män";1;1183;58990;60173;0,0196599803898759;1,97
2018;"25";"Kvinnor";1;1810;50462;52272;0,0346265687174778;3,46
2018;"9999";"Män";1;1511;171009;172520;0,00875840482262926;0,88
2018;"9999";"Kvinnor";1;1972;175662;177634;0,0111014783205918;1,11
2019;"01";"Män";1;39361;600550;639911;0,0615101162505411;6,15
2019;"01";"Kvinnor";1;48104;550294;598398;0,080387969211127;8,04
2019;"03";"Män";1;2552;73924;76476;0,0333699461268895;3,34
2019;"03";"Kvinnor";1;3085;73304;76389;0,0403853958030607;4,04
2019;"04";"Män";1;1461;54361;55822;0,0261724768012612;2,62
2019;"04";"Kvinnor";1;2108;51652;53760;0,0392113095238095;3,92
2019;"05";"Män";1;2336;106148;108484;0,0215331293093912;2,15
2019;"05";"Kvinnor";1;3025;93456;96481;0,0313533234522859;3,14
2019;"06";"Män";1;1861;89700;91561;0,0203252476491082;2,03
2019;"06";"Kvinnor";1;2411;75242;77653;0,0310483819041119;3,1
2019;"07";"Män";1;2575;48700;51275;0,0502194051682106;5,02
2019;"07";"Kvinnor";1;2772;41287;44059;0,0629156358519258;6,29
2019;"08";"Män";1;1377;52916;54293;0,0253623855745676;2,54
2019;"08";"Kvinnor";1;1820;46619;48439;0,0375730299964904;3,76
2019;"09";"Män";1;390;12580;12970;0,0300693909020817;3,01
2019;"09";"Kvinnor";1;530;12122;12652;0,0418906101802087;4,19
2019;"10";"Män";1;781;34162;34943;0,0223506854019403;2,24
2019;"10";"Kvinnor";1;876;28774;29650;0,0295446880269815;2,95
2019;"12";"Män";1;10521;283473;293994;0,0357864446213188;3,58
2019;"12";"Kvinnor";1;12869;263766;276635;0,0465197823847308;4,65
2019;"13";"Män";1;1958;65771;67729;0,0289093298291721;2,89
2019;"13";"Kvinnor";1;3035;62509;65544;0,0463047723666545;4,63
2019;"14";"Män";1;14739;412709;427448;0,0344813872096723;3,45
2019;"14";"Kvinnor";1;20000;366434;386434;0,0517552803324759;5,18
2019;"17";"Män";1;1336;58752;60088;0,0222340567168153;2,22
2019;"17";"Kvinnor";1;1948;53529;55477;0,0351136507020928;3,51
2019;"18";"Män";1;1651;68011;69662;0,0237001521633028;2,37
2019;"18";"Kvinnor";1;2084;62187;64271;0,0324251995456738;3,24
2019;"19";"Män";1;1316;59071;60387;0,0217927699670459;2,18
2019;"19";"Kvinnor";1;1692;52855;54547;0,0310191211249015;3,1
2019;"20";"Män";1;1406;63268;64674;0,0217398027027863;2,17
2019;"20";"Kvinnor";1;1728;55857;57585;0,0300078145350352;3
2019;"21";"Män";1;1372;60627;61999;0,0221293891836965;2,21
2019;"21";"Kvinnor";1;1820;53816;55636;0,0327126321087066;3,27
2019;"22";"Män";1;1122;53826;54948;0,0204193055252238;2,04
2019;"22";"Kvinnor";1;1650;47493;49143;0,0335754837921983;3,36
2019;"23";"Män";1;772;29243;30015;0,0257204730967849;2,57
2019;"23";"Kvinnor";1;892;27491;28383;0,0314272627981538;3,14
2019;"24";"Män";1;1473;62299;63772;0,0230979113090384;2,31
2019;"24";"Kvinnor";1;1936;55779;57715;0,0335441393052066;3,35
2019;"25";"Män";1;1158;57780;58938;0,0196477654484373;1,96
2019;"25";"Kvinnor";1;1802;49001;50803;0,0354703462393953;3,55
2019;"9999";"Män";1;1957;176639;178596;0,0109576922215503;1,1
2019;"9999";"Kvinnor";1;2645;201290;203935;0,0129698188148184;1,3
2020;"01";"Män";1;38034;594074;632108;0,0601700975149816;6,02
2020;"01";"Kvinnor";1;44624;542209;586833;0,076042076706661;7,6
2020;"03";"Män";1;2465;74100;76565;0,0321948671063802;3,22
2020;"03";"Kvinnor";1;2772;72751;75523;0,0367040504217258;3,67
2020;"04";"Män";1;1370;53304;54674;0,0250576142224824;2,51
2020;"04";"Kvinnor";1;1831;51408;53239;0,0343920809932568;3,44
2020;"05";"Män";1;2138;105667;107805;0,0198321042623255;1,98
2020;"05";"Kvinnor";1;2699;92664;95363;0,0283023814267588;2,83
2020;"06";"Män";1;1663;88668;90331;0,0184100696327949;1,84
2020;"06";"Kvinnor";1;2219;75269;77488;0,0286366921329754;2,86
2020;"07";"Män";1;2635;47695;50330;0,052354460560302;5,24
2020;"07";"Kvinnor";1;2765;40435;43200;0,0640046296296296;6,4
2020;"08";"Män";1;1239;52051;53290;0,0232501407393507;2,33
2020;"08";"Kvinnor";1;1616;46264;47880;0,0337510442773601;3,38
2020;"09";"Män";1;400;12428;12828;0,0311817898347365;3,12
2020;"09";"Kvinnor";1;510;11978;12488;0,0408392056374119;4,08
2020;"10";"Män";1;654;33854;34508;0,0189521270430045;1,9
2020;"10";"Kvinnor";1;751;28367;29118;0,0257916065663851;2,58
2020;"12";"Män";1;10106;283310;293416;0,0344425661858931;3,44
2020;"12";"Kvinnor";1;11972;264169;276141;0,0433546630163576;4,34
2020;"13";"Män";1;1872;65961;67833;0,0275971872097652;2,76
2020;"13";"Kvinnor";1;2776;62539;65315;0,0425017224221082;4,25
2020;"14";"Män";1;14089;406104;420193;0,0335298303398676;3,35
2020;"14";"Kvinnor";1;18718;360294;379012;0,0493862991145399;4,94
2020;"17";"Män";1;1252;57905;59157;0,0211640211640212;2,12
2020;"17";"Kvinnor";1;1767;52479;54246;0,0325738303285035;3,26
2020;"18";"Män";1;1509;68268;69777;0,0216260372328991;2,16
2020;"18";"Kvinnor";1;1844;61861;63705;0,0289459226120399;2,89
2020;"19";"Män";1;1218;58118;59336;0,0205271673183228;2,05
2020;"19";"Kvinnor";1;1466;52583;54049;0,0271235360506207;2,71
2020;"20";"Män";1;1372;61920;63292;0,0216773051886494;2,17
2020;"20";"Kvinnor";1;1701;54813;56514;0,0300987365962416;3,01
2020;"21";"Män";1;1268;59812;61080;0,0207596594629993;2,08
2020;"21";"Kvinnor";1;1640;53281;54921;0,0298610731778373;2,99
2020;"22";"Män";1;1043;52941;53984;0,0193205394190871;1,93
2020;"22";"Kvinnor";1;1533;46822;48355;0,031703029676352;3,17
2020;"23";"Män";1;735;28799;29534;0,0248865714092233;2,49
2020;"23";"Kvinnor";1;837;26826;27663;0,0302570220149658;3,03
2020;"24";"Män";1;1440;61592;63032;0,0228455387739561;2,28
2020;"24";"Kvinnor";1;1798;54901;56699;0,0317113176599235;3,17
2020;"25";"Män";1;1069;57336;58405;0,0183032274634021;1,83
2020;"25";"Kvinnor";1;1555;48877;50432;0,030833597715736;3,08
2020;"9999";"Män";1;1831;169354;171185;0,0106960306101586;1,07
2020;"9999";"Kvinnor";1;2300;188617;190917;0,0120471199526496;1,2
2021;"01";"Män";1;38900;613189;652089;0,059654433673931;5,97
2021;"01";"Kvinnor";1;45382;560627;606009;0,0748866766005125;7,49
2021;"03";"Män";1;2449;76346;78795;0,0310806523256552;3,11
2021;"03";"Kvinnor";1;2705;75112;77817;0,0347610419317116;3,48
2021;"04";"Män";1;1312;54947;56259;0,0233207131303436;2,33
2021;"04";"Kvinnor";1;1829;52679;54508;0,0335547075658619;3,36
2021;"05";"Män";1;2138;108373;110511;0,0193464903946214;1,93
2021;"05";"Kvinnor";1;2682;95494;98176;0,0273182855280313;2,73
2021;"06";"Män";1;1645;91003;92648;0,0177553751834902;1,78
2021;"06";"Kvinnor";1;2156;77093;79249;0,0272053906042978;2,72
2021;"07";"Män";1;2757;49451;52208;0,0528079987741342;5,28
2021;"07";"Kvinnor";1;2887;41425;44312;0,0651516519227297;6,52
2021;"08";"Män";1;1317;53355;54672;0,0240891132572432;2,41
2021;"08";"Kvinnor";1;1715;47448;49163;0,0348839574476741;3,49
2021;"09";"Män";1;398;12962;13360;0,0297904191616766;2,98
2021;"09";"Kvinnor";1;506;12451;12957;0,0390522497491703;3,91
2021;"10";"Män";1;662;34408;35070;0,0188765326489877;1,89
2021;"10";"Kvinnor";1;728;28934;29662;0,0245431865686737;2,45
2021;"12";"Män";1;10253;291828;302081;0,0339412276839656;3,39
2021;"12";"Kvinnor";1;12121;272283;284404;0,0426189505070252;4,26
2021;"13";"Män";1;1916;67897;69813;0,0274447452480197;2,74
2021;"13";"Kvinnor";1;2710;64260;66970;0,0404658802448858;4,05
2021;"14";"Män";1;13936;416933;430869;0,032343937484479;3,23
2021;"14";"Kvinnor";1;18369;371062;389431;0,0471688180961454;4,72
2021;"17";"Män";1;1224;58965;60189;0,0203359417833823;2,03
2021;"17";"Kvinnor";1;1774;53881;55655;0,0318749438505076;3,19
2021;"18";"Män";1;1480;70097;71577;0,0206770331251659;2,07
2021;"18";"Kvinnor";1;1815;63181;64996;0,0279247953720229;2,79
2021;"19";"Män";1;1169;59511;60680;0,0192649967040211;1,93
2021;"19";"Kvinnor";1;1448;53608;55056;0,0263004940424295;2,63
2021;"20";"Män";1;1351;62975;64326;0,0210023940552809;2,1
2021;"20";"Kvinnor";1;1735;55916;57651;0,0300948812683215;3,01
2021;"21";"Män";1;1260;60969;62229;0,0202477944366774;2,02
2021;"21";"Kvinnor";1;1672;54438;56110;0,0297986098734628;2,98
2021;"22";"Män";1;1030;53486;54516;0,0188935358426884;1,89
2021;"22";"Kvinnor";1;1501;47720;49221;0,0304951138741594;3,05
2021;"23";"Män";1;759;29591;30350;0,02500823723229;2,5
2021;"23";"Kvinnor";1;855;27696;28551;0,0299464116843543;2,99
2021;"24";"Män";1;1429;63300;64729;0,0220766580667089;2,21
2021;"24";"Kvinnor";1;1682;56019;57701;0,0291502746919464;2,92
2021;"25";"Män";1;1079;58590;59669;0,0180830917226701;1,81
2021;"25";"Kvinnor";1;1578;49922;51500;0,0306407766990291;3,06
2021;"9999";"Män";1;1487;170647;172134;0,00863861875050832;0,86
2021;"9999";"Kvinnor";1;1928;189604;191532;0,0100662030365683;1,01
2022;"01";"Män";1;41826;632963;674789;0,0619838201274769;6,2
2022;"01";"Kvinnor";1;49460;583449;632909;0,0781470953960206;7,81
2022;"03";"Män";1;2532;78645;81177;0,0311911009276026;3,12
2022;"03";"Kvinnor";1;2840;77874;80714;0,035185965260054;3,52
2022;"04";"Män";1;1410;56796;58206;0,0242243067724977;2,42
2022;"04";"Kvinnor";1;1954;54272;56226;0,0347526055561484;3,48
2022;"05";"Män";1;2317;111159;113476;0,0204184144664951;2,04
2022;"05";"Kvinnor";1;2883;98505;101388;0,0284353177890875;2,84
2022;"06";"Män";1;1754;93611;95365;0,0183924920044041;1,84
2022;"06";"Kvinnor";1;2286;79950;82236;0,0277980446519772;2,78
2022;"07";"Män";1;2436;50933;53369;0,0456444752571718;4,56
2022;"07";"Kvinnor";1;2558;42859;45417;0,0563225224035053;5,63
2022;"08";"Män";1;1252;54898;56150;0,0222974176313446;2,23
2022;"08";"Kvinnor";1;1796;49113;50909;0,0352786344261329;3,53
2022;"09";"Män";1;414;13274;13688;0,0302454704850964;3,02
2022;"09";"Kvinnor";1;525;12791;13316;0,0394262541303695;3,94
2022;"10";"Män";1;693;35067;35760;0,0193791946308725;1,94
2022;"10";"Kvinnor";1;747;29496;30243;0,0246999305624442;2,47
2022;"12";"Män";1;11190;301192;312382;0,0358215262082963;3,58
2022;"12";"Kvinnor";1;13268;282412;295680;0,0448728354978355;4,49
2022;"13";"Män";1;1987;69272;71259;0,0278841970838771;2,79
2022;"13";"Kvinnor";1;2872;66533;69405;0,0413803040126792;4,14
2022;"14";"Män";1;14626;431205;445831;0,0328061530041653;3,28
2022;"14";"Kvinnor";1;19525;386005;405530;0,0481468695287648;4,81
2022;"17";"Män";1;1323;60801;62124;0,0212961174425343;2,13
2022;"17";"Kvinnor";1;1938;55741;57679;0,0335997503424123;3,36
2022;"18";"Män";1;1583;71760;73343;0,021583518536193;2,16
2022;"18";"Kvinnor";1;1963;64907;66870;0,0293554658292209;2,94
2022;"19";"Män";1;1133;61213;62346;0,0181727777243127;1,82
2022;"19";"Kvinnor";1;1522;55197;56719;0,0268340415028474;2,68
2022;"20";"Män";1;1435;64113;65548;0,0218923536950021;2,19
2022;"20";"Kvinnor";1;1798;57630;59428;0,0302550986067174;3,03
2022;"21";"Män";1;1298;62063;63361;0,0204857877874402;2,05
2022;"21";"Kvinnor";1;1731;55893;57624;0,030039566847147;3
2022;"22";"Män";1;1060;54364;55424;0,0191252886836028;1,91
2022;"22";"Kvinnor";1;1530;49105;50635;0,0302162535795398;3,02
2022;"23";"Män";1;785;30409;31194;0,0251650958517664;2,52
2022;"23";"Kvinnor";1;950;29016;29966;0,0317025962757792;3,17
2022;"24";"Män";1;1455;65009;66464;0,0218915503129514;2,19
2022;"24";"Kvinnor";1;1792;58835;60627;0,0295577877843205;2,96
2022;"25";"Män";1;1165;59072;60237;0,0193402725899364;1,93
2022;"25";"Kvinnor";1;1657;51078;52735;0,0314212572295439;3,14
2022;"9999";"Män";1;2861;244908;247769;0,0115470458370498;1,15
2022;"9999";"Kvinnor";1;2988;213914;216902;0,0137758065854626;1,38
2007;"0000";"Män";1;96932;2201654;2298586;0,0421702733767629;4,22
2007;"0000";"Kvinnor";1;112849;1989694;2102543;0,0536726240557268;5,37
2008;"0000";"Män";1;97577;2210319;2307896;0,0422796347842364;4,23
2008;"0000";"Kvinnor";1;114727;1994771;2109498;0,0543859249925812;5,44
2009;"0000";"Män";1;94357;2134502;2228859;0,0423342167449803;4,23
2009;"0000";"Kvinnor";1;110958;1951180;2062138;0,0538072621715908;5,38
2010;"0000";"Män";1;94416;2191157;2285573;0,0413095534467724;4,13
2010;"0000";"Kvinnor";1;113590;2003556;2117146;0,0536524169802177;5,37
2011;"0000";"Män";1;94261;2269895;2364156;0,039870888384692;3,99
2011;"0000";"Kvinnor";1;112616;2038611;2151227;0,0523496590550416;5,23
2012;"0000";"Män";1;94206;2290978;2385184;0,0394963239733287;3,95
2012;"0000";"Kvinnor";1;113563;2078226;2191789;0,051812925423022;5,18
2013;"0000";"Män";1;94120;2311148;2405268;0,0391307746163837;3,91
2013;"0000";"Kvinnor";1;113408;2100422;2213830;0,0512270589882692;5,12
2014;"0000";"Män";1;92915;2329489;2422404;0,0383565251708633;3,84
2014;"0000";"Kvinnor";1;113378;2120045;2233423;0,0507642305107452;5,08
2015;"0000";"Män";1;91929;2367954;2459883;0,0373712896101156;3,74
2015;"0000";"Kvinnor";1;113542;2159802;2273344;0,0499449269446243;4,99
2016;"0000";"Män";1;91740;2418680;2510420;0,0365436859170975;3,65
2016;"0000";"Kvinnor";1;114578;2211069;2325647;0,0492671501736936;4,93
2017;"0000";"Män";1;92716;2470905;2563621;0,0361660323425343;3,62
2017;"0000";"Kvinnor";1;115819;2242947;2358766;0,0491015217278865;4,91
2018;"0000";"Män";1;92386;2506832;2599218;0,0355437673946549;3,55
2018;"0000";"Kvinnor";1;116183;2263733;2379916;0,0488181095467235;4,88
2019;"0000";"Män";1;93475;2524510;2617985;0,035704941013795;3,57
2019;"0000";"Kvinnor";1;118832;2324757;2443589;0,0486301092368643;4,86
2020;"0000";"Män";1;89402;2493261;2582663;0,0346162081541417;3,46
2020;"0000";"Kvinnor";1;109694;2289407;2399101;0,0457229603922469;4,57
2021;"0000";"Män";1;89951;2558823;2648774;0,0339594846521447;3,4
2021;"0000";"Kvinnor";1;109778;2350853;2460631;0,0446137596413278;4,46
2022;"0000";"Män";1;96535;2702727;2799262;0,0344858752056792;3,45
2022;"0000";"Kvinnor";1;118583;2454575;2573158;0,0460846166461601;4,61
2007;"0114";"Totalt";0;492;13451;13943;0,0352865237036506;3,53
2008;"0114";"Totalt";0;456;13194;13650;0,0334065934065934;3,34
2009;"0114";"Totalt";0;394;13131;13525;0,0291312384473198;2,91
2010;"0114";"Totalt";0;450;13309;13759;0,0327058652518352;3,27
2011;"0114";"Totalt";0;416;13054;13470;0,0308834446919079;3,09
2012;"0114";"Totalt";0;410;13299;13709;0,0299073601283828;2,99
2013;"0114";"Totalt";0;423;13703;14126;0,0299447826702534;2,99
2014;"0114";"Totalt";0;396;13719;14115;0,0280552603613177;2,81
2015;"0114";"Totalt";0;381;13746;14127;0,0269696326183903;2,7
2016;"0114";"Totalt";0;418;13934;14352;0,0291248606465998;2,91
2017;"0114";"Totalt";0;437;13910;14347;0,0304593294765456;3,05
2018;"0114";"Totalt";0;444;13759;14203;0,0312610011969302;3,13
2019;"0114";"Totalt";0;390;13518;13908;0,0280414150129422;2,8
2020;"0114";"Totalt";0;357;13540;13897;0,0256889976253868;2,57
2021;"0114";"Totalt";0;342;14079;14421;0,0237154150197628;2,37
2022;"0114";"Totalt";0;336;14428;14764;0,0227580601463018;2,28
2007;"0115";"Totalt";0;190;6654;6844;0,0277615429573349;2,78
2008;"0115";"Totalt";0;193;6730;6923;0,0278780875343059;2,79
2009;"0115";"Totalt";0;189;6706;6895;0,0274111675126904;2,74
2010;"0115";"Totalt";0;190;7041;7231;0,0262757571566865;2,63
2011;"0115";"Totalt";0;236;7148;7384;0,0319609967497291;3,2
2012;"0115";"Totalt";0;234;7394;7628;0,0306764551651809;3,07
2013;"0115";"Totalt";0;244;7534;7778;0,0313705322705066;3,14
2014;"0115";"Totalt";0;237;7471;7708;0,030747275557862;3,07
2015;"0115";"Totalt";0;188;7655;7843;0,0239704194823409;2,4
2016;"0115";"Totalt";0;178;7889;8067;0,0220652039171935;2,21
2017;"0115";"Totalt";0;172;8022;8194;0,0209909690017086;2,1
2018;"0115";"Totalt";0;183;7972;8155;0,0224402207234825;2,24
2019;"0115";"Totalt";0;190;8174;8364;0,0227164036346246;2,27
2020;"0115";"Totalt";0;190;8161;8351;0,0227517662555383;2,28
2021;"0115";"Totalt";0;203;8419;8622;0,0235444212479703;2,35
2022;"0115";"Totalt";0;220;8927;9147;0,0240516016180168;2,41
2007;"0117";"Totalt";0;374;8136;8510;0,0439482961222092;4,39
2008;"0117";"Totalt";0;360;8241;8601;0,0418555981862574;4,19
2009;"0117";"Totalt";0;356;8260;8616;0,0413184772516249;4,13
2010;"0117";"Totalt";0;359;8643;9002;0,0398800266607421;3,99
2011;"0117";"Totalt";0;389;8762;9151;0,0425090154081521;4,25
2012;"0117";"Totalt";0;391;8833;9224;0,0423894189071986;4,24
2013;"0117";"Totalt";0;371;9070;9441;0,0392966846732338;3,93
2014;"0117";"Totalt";0;368;9328;9696;0,037953795379538;3,8
2015;"0117";"Totalt";0;363;9480;9843;0,0368790003047851;3,69
2016;"0117";"Totalt";0;354;9681;10035;0,0352765321375187;3,53
2017;"0117";"Totalt";0;369;9702;10071;0,0366398570151921;3,66
2018;"0117";"Totalt";0;361;9803;10164;0,0355175127902401;3,55
2019;"0117";"Totalt";0;343;10122;10465;0,0327759197324415;3,28
2020;"0117";"Totalt";0;325;10289;10614;0,0306199359336725;3,06
2021;"0117";"Totalt";0;366;10647;11013;0,033233451375647;3,32
2022;"0117";"Totalt";0;393;11102;11495;0,0341887777294476;3,42
2007;"0120";"Totalt";0;411;8741;9152;0,0449082167832168;4,49
2008;"0120";"Totalt";0;417;8946;9363;0,0445370073694329;4,45
2009;"0120";"Totalt";0;417;8956;9373;0,0444894910914328;4,45
2010;"0120";"Totalt";0;376;9231;9607;0,0391381284480067;3,91
2011;"0120";"Totalt";0;380;9363;9743;0,0390023606691984;3,9
2012;"0120";"Totalt";0;391;9550;9941;0,039332059148979;3,93
2013;"0120";"Totalt";0;425;9904;10329;0,0411462871526769;4,11
2014;"0120";"Totalt";0;423;10137;10560;0,0400568181818182;4,01
2015;"0120";"Totalt";0;440;10432;10872;0,0404709345106696;4,05
2016;"0120";"Totalt";0;445;10720;11165;0,0398566950291088;3,99
2017;"0120";"Totalt";0;467;10863;11330;0,0412180052956752;4,12
2018;"0120";"Totalt";0;474;10808;11282;0,0420138273355788;4,2
2019;"0120";"Totalt";0;493;10927;11420;0,043169877408056;4,32
2020;"0120";"Totalt";0;489;10901;11390;0,0429323968393327;4,29
2021;"0120";"Totalt";0;483;11389;11872;0,0406839622641509;4,07
2022;"0120";"Totalt";0;530;11604;12134;0,0436789187407285;4,37
2007;"0123";"Totalt";0;687;20468;21155;0,0324745922949657;3,25
2008;"0123";"Totalt";0;735;20390;21125;0,034792899408284;3,48
2009;"0123";"Totalt";0;716;19824;20540;0,0348588120740019;3,49
2010;"0123";"Totalt";0;727;21039;21766;0,0334007167141413;3,34
2011;"0123";"Totalt";0;741;20928;21669;0,0341963173196733;3,42
2012;"0123";"Totalt";0;772;21166;21938;0,0351900811377518;3,52
2013;"0123";"Totalt";0;809;21678;22487;0,0359763418864233;3,6
2014;"0123";"Totalt";0;771;22141;22912;0,0336504888268156;3,37
2015;"0123";"Totalt";0;943;22608;23551;0,0400407626003142;4
2016;"0123";"Totalt";0;1006;22953;23959;0,0419883968446095;4,2
2017;"0123";"Totalt";0;1034;23445;24479;0,0422402875934474;4,22
2018;"0123";"Totalt";0;979;24113;25092;0,0390164195759605;3,9
2019;"0123";"Totalt";0;1007;24274;25281;0,039832285115304;3,98
2020;"0123";"Totalt";0;1028;23752;24780;0,0414850686037127;4,15
2021;"0123";"Totalt";0;894;25200;26094;0,0342607495976086;3,43
2022;"0123";"Totalt";0;928;25997;26925;0,0344661095636026;3,45
2007;"0125";"Totalt";0;253;5871;6124;0,0413128674069236;4,13
2008;"0125";"Totalt";0;276;6380;6656;0,0414663461538462;4,15
2009;"0125";"Totalt";0;253;6617;6870;0,0368267831149927;3,68
2010;"0125";"Totalt";0;231;6924;7155;0,0322851153039832;3,23
2011;"0125";"Totalt";0;267;7058;7325;0,0364505119453925;3,65
2012;"0125";"Totalt";0;343;7240;7583;0,0452327574838454;4,52
2013;"0125";"Totalt";0;271;7480;7751;0,0349632305508967;3,5
2014;"0125";"Totalt";0;259;7621;7880;0,0328680203045685;3,29
2015;"0125";"Totalt";0;280;7744;8024;0,0348953140578265;3,49
2016;"0125";"Totalt";0;264;8153;8417;0,0313650944517049;3,14
2017;"0125";"Totalt";0;280;8394;8674;0,0322803781415725;3,23
2018;"0125";"Totalt";0;278;8340;8618;0,032258064516129;3,23
2019;"0125";"Totalt";0;262;7499;7761;0,0337585362710991;3,38
2020;"0125";"Totalt";0;248;7501;7749;0,0320041295651052;3,2
2021;"0125";"Totalt";0;253;7699;7952;0,0318158953722334;3,18
2022;"0125";"Totalt";0;272;7652;7924;0,0343260979303382;3,43
2007;"0126";"Totalt";0;826;37903;38729;0,0213276872627747;2,13
2008;"0126";"Totalt";0;910;38852;39762;0,02288617272773;2,29
2009;"0126";"Totalt";0;866;38311;39177;0,0221048063915052;2,21
2010;"0126";"Totalt";0;942;39859;40801;0,0230876694198672;2,31
2011;"0126";"Totalt";0;883;40802;41685;0,0211826796209668;2,12
2012;"0126";"Totalt";0;867;41589;42456;0,0204211418880724;2,04
2013;"0126";"Totalt";0;930;41736;42666;0,0217972155814935;2,18
2014;"0126";"Totalt";0;956;42075;43031;0,0222165415630592;2,22
2015;"0126";"Totalt";0;1167;43078;44245;0,0263758616792858;2,64
2016;"0126";"Totalt";0;1047;42398;43445;0,0240994360685925;2,41
2017;"0126";"Totalt";0;1070;43300;44370;0,0241153932837503;2,41
2018;"0126";"Totalt";0;1073;44045;45118;0,0237820825391196;2,38
2019;"0126";"Totalt";0;1015;45062;46077;0,0220283438591922;2,2
2020;"0126";"Totalt";0;950;44333;45283;0,0209791754079898;2,1
2021;"0126";"Totalt";0;969;45534;46503;0,0208373653312689;2,08
2022;"0126";"Totalt";0;1039;45919;46958;0,0221261552877039;2,21
2007;"0127";"Totalt";0;997;19074;20071;0,0496736585122814;4,97
2008;"0127";"Totalt";0;934;19428;20362;0,0458697573912189;4,59
2009;"0127";"Totalt";0;840;19077;19917;0,0421750263593915;4,22
2010;"0127";"Totalt";0;884;19810;20694;0,0427176959505171;4,27
2011;"0127";"Totalt";0;903;20023;20926;0,0431520596387269;4,32
2012;"0127";"Totalt";0;902;20399;21301;0,0423454297920285;4,23
2013;"0127";"Totalt";0;861;20569;21430;0,0401773215118992;4,02
2014;"0127";"Totalt";0;848;20902;21750;0,0389885057471264;3,9
2015;"0127";"Totalt";0;808;21692;22500;0,0359111111111111;3,59
2016;"0127";"Totalt";0;871;22380;23251;0,0374607543761559;3,75
2017;"0127";"Totalt";0;1336;22312;23648;0,0564952638700947;5,65
2018;"0127";"Totalt";0;1311;22403;23714;0,0552837985999831;5,53
2019;"0127";"Totalt";0;1127;22488;23615;0,0477239042981156;4,77
2020;"0127";"Totalt";0;837;22294;23131;0,0361852060006052;3,62
2021;"0127";"Totalt";0;846;22688;23534;0,0359479901419223;3,59
2022;"0127";"Totalt";0;871;23094;23965;0,0363446693094096;3,63
2007;"0128";"Totalt";0;64;2260;2324;0,0275387263339071;2,75
2008;"0128";"Totalt";0;71;2330;2401;0,0295710120783007;2,96
2009;"0128";"Totalt";0;68;2368;2436;0,0279146141215107;2,79
2010;"0128";"Totalt";0;75;2521;2596;0,0288906009244992;2,89
2011;"0128";"Totalt";0;90;2426;2516;0,0357710651828299;3,58
2012;"0128";"Totalt";0;79;2504;2583;0,0305845915602013;3,06
2013;"0128";"Totalt";0;74;2542;2616;0,0282874617737003;2,83
2014;"0128";"Totalt";0;79;2564;2643;0,0298902762012864;2,99
2015;"0128";"Totalt";0;86;2650;2736;0,0314327485380117;3,14
2016;"0128";"Totalt";0;79;2676;2755;0,0286751361161524;2,87
2017;"0128";"Totalt";0;74;2800;2874;0,0257480862908838;2,57
2018;"0128";"Totalt";0;84;2757;2841;0,0295670538542767;2,96
2019;"0128";"Totalt";0;91;2650;2741;0,0331995622035753;3,32
2020;"0128";"Totalt";0;88;2481;2569;0,0342545737641105;3,43
2021;"0128";"Totalt";0;110;2707;2817;0,0390486332978346;3,9
2022;"0128";"Totalt";0;92;2771;2863;0,0321341250436605;3,21
2007;"0136";"Totalt";0;498;21709;22207;0,0224253613725402;2,24
2008;"0136";"Totalt";0;514;21554;22068;0,0232916440094254;2,33
2009;"0136";"Totalt";0;536;21403;21939;0,0244313779114818;2,44
2010;"0136";"Totalt";0;573;22236;22809;0,0251216625016441;2,51
2011;"0136";"Totalt";0;538;23128;23666;0,0227330347333728;2,27
2012;"0136";"Totalt";0;533;23510;24043;0,02216861456557;2,22
2013;"0136";"Totalt";0;563;24252;24815;0,0226878903888777;2,27
2014;"0136";"Totalt";0;622;24515;25137;0,0247444006842503;2,47
2015;"0136";"Totalt";0;565;25243;25808;0,0218924364538128;2,19
2016;"0136";"Totalt";0;538;25931;26469;0,0203256639842835;2,03
2017;"0136";"Totalt";0;540;26502;27042;0,0199689372087863;2
2018;"0136";"Totalt";0;566;26665;27231;0,0207851345892549;2,08
2019;"0136";"Totalt";0;645;27107;27752;0,0232415681752666;2,32
2020;"0136";"Totalt";0;596;27882;28478;0,0209284359856732;2,09
2021;"0136";"Totalt";0;689;29292;29981;0,0229812214402455;2,3
2022;"0136";"Totalt";0;746;28716;29462;0,0253207521553187;2,53
2007;"0138";"Totalt";0;343;8776;9119;0,0376137734400702;3,76
2008;"0138";"Totalt";0;362;8959;9321;0,0388370346529342;3,88
2009;"0138";"Totalt";0;358;8849;9207;0,0388834582382969;3,89
2010;"0138";"Totalt";0;349;9144;9493;0,0367639313178131;3,68
2011;"0138";"Totalt";0;343;9284;9627;0,035628960216059;3,56
2012;"0138";"Totalt";0;349;9573;9922;0,0351743600080629;3,52
2013;"0138";"Totalt";0;390;9518;9908;0,0393621316108195;3,94
2014;"0138";"Totalt";0;384;9721;10105;0,0380009896091044;3,8
2015;"0138";"Totalt";0;390;9952;10342;0,0377103074840456;3,77
2016;"0138";"Totalt";0;389;10103;10492;0,0370758673274876;3,71
2017;"0138";"Totalt";0;406;10032;10438;0,0388963402950757;3,89
2018;"0138";"Totalt";0;446;10012;10458;0,0426467775865366;4,26
2019;"0138";"Totalt";0;446;10107;10553;0,0422628636406709;4,23
2020;"0138";"Totalt";0;433;10251;10684;0,0405278921752153;4,05
2021;"0138";"Totalt";0;416;10623;11039;0,0376845728779781;3,77
2022;"0138";"Totalt";0;455;10865;11320;0,0401943462897527;4,02
2007;"0139";"Totalt";0;92;6553;6645;0,0138449962377728;1,38
2008;"0139";"Totalt";0;118;7131;7249;0,0162781073251483;1,63
2009;"0139";"Totalt";0;112;6958;7070;0,0158415841584158;1,58
2010;"0139";"Totalt";0;116;6814;6930;0,0167388167388167;1,67
2011;"0139";"Totalt";0;116;7514;7630;0,0152031454783748;1,52
2012;"0139";"Totalt";0;111;7845;7956;0,0139517345399698;1,4
2013;"0139";"Totalt";0;110;7711;7821;0,0140646976090014;1,41
2014;"0139";"Totalt";0;107;7961;8068;0,013262270699058;1,33
2015;"0139";"Totalt";0;106;8133;8239;0,0128656390338633;1,29
2016;"0139";"Totalt";0;107;8526;8633;0,0123943009382602;1,24
2017;"0139";"Totalt";0;130;9039;9169;0,014178209183117;1,42
2018;"0139";"Totalt";0;119;9448;9567;0,012438590989861;1,24
2019;"0139";"Totalt";0;101;9144;9245;0,0109248242293131;1,09
2020;"0139";"Totalt";0;106;10487;10593;0,0100066081374493;1
2021;"0139";"Totalt";0;108;11297;11405;0,00946953090749671;0,95
2022;"0139";"Totalt";0;117;12140;12257;0,00954556579913519;0,95
2007;"0140";"Totalt";0;20;1968;1988;0,0100603621730382;1,01
2008;"0140";"Totalt";0;27;2037;2064;0,0130813953488372;1,31
2009;"0140";"Totalt";0;21;2061;2082;0,0100864553314121;1,01
2010;"0140";"Totalt";0;27;2150;2177;0,0124023886081764;1,24
2011;"0140";"Totalt";0;25;2200;2225;0,0112359550561798;1,12
2012;"0140";"Totalt";0;32;2173;2205;0,0145124716553288;1,45
2013;"0140";"Totalt";0;37;2181;2218;0,0166816952209197;1,67
2014;"0140";"Totalt";0;36;2228;2264;0,0159010600706714;1,59
2015;"0140";"Totalt";0;38;2220;2258;0,016829052258636;1,68
2016;"0140";"Totalt";0;36;2402;2438;0,014766201804758;1,48
2017;"0140";"Totalt";0;43;2470;2513;0,0171110226820533;1,71
2018;"0140";"Totalt";0;44;2537;2581;0,0170476559473072;1,7
2019;"0140";"Totalt";0;46;2684;2730;0,0168498168498168;1,68
2020;"0140";"Totalt";0;38;2859;2897;0,0131170176044184;1,31
2021;"0140";"Totalt";0;29;2907;2936;0,00987738419618529;0,99
2022;"0140";"Totalt";0;42;2980;3022;0,013898080741231;1,39
2007;"0160";"Totalt";0;1142;20440;21582;0,0529144657585025;5,29
2008;"0160";"Totalt";0;1195;20641;21836;0,0547261403187397;5,47
2009;"0160";"Totalt";0;1133;19966;21099;0,053699227451538;5,37
2010;"0160";"Totalt";0;1129;20617;21746;0,0519175940402833;5,19
2011;"0160";"Totalt";0;1184;20671;21855;0,0541752459391444;5,42
2012;"0160";"Totalt";0;1287;21008;22295;0,0577259475218659;5,77
2013;"0160";"Totalt";0;1289;21299;22588;0,0570656986010271;5,71
2014;"0160";"Totalt";0;1270;22077;23347;0,0543967104981368;5,44
2015;"0160";"Totalt";0;1242;22329;23571;0,0526918671248568;5,27
2016;"0160";"Totalt";0;1306;22602;23908;0,0546260665885896;5,46
2017;"0160";"Totalt";0;1271;23025;24296;0,0523131379650971;5,23
2018;"0160";"Totalt";0;1206;23231;24437;0,0493513933788927;4,94
2019;"0160";"Totalt";0;1231;23173;24404;0,0504425504015735;5,04
2020;"0160";"Totalt";0;1249;22886;24135;0,0517505697120365;5,18
2021;"0160";"Totalt";0;1217;23575;24792;0,0490884156179413;4,91
2022;"0160";"Totalt";0;1208;23858;25066;0,0481927710843374;4,82
2007;"0162";"Totalt";0;507;15220;15727;0,0322375532523685;3,22
2008;"0162";"Totalt";0;500;15370;15870;0,0315059861373661;3,15
2009;"0162";"Totalt";0;416;15205;15621;0,0266308174892773;2,66
2010;"0162";"Totalt";0;405;15898;16303;0,0248420536097651;2,48
2011;"0162";"Totalt";0;443;16478;16921;0,026180485786892;2,62
2012;"0162";"Totalt";0;405;16735;17140;0,0236289381563594;2,36
2013;"0162";"Totalt";0;439;17279;17718;0,0247770628739135;2,48
2014;"0162";"Totalt";0;461;17503;17964;0,0256624359830773;2,57
2015;"0162";"Totalt";0;442;17181;17623;0,0250808602394598;2,51
2016;"0162";"Totalt";0;404;17310;17714;0,0228068194648301;2,28
2017;"0162";"Totalt";0;423;17909;18332;0,0230744054113026;2,31
2018;"0162";"Totalt";0;477;18073;18550;0,0257142857142857;2,57
2019;"0162";"Totalt";0;482;19089;19571;0,0246282765316029;2,46
2020;"0162";"Totalt";0;484;19090;19574;0,0247266782466537;2,47
2021;"0162";"Totalt";0;498;19148;19646;0,0253486714852896;2,53
2022;"0162";"Totalt";0;487;19879;20366;0,0239124030246489;2,39
2007;"0163";"Totalt";0;989;21487;22476;0,0440024915465385;4,4
2008;"0163";"Totalt";0;840;22009;22849;0,036763096853254;3,68
2009;"0163";"Totalt";0;822;21709;22531;0,0364830677732901;3,65
2010;"0163";"Totalt";0;913;22522;23435;0,0389588222743759;3,9
2011;"0163";"Totalt";0;843;23358;24201;0,0348332713524235;3,48
2012;"0163";"Totalt";0;897;23569;24466;0,036663124335813;3,67
2013;"0163";"Totalt";0;815;24171;24986;0,0326182662290883;3,26
2014;"0163";"Totalt";0;805;24156;24961;0,0322503104843556;3,23
2015;"0163";"Totalt";0;808;23713;24521;0,0329513478243139;3,3
2016;"0163";"Totalt";0;771;23702;24473;0,0315041065664201;3,15
2017;"0163";"Totalt";0;714;23872;24586;0,0290409175953795;2,9
2018;"0163";"Totalt";0;684;23996;24680;0,0277147487844408;2,77
2019;"0163";"Totalt";0;770;24294;25064;0,0307213533354612;3,07
2020;"0163";"Totalt";0;703;23972;24675;0,0284903748733536;2,85
2021;"0163";"Totalt";0;732;24632;25364;0,0288598012931714;2,89
2022;"0163";"Totalt";0;860;25131;25991;0,0330883767457966;3,31
2007;"0180";"Totalt";0;61166;479014;540180;0,11323262616165;11,32
2008;"0180";"Totalt";0;62357;490765;553122;0,112736430660867;11,27
2009;"0180";"Totalt";0;61102;488885;549987;0,111097171387687;11,11
2010;"0180";"Totalt";0;62783;509770;572553;0,109654477402092;10,97
2011;"0180";"Totalt";0;64194;522416;586610;0,109432161061012;10,94
2012;"0180";"Totalt";0;65168;537456;602624;0,108140399320306;10,81
2013;"0180";"Totalt";0;65526;550167;615693;0,10642641706175;10,64
2014;"0180";"Totalt";0;66704;559885;626589;0,106455746909058;10,65
2015;"0180";"Totalt";0;67495;575382;642877;0,104988979229308;10,5
2016;"0180";"Totalt";0;68875;587888;656763;0,104870402260785;10,49
2017;"0180";"Totalt";0;70029;599413;669442;0,104608016825954;10,46
2018;"0180";"Totalt";0;70514;607761;678275;0,103960782868306;10,4
2019;"0180";"Totalt";0;70657;620470;691127;0,102234466313717;10,22
2020;"0180";"Totalt";0;67088;605098;672186;0,0998057085390056;9,98
2021;"0180";"Totalt";0;68418;626413;694831;0,0984671092682969;9,85
2022;"0180";"Totalt";0;74884;652680;727564;0,10292427882633;10,29
2007;"0181";"Totalt";0;1097;42789;43886;0,0249965820535023;2,5
2008;"0181";"Totalt";0;1159;43323;44482;0,0260554831167663;2,61
2009;"0181";"Totalt";0;1104;41365;42469;0,0259954319621371;2,6
2010;"0181";"Totalt";0;1067;41777;42844;0,0249043039865559;2,49
2011;"0181";"Totalt";0;1016;42775;43791;0,0232011143842342;2,32
2012;"0181";"Totalt";0;1064;43611;44675;0,0238164521544488;2,38
2013;"0181";"Totalt";0;1074;43510;44584;0,0240893594114481;2,41
2014;"0181";"Totalt";0;1021;43418;44439;0,0229753144760233;2,3
2015;"0181";"Totalt";0;1059;44458;45517;0,0232660324713843;2,33
2016;"0181";"Totalt";0;1038;46263;47301;0,0219445677681233;2,19
2017;"0181";"Totalt";0;1008;47573;48581;0,0207488524320207;2,07
2018;"0181";"Totalt";0;1027;49117;50144;0,0204810146777281;2,05
2019;"0181";"Totalt";0;1056;49662;50718;0,020821010292204;2,08
2020;"0181";"Totalt";0;893;49268;50161;0,0178026753852595;1,78
2021;"0181";"Totalt";0;912;51338;52250;0,0174545454545455;1,75
2022;"0181";"Totalt";0;891;52916;53807;0,0165591837493263;1,66
2007;"0182";"Totalt";0;1936;27181;29117;0,0664903664525878;6,65
2008;"0182";"Totalt";0;2087;27698;29785;0,0700688265905657;7,01
2009;"0182";"Totalt";0;2037;27955;29992;0,067918111496399;6,79
2010;"0182";"Totalt";0;2157;29279;31436;0,0686155999491029;6,86
2011;"0182";"Totalt";0;2125;29484;31609;0,0672276883166187;6,72
2012;"0182";"Totalt";0;2186;30547;32733;0,0667827574618886;6,68
2013;"0182";"Totalt";0;2237;29917;32154;0,0695714374572371;6,96
2014;"0182";"Totalt";0;2173;30421;32594;0,0666687120328895;6,67
2015;"0182";"Totalt";0;2282;30458;32740;0,0697006719609041;6,97
2016;"0182";"Totalt";0;2235;30478;32713;0,0683214624155535;6,83
2017;"0182";"Totalt";0;2164;30906;33070;0,0654369519201693;6,54
2018;"0182";"Totalt";0;2070;31624;33694;0,0614352703745474;6,14
2019;"0182";"Totalt";0;2004;31787;33791;0,0593057322955817;5,93
2020;"0182";"Totalt";0;1968;31682;33650;0,0584843982169391;5,85
2021;"0182";"Totalt";0;1951;32309;34260;0,0569468768242849;5,69
2022;"0182";"Totalt";0;1934;33652;35586;0,0543472151969876;5,43
2007;"0183";"Totalt";0;702;17539;18241;0,0384847321966997;3,85
2008;"0183";"Totalt";0;580;18435;19015;0,0305022350775703;3,05
2009;"0183";"Totalt";0;529;17895;18424;0,028712548849327;2,87
2010;"0183";"Totalt";0;616;18378;18994;0,0324312940928714;3,24
2011;"0183";"Totalt";0;646;17785;18431;0,0350496446204764;3,5
2012;"0183";"Totalt";0;638;17945;18583;0,0343324543938008;3,43
2013;"0183";"Totalt";0;524;18476;19000;0,0275789473684211;2,76
2014;"0183";"Totalt";0;520;21202;21722;0,0239388638246939;2,39
2015;"0183";"Totalt";0;498;21365;21863;0,0227782097607831;2,28
2016;"0183";"Totalt";0;517;22136;22653;0,0228225842051825;2,28
2017;"0183";"Totalt";0;500;22006;22506;0,0222162978761219;2,22
2018;"0183";"Totalt";0;553;21802;22355;0,0247371952583315;2,47
2019;"0183";"Totalt";0;548;21831;22379;0,0244872425041333;2,45
2020;"0183";"Totalt";0;515;22135;22650;0,0227373068432671;2,27
2021;"0183";"Totalt";0;556;24201;24757;0,0224582946237428;2,25
2022;"0183";"Totalt";0;537;26047;26584;0,0202001203731568;2,02
2007;"0184";"Totalt";0;3069;65171;68240;0,0449736225087925;4,5
2008;"0184";"Totalt";0;3071;66305;69376;0,044266028597786;4,43
2009;"0184";"Totalt";0;3204;65558;68762;0,0465955033303278;4,66
2010;"0184";"Totalt";0;3143;65166;68309;0,046011506536474;4,6
2011;"0184";"Totalt";0;2968;66865;69833;0,0425013961880486;4,25
2012;"0184";"Totalt";0;2919;70664;73583;0,0396694888765068;3,97
2013;"0184";"Totalt";0;3050;69937;72987;0,0417882636633921;4,18
2014;"0184";"Totalt";0;2937;73516;76453;0,0384157587014244;3,84
2015;"0184";"Totalt";0;2434;76461;78895;0,0308511312503961;3,09
2016;"0184";"Totalt";0;2502;84153;86655;0,0288731175350528;2,89
2017;"0184";"Totalt";0;2616;87521;90137;0,0290224879905033;2,9
2018;"0184";"Totalt";0;2574;91396;93970;0,0273917207619453;2,74
2019;"0184";"Totalt";0;2560;96168;98728;0,0259298274045863;2,59
2020;"0184";"Totalt";0;2287;100927;103214;0,0221578468037282;2,22
2021;"0184";"Totalt";0;2430;103429;105859;0,0229550628666434;2,3
2022;"0184";"Totalt";0;2452;106445;108897;0,0225166900832897;2,25
2007;"0186";"Totalt";0;1172;10044;11216;0,104493580599144;10,45
2008;"0186";"Totalt";0;1169;10167;11336;0,103122794636556;10,31
2009;"0186";"Totalt";0;1139;10319;11458;0,099406528189911;9,94
2010;"0186";"Totalt";0;1143;10437;11580;0,0987046632124352;9,87
2011;"0186";"Totalt";0;1043;10030;11073;0,0941930822721936;9,42
2012;"0186";"Totalt";0;999;10280;11279;0,0885716818866921;8,86
2013;"0186";"Totalt";0;970;10324;11294;0,0858863113157429;8,59
2014;"0186";"Totalt";0;898;10393;11291;0,079532370914888;7,95
2015;"0186";"Totalt";0;901;10354;11255;0,0800533096401599;8,01
2016;"0186";"Totalt";0;721;10511;11232;0,0641915954415954;6,42
2017;"0186";"Totalt";0;855;10402;11257;0,0759527405170116;7,6
2018;"0186";"Totalt";0;829;10369;11198;0,0740310769780318;7,4
2019;"0186";"Totalt";0;708;10739;11447;0,0618502664453569;6,19
2020;"0186";"Totalt";0;603;10528;11131;0,0541730302758063;5,42
2021;"0186";"Totalt";0;667;10797;11464;0,058182135380321;5,82
2022;"0186";"Totalt";0;663;10884;11547;0,057417511041829;5,74
2007;"0187";"Totalt";0;130;2251;2381;0,0545989080218396;5,46
2008;"0187";"Totalt";0;144;2236;2380;0,0605042016806723;6,05
2009;"0187";"Totalt";0;121;2217;2338;0,0517536355859709;5,18
2010;"0187";"Totalt";0;116;2276;2392;0,048494983277592;4,85
2011;"0187";"Totalt";0;113;2309;2422;0,0466556564822461;4,67
2012;"0187";"Totalt";0;113;2291;2404;0,0470049916805324;4,7
2013;"0187";"Totalt";0;114;2367;2481;0,0459492140266022;4,59
2014;"0187";"Totalt";0;122;2370;2492;0,0489566613162119;4,9
2015;"0187";"Totalt";0;134;2455;2589;0,0517574353032059;5,18
2016;"0187";"Totalt";0;134;2581;2715;0,0493554327808471;4,94
2017;"0187";"Totalt";0;130;2570;2700;0,0481481481481481;4,81
2018;"0187";"Totalt";0;140;2468;2608;0,053680981595092;5,37
2019;"0187";"Totalt";0;130;2553;2683;0,0484532240029817;4,85
2020;"0187";"Totalt";0;125;2525;2650;0,0471698113207547;4,72
2021;"0187";"Totalt";0;116;2556;2672;0,0434131736526946;4,34
2022;"0187";"Totalt";0;119;2537;2656;0,0448042168674699;4,48
2007;"0188";"Totalt";0;633;18437;19070;0,0331934976402727;3,32
2008;"0188";"Totalt";0;575;18294;18869;0,0304732630240076;3,05
2009;"0188";"Totalt";0;529;17892;18421;0,0287172249063569;2,87
2010;"0188";"Totalt";0;499;18765;19264;0,0259032392026578;2,59
2011;"0188";"Totalt";0;532;19022;19554;0,0272067096246292;2,72
2012;"0188";"Totalt";0;525;19310;19835;0,026468364003025;2,65
2013;"0188";"Totalt";0;495;19433;19928;0,0248394219189081;2,48
2014;"0188";"Totalt";0;496;19509;20005;0,0247938015496126;2,48
2015;"0188";"Totalt";0;464;19619;20083;0,0231041179106707;2,31
2016;"0188";"Totalt";0;466;19978;20444;0,0227939737820387;2,28
2017;"0188";"Totalt";0;480;20271;20751;0,0231314153534769;2,31
2018;"0188";"Totalt";0;489;20502;20991;0,0232956981563527;2,33
2019;"0188";"Totalt";0;498;21312;21810;0,0228335625859697;2,28
2020;"0188";"Totalt";0;493;21261;21754;0,0226624988507861;2,27
2021;"0188";"Totalt";0;528;21703;22231;0,0237506185056903;2,38
2022;"0188";"Totalt";0;532;22249;22781;0,0233527939949958;2,34
2007;"0191";"Totalt";0;514;24851;25365;0,0202641435048295;2,03
2008;"0191";"Totalt";0;455;25735;26190;0,017373043146239;1,74
2009;"0191";"Totalt";0;469;24273;24742;0,0189556220192385;1,9
2010;"0191";"Totalt";0;475;24345;24820;0,0191377921031426;1,91
2011;"0191";"Totalt";0;463;25755;26218;0,0176596231596613;1,77
2012;"0191";"Totalt";0;430;26483;26913;0,0159774086872515;1,6
2013;"0191";"Totalt";0;437;27112;27549;0,0158626447420959;1,59
2014;"0191";"Totalt";0;442;27008;27450;0,0161020036429873;1,61
2015;"0191";"Totalt";0;477;27187;27664;0,0172426257952574;1,72
2016;"0191";"Totalt";0;482;28272;28754;0,0167628851638033;1,68
2017;"0191";"Totalt";0;535;28542;29077;0,0183994222237507;1,84
2018;"0191";"Totalt";0;462;29574;30036;0,0153815421494207;1,54
2019;"0191";"Totalt";0;473;29263;29736;0,0159066451439333;1,59
2020;"0191";"Totalt";0;414;25636;26050;0,0158925143953935;1,59
2021;"0191";"Totalt";0;387;24442;24829;0,0155866124290145;1,56
2022;"0191";"Totalt";0;512;27023;27535;0,0185945160704558;1,86
2007;"0192";"Totalt";0;172;6301;6473;0,0265719141047428;2,66
2008;"0192";"Totalt";0;172;6093;6265;0,0274541101356744;2,75
2009;"0192";"Totalt";0;167;6046;6213;0,026879124416546;2,69
2010;"0192";"Totalt";0;170;6130;6300;0,026984126984127;2,7
2011;"0192";"Totalt";0;179;6220;6399;0,027973120800125;2,8
2012;"0192";"Totalt";0;173;6258;6431;0,0269009485305551;2,69
2013;"0192";"Totalt";0;171;6225;6396;0,0267354596622889;2,67
2014;"0192";"Totalt";0;186;6092;6278;0,0296272698311564;2,96
2015;"0192";"Totalt";0;184;6189;6373;0,0288718029185627;2,89
2016;"0192";"Totalt";0;173;6419;6592;0,026243932038835;2,62
2017;"0192";"Totalt";0;182;6600;6782;0,0268357416691242;2,68
2018;"0192";"Totalt";0;197;6625;6822;0,0288771621225447;2,89
2019;"0192";"Totalt";0;192;6747;6939;0,0276696930393428;2,77
2020;"0192";"Totalt";0;151;6544;6695;0,022554144884242;2,26
2021;"0192";"Totalt";0;162;6792;6954;0,0232959447799827;2,33
2022;"0192";"Totalt";0;166;6916;7082;0,023439706297656;2,34
2007;"0305";"Totalt";0;121;4198;4319;0,0280157443852744;2,8
2008;"0305";"Totalt";0;129;4248;4377;0,0294722412611378;2,95
2009;"0305";"Totalt";0;120;4235;4355;0,0275545350172216;2,76
2010;"0305";"Totalt";0;133;4414;4547;0,0292500549813064;2,93
2011;"0305";"Totalt";0;143;4554;4697;0,0304449648711944;3,04
2012;"0305";"Totalt";0;99;4535;4634;0,0213638325420803;2,14
2013;"0305";"Totalt";0;111;4721;4832;0,0229718543046358;2,3
2014;"0305";"Totalt";0;98;4726;4824;0,0203150912106136;2,03
2015;"0305";"Totalt";0;102;4754;4856;0,021004942339374;2,1
2016;"0305";"Totalt";0;123;4757;4880;0,0252049180327869;2,52
2017;"0305";"Totalt";0;129;4895;5024;0,0256767515923567;2,57
2018;"0305";"Totalt";0;134;4941;5075;0,0264039408866995;2,64
2019;"0305";"Totalt";0;174;5254;5428;0,0320560058953574;3,21
2020;"0305";"Totalt";0;132;5191;5323;0,0247980462145407;2,48
2021;"0305";"Totalt";0;156;5614;5770;0,0270363951473137;2,7
2022;"0305";"Totalt";0;157;5805;5962;0,0263334451526333;2,63
2007;"0319";"Totalt";0;61;2342;2403;0,025384935497295;2,54
2008;"0319";"Totalt";0;63;2263;2326;0,027085124677558;2,71
2009;"0319";"Totalt";0;64;2264;2328;0,0274914089347079;2,75
2010;"0319";"Totalt";0;44;2305;2349;0,0187313750532141;1,87
2011;"0319";"Totalt";0;39;2211;2250;0,0173333333333333;1,73
2012;"0319";"Totalt";0;34;2293;2327;0,0146110872367856;1,46
2013;"0319";"Totalt";0;29;2198;2227;0,0130220026942075;1,3
2014;"0319";"Totalt";0;28;2182;2210;0,0126696832579186;1,27
2015;"0319";"Totalt";0;34;2234;2268;0,0149911816578483;1,5
2016;"0319";"Totalt";0;33;2285;2318;0,0142364106988783;1,42
2017;"0319";"Totalt";0;35;2337;2372;0,0147554806070826;1,48
2018;"0319";"Totalt";0;33;2378;2411;0,0136872666943177;1,37
2019;"0319";"Totalt";0;36;2404;2440;0,0147540983606557;1,48
2020;"0319";"Totalt";0;30;2415;2445;0,0122699386503067;1,23
2021;"0319";"Totalt";0;38;2412;2450;0,0155102040816327;1,55
2022;"0319";"Totalt";0;35;2478;2513;0,0139275766016713;1,39
2007;"0330";"Totalt";0;74;2933;3007;0,0246092450947788;2,46
2008;"0330";"Totalt";0;71;2981;3052;0,0232634338138925;2,33
2009;"0330";"Totalt";0;71;3012;3083;0,0230295167045086;2,3
2010;"0330";"Totalt";0;86;3155;3241;0,0265350200555384;2,65
2011;"0330";"Totalt";0;84;3229;3313;0,0253546634470269;2,54
2012;"0330";"Totalt";0;88;3331;3419;0,025738520035098;2,57
2013;"0330";"Totalt";0;87;3408;3495;0,0248927038626609;2,49
2014;"0330";"Totalt";0;90;3527;3617;0,0248824993088195;2,49
2015;"0330";"Totalt";0;92;3520;3612;0,0254706533776301;2,55
2016;"0330";"Totalt";0;89;3677;3766;0,0236325013276686;2,36
2017;"0330";"Totalt";0;104;3654;3758;0,0276742948376796;2,77
2018;"0330";"Totalt";0;103;3712;3815;0,0269986893840105;2,7
2019;"0330";"Totalt";0;100;3828;3928;0,0254582484725051;2,55
2020;"0330";"Totalt";0;106;3871;3977;0,0266532562232839;2,67
2021;"0330";"Totalt";0;97;4066;4163;0,0233005044439106;2,33
2022;"0330";"Totalt";0;100;4221;4321;0,0231427910205971;2,31
2007;"0331";"Totalt";0;346;3465;3811;0,0907898189451588;9,08
2008;"0331";"Totalt";0;315;3356;3671;0,0858076818305639;8,58
2009;"0331";"Totalt";0;286;3130;3416;0,0837236533957845;8,37
2010;"0331";"Totalt";0;239;3319;3558;0,0671725688589095;6,72
2011;"0331";"Totalt";0;271;3299;3570;0,0759103641456583;7,59
2012;"0331";"Totalt";0;272;3279;3551;0,0765981413686286;7,66
2013;"0331";"Totalt";0;248;3376;3624;0,0684326710816777;6,84
2014;"0331";"Totalt";0;253;3402;3655;0,0692202462380301;6,92
2015;"0331";"Totalt";0;266;3387;3653;0,07281686285245;7,28
2016;"0331";"Totalt";0;311;3407;3718;0,0836471221086606;8,36
2017;"0331";"Totalt";0;443;3566;4009;0,110501371913195;11,05
2018;"0331";"Totalt";0;660;3747;4407;0,149761742682097;14,98
2019;"0331";"Totalt";0;612;3862;4474;0,136790344210997;13,68
2020;"0331";"Totalt";0;615;3989;4604;0,133579496090356;13,36
2021;"0331";"Totalt";0;596;4202;4798;0,124218424343476;12,42
2022;"0331";"Totalt";0;493;4217;4710;0,104670912951168;10,47
2007;"0360";"Totalt";0;102;6256;6358;0,0160427807486631;1,6
2008;"0360";"Totalt";0;108;6352;6460;0,01671826625387;1,67
2009;"0360";"Totalt";0;104;5908;6012;0,0172987358616101;1,73
2010;"0360";"Totalt";0;94;6024;6118;0,0153644982020268;1,54
2011;"0360";"Totalt";0;95;5995;6090;0,0155993431855501;1,56
2012;"0360";"Totalt";0;103;5880;5983;0,0172154437573124;1,72
2013;"0360";"Totalt";0;102;5793;5895;0,0173027989821883;1,73
2014;"0360";"Totalt";0;116;5756;5872;0,0197547683923706;1,98
2015;"0360";"Totalt";0;99;5814;5913;0,0167427701674277;1,67
2016;"0360";"Totalt";0;103;5940;6043;0,0170445143140824;1,7
2017;"0360";"Totalt";0;109;6332;6441;0,0169228380686229;1,69
2018;"0360";"Totalt";0;109;6494;6603;0,0165076480387703;1,65
2019;"0360";"Totalt";0;108;6494;6602;0,0163586791881248;1,64
2020;"0360";"Totalt";0;97;6294;6391;0,0151775934908465;1,52
2021;"0360";"Totalt";0;103;6379;6482;0,0158901573588399;1,59
2022;"0360";"Totalt";0;108;6574;6682;0,0161628255013469;1,62
2007;"0380";"Totalt";0;4138;80890;85028;0,0486663216822694;4,87
2008;"0380";"Totalt";0;4118;79698;83816;0,0491314307530782;4,91
2009;"0380";"Totalt";0;4148;78994;83142;0,0498905486998148;4,99
2010;"0380";"Totalt";0;4257;82179;86436;0,0492503123698459;4,93
2011;"0380";"Totalt";0;4240;83824;88064;0,0481468023255814;4,81
2012;"0380";"Totalt";0;4197;85908;90105;0,0465789911769602;4,66
2013;"0380";"Totalt";0;4111;87643;91754;0,0448045861760795;4,48
2014;"0380";"Totalt";0;4051;88614;92665;0,0437166136081584;4,37
2015;"0380";"Totalt";0;4143;90819;94962;0,0436279775067922;4,36
2016;"0380";"Totalt";0;4121;93892;98013;0,0420454429514452;4,2
2017;"0380";"Totalt";0;4087;96057;100144;0,0408112318261703;4,08
2018;"0380";"Totalt";0;3911;96343;100254;0,0390109122828017;3,9
2019;"0380";"Totalt";0;4179;99916;104095;0,0401460204620779;4,01
2020;"0380";"Totalt";0;3870;99462;103332;0,0374520961560794;3,75
2021;"0380";"Totalt";0;3781;102611;106392;0,035538386344838;3,55
2022;"0380";"Totalt";0;4063;106275;110338;0,0368232159364861;3,68
2007;"0381";"Totalt";0;304;13575;13879;0,0219035953598962;2,19
2008;"0381";"Totalt";0;295;13022;13317;0,0221521363670496;2,22
2009;"0381";"Totalt";0;294;12707;13001;0,0226136451042228;2,26
2010;"0381";"Totalt";0;332;13350;13682;0,0242654582663353;2,43
2011;"0381";"Totalt";0;318;13971;14289;0,0222548813772832;2,23
2012;"0381";"Totalt";0;321;14262;14583;0,022011931701296;2,2
2013;"0381";"Totalt";0;330;14441;14771;0,0223410737255433;2,23
2014;"0381";"Totalt";0;330;14810;15140;0,0217965653896962;2,18
2015;"0381";"Totalt";0;366;15271;15637;0,0234060241734348;2,34
2016;"0381";"Totalt";0;337;15834;16171;0,0208397749056954;2,08
2017;"0381";"Totalt";0;306;16082;16388;0,0186721991701245;1,87
2018;"0381";"Totalt";0;324;16488;16812;0,019271948608137;1,93
2019;"0381";"Totalt";0;339;16464;16803;0,0201749687555794;2,02
2020;"0381";"Totalt";0;304;16640;16944;0,0179414542020774;1,79
2021;"0381";"Totalt";0;306;17280;17586;0,0174002047082907;1,74
2022;"0381";"Totalt";0;336;17801;18137;0,0185256657661135;1,85
2007;"0382";"Totalt";0;78;8333;8411;0,00927357032457496;0,93
2008;"0382";"Totalt";0;87;8381;8468;0,0102739726027397;1,03
2009;"0382";"Totalt";0;79;8415;8494;0,00930068283494231;0,93
2010;"0382";"Totalt";0;78;8655;8733;0,00893163861216077;0,89
2011;"0382";"Totalt";0;90;8654;8744;0,0102927721866423;1,03
2012;"0382";"Totalt";0;86;8998;9084;0,00946719506825187;0,95
2013;"0382";"Totalt";0;81;9103;9184;0,00881968641114983;0,88
2014;"0382";"Totalt";0;90;9151;9241;0,00973920571366735;0,97
2015;"0382";"Totalt";0;88;8978;9066;0,00970659607324068;0,97
2016;"0382";"Totalt";0;90;8993;9083;0,00990862049983486;0,99
2017;"0382";"Totalt";0;76;8919;8995;0,0084491384102279;0,84
2018;"0382";"Totalt";0;85;9033;9118;0,00932221978504058;0,93
2019;"0382";"Totalt";0;89;9006;9095;0,00978559648158329;0,98
2020;"0382";"Totalt";0;83;8989;9072;0,00914902998236332;0,91
2021;"0382";"Totalt";0;77;8894;8971;0,00858321257384907;0,86
2022;"0382";"Totalt";0;80;9148;9228;0,00866926744690074;0,87
2007;"0428";"Totalt";0;150;2722;2872;0,0522284122562674;5,22
2008;"0428";"Totalt";0;182;2786;2968;0,0613207547169811;6,13
2009;"0428";"Totalt";0;174;2688;2862;0,0607966457023061;6,08
2010;"0428";"Totalt";0;170;2635;2805;0,0606060606060606;6,06
2011;"0428";"Totalt";0;166;2539;2705;0,0613678373382625;6,14
2012;"0428";"Totalt";0;157;2512;2669;0,0588235294117647;5,88
2013;"0428";"Totalt";0;181;2472;2653;0,0682246513381078;6,82
2014;"0428";"Totalt";0;183;2496;2679;0,0683090705487122;6,83
2015;"0428";"Totalt";0;190;2548;2738;0,0693937180423667;6,94
2016;"0428";"Totalt";0;180;2606;2786;0,0646087580760948;6,46
2017;"0428";"Totalt";0;192;2620;2812;0,0682788051209104;6,83
2018;"0428";"Totalt";0;183;2562;2745;0,0666666666666667;6,67
2019;"0428";"Totalt";0;194;2567;2761;0,070264396957624;7,03
2020;"0428";"Totalt";0;170;2561;2731;0,0622482607103625;6,22
2021;"0428";"Totalt";0;183;2522;2705;0,0676524953789279;6,77
2022;"0428";"Totalt";0;177;2682;2859;0,061909758656873;6,19
2007;"0461";"Totalt";0;87;2447;2534;0,0343330702446725;3,43
2008;"0461";"Totalt";0;84;2404;2488;0,0337620578778135;3,38
2009;"0461";"Totalt";0;65;2324;2389;0,027208036835496;2,72
2010;"0461";"Totalt";0;73;2475;2548;0,0286499215070644;2,86
2011;"0461";"Totalt";0;76;2453;2529;0,0300514037168841;3,01
2012;"0461";"Totalt";0;80;2504;2584;0,0309597523219814;3,1
2013;"0461";"Totalt";0;87;2579;2666;0,0326331582895724;3,26
2014;"0461";"Totalt";0;82;2549;2631;0,0311668567084759;3,12
2015;"0461";"Totalt";0;81;2521;2602;0,031129900076864;3,11
2016;"0461";"Totalt";0;87;2516;2603;0,0334229734921245;3,34
2017;"0461";"Totalt";0;92;2448;2540;0,0362204724409449;3,62
2018;"0461";"Totalt";0;92;2482;2574;0,0357420357420357;3,57
2019;"0461";"Totalt";0;94;2520;2614;0,0359602142310635;3,6
2020;"0461";"Totalt";0;99;2543;2642;0,0374716124148372;3,75
2021;"0461";"Totalt";0;98;2623;2721;0,0360161705255421;3,6
2022;"0461";"Totalt";0;107;2815;2922;0,0366187542778919;3,66
2007;"0480";"Totalt";0;654;20001;20655;0,0316630355846042;3,17
2008;"0480";"Totalt";0;647;19905;20552;0,0314811210587777;3,15
2009;"0480";"Totalt";0;666;19368;20034;0,0332434860736747;3,32
2010;"0480";"Totalt";0;684;20039;20723;0,0330068040341649;3,3
2011;"0480";"Totalt";0;671;20534;21205;0,0316434803112473;3,16
2012;"0480";"Totalt";0;759;20762;21521;0,0352678778867153;3,53
2013;"0480";"Totalt";0;761;21096;21857;0,0348172210275884;3,48
2014;"0480";"Totalt";0;773;21066;21839;0,0353953935619763;3,54
2015;"0480";"Totalt";0;634;21250;21884;0,0289709376713581;2,9
2016;"0480";"Totalt";0;569;21437;22006;0,0258565845678451;2,59
2017;"0480";"Totalt";0;595;21703;22298;0,026684007534308;2,67
2018;"0480";"Totalt";0;636;21874;22510;0,0282541092847623;2,83
2019;"0480";"Totalt";0;649;21905;22554;0,0287753835239869;2,88
2020;"0480";"Totalt";0;604;21452;22056;0,0273848385926732;2,74
2021;"0480";"Totalt";0;589;21981;22570;0,0260965883916704;2,61
2022;"0480";"Totalt";0;610;22454;23064;0,0264481442941381;2,64
2007;"0481";"Totalt";0;51;5217;5268;0,00968109339407745;0,97
2008;"0481";"Totalt";0;55;5228;5283;0,0104107514669695;1,04
2009;"0481";"Totalt";0;47;4588;4635;0,0101402373247033;1,01
2010;"0481";"Totalt";0;57;4713;4770;0,0119496855345912;1,19
2011;"0481";"Totalt";0;58;5095;5153;0,0112555792742092;1,13
2012;"0481";"Totalt";0;62;4857;4919;0,0126041878430575;1,26
2013;"0481";"Totalt";0;51;4916;4967;0,010267767263942;1,03
2014;"0481";"Totalt";0;54;4818;4872;0,0110837438423645;1,11
2015;"0481";"Totalt";0;46;5085;5131;0,00896511401286299;0,9
2016;"0481";"Totalt";0;52;5038;5090;0,0102161100196464;1,02
2017;"0481";"Totalt";0;52;4918;4970;0,0104627766599598;1,05
2018;"0481";"Totalt";0;49;4943;4992;0,00981570512820513;0,98
2019;"0481";"Totalt";0;51;4959;5010;0,0101796407185629;1,02
2020;"0481";"Totalt";0;48;4739;4787;0,0100271568832254;1
2021;"0481";"Totalt";0;54;4863;4917;0,0109823062843197;1,1
2022;"0481";"Totalt";0;54;5038;5092;0,0106048703849175;1,06
2007;"0482";"Totalt";0;114;5483;5597;0,0203680543148115;2,04
2008;"0482";"Totalt";0;108;5363;5471;0,0197404496435752;1,97
2009;"0482";"Totalt";0;110;5180;5290;0,0207939508506616;2,08
2010;"0482";"Totalt";0;104;5165;5269;0,0197380907193016;1,97
2011;"0482";"Totalt";0;88;5030;5118;0,0171942164908167;1,72
2012;"0482";"Totalt";0;81;4940;5021;0,0161322445727943;1,61
2013;"0482";"Totalt";0;91;5022;5113;0,017797770389204;1,78
2014;"0482";"Totalt";0;94;4962;5056;0,0185917721518987;1,86
2015;"0482";"Totalt";0;96;4891;4987;0,0192500501303389;1,93
2016;"0482";"Totalt";0;98;5063;5161;0,018988568106956;1,9
2017;"0482";"Totalt";0;85;5091;5176;0,0164219474497682;1,64
2018;"0482";"Totalt";0;101;5199;5300;0,0190566037735849;1,91
2019;"0482";"Totalt";0;79;4973;5052;0,0156373713380839;1,56
2020;"0482";"Totalt";0;67;4906;4973;0,0134727528654736;1,35
2021;"0482";"Totalt";0;78;4927;5005;0,0155844155844156;1,56
2022;"0482";"Totalt";0;85;5114;5199;0,0163492979419119;1,63
2007;"0483";"Totalt";0;731;12003;12734;0,0574053714465211;5,74
2008;"0483";"Totalt";0;717;11928;12645;0,0567022538552788;5,67
2009;"0483";"Totalt";0;697;11448;12145;0,0573898723754632;5,74
2010;"0483";"Totalt";0;715;11715;12430;0,0575221238938053;5,75
2011;"0483";"Totalt";0;694;11959;12653;0,0548486524934798;5,48
2012;"0483";"Totalt";0;649;12044;12693;0,0511305443945482;5,11
2013;"0483";"Totalt";0;577;12163;12740;0,0452904238618524;4,53
2014;"0483";"Totalt";0;544;12409;12953;0,0419979927429939;4,2
2015;"0483";"Totalt";0;312;12277;12589;0,0247835411867503;2,48
2016;"0483";"Totalt";0;368;12586;12954;0,0284082136791725;2,84
2017;"0483";"Totalt";0;337;12869;13206;0,0255187036195669;2,55
2018;"0483";"Totalt";0;332;13236;13568;0,0244693396226415;2,45
2019;"0483";"Totalt";0;345;13359;13704;0,0251751313485114;2,52
2020;"0483";"Totalt";0;289;13384;13673;0,0211365464784612;2,11
2021;"0483";"Totalt";0;295;13553;13848;0,0213027151935298;2,13
2022;"0483";"Totalt";0;338;13749;14087;0,0239937531057003;2,4
2007;"0484";"Totalt";0;1459;38100;39559;0,0368816198589449;3,69
2008;"0484";"Totalt";0;1683;37918;39601;0,0424989267947779;4,25
2009;"0484";"Totalt";0;1442;35567;37009;0,0389634953659921;3,9
2010;"0484";"Totalt";0;1524;36255;37779;0,0403398713571032;4,03
2011;"0484";"Totalt";0;1429;37404;38833;0,0367985991296063;3,68
2012;"0484";"Totalt";0;1404;37592;38996;0,0360036926864294;3,6
2013;"0484";"Totalt";0;1409;37988;39397;0,0357641444780059;3,58
2014;"0484";"Totalt";0;1485;38211;39696;0,0374093107617896;3,74
2015;"0484";"Totalt";0;1437;38731;40168;0,0357747460665206;3,58
2016;"0484";"Totalt";0;1455;39799;41254;0,0352693072186939;3,53
2017;"0484";"Totalt";0;1487;40635;42122;0,035302217368596;3,53
2018;"0484";"Totalt";0;1495;41089;42584;0,0351070824722901;3,51
2019;"0484";"Totalt";0;1633;41419;43052;0,0379308742915544;3,79
2020;"0484";"Totalt";0;1446;41084;42530;0,0339995297437103;3,4
2021;"0484";"Totalt";0;1378;42342;43720;0,0315187557182068;3,15
2022;"0484";"Totalt";0;1505;44110;45615;0,0329935328291132;3,3
2007;"0486";"Totalt";0;308;9425;9733;0,031644919346553;3,16
2008;"0486";"Totalt";0;308;9612;9920;0,0310483870967742;3,1
2009;"0486";"Totalt";0;317;9359;9676;0,0327614716825134;3,28
2010;"0486";"Totalt";0;330;9540;9870;0,033434650455927;3,34
2011;"0486";"Totalt";0;335;9805;10140;0,0330374753451677;3,3
2012;"0486";"Totalt";0;339;9822;10161;0,0333628579864187;3,34
2013;"0486";"Totalt";0;311;9961;10272;0,0302764797507788;3,03
2014;"0486";"Totalt";0;302;9854;10156;0,0297361165813312;2,97
2015;"0486";"Totalt";0;325;9749;10074;0,0322612666269605;3,23
2016;"0486";"Totalt";0;322;9875;10197;0,0315779150730607;3,16
2017;"0486";"Totalt";0;353;10096;10449;0,0337831371423103;3,38
2018;"0486";"Totalt";0;351;10354;10705;0,032788416627744;3,28
2019;"0486";"Totalt";0;384;10639;11023;0,0348362514741903;3,48
2020;"0486";"Totalt";0;328;10344;10672;0,0307346326836582;3,07
2021;"0486";"Totalt";0;340;10741;11081;0,0306831513401318;3,07
2022;"0486";"Totalt";0;351;10920;11271;0,0311418685121107;3,11
2007;"0488";"Totalt";0;200;3196;3396;0,0588928150765607;5,89
2008;"0488";"Totalt";0;224;3138;3362;0,066627007733492;6,66
2009;"0488";"Totalt";0;212;3090;3302;0,0642035130224107;6,42
2010;"0488";"Totalt";0;217;3226;3443;0,063026430438571;6,3
2011;"0488";"Totalt";0;204;3229;3433;0,0594232449752403;5,94
2012;"0488";"Totalt";0;218;3192;3410;0,0639296187683285;6,39
2013;"0488";"Totalt";0;216;3107;3323;0,0650015046644598;6,5
2014;"0488";"Totalt";0;196;3194;3390;0,0578171091445428;5,78
2015;"0488";"Totalt";0;198;3260;3458;0,0572585309427415;5,73
2016;"0488";"Totalt";0;188;3368;3556;0,0528683914510686;5,29
2017;"0488";"Totalt";0;143;3550;3693;0,0387219063092337;3,87
2018;"0488";"Totalt";0;134;3640;3774;0,0355060943296237;3,55
2019;"0488";"Totalt";0;140;3672;3812;0,0367261280167891;3,67
2020;"0488";"Totalt";0;150;3699;3849;0,0389711613406079;3,9
2021;"0488";"Totalt";0;126;4074;4200;0,03;3
2022;"0488";"Totalt";0;137;4186;4323;0,0316909553550775;3,17
2007;"0509";"Totalt";0;116;1580;1696;0,0683962264150943;6,84
2008;"0509";"Totalt";0;86;1565;1651;0,0520896426408237;5,21
2009;"0509";"Totalt";0;67;1566;1633;0,0410287813839559;4,1
2010;"0509";"Totalt";0;62;1553;1615;0,038390092879257;3,84
2011;"0509";"Totalt";0;60;1573;1633;0,0367421922841396;3,67
2012;"0509";"Totalt";0;52;1606;1658;0,0313630880579011;3,14
2013;"0509";"Totalt";0;50;1573;1623;0,0308071472581639;3,08
2014;"0509";"Totalt";0;51;1520;1571;0,0324633991088479;3,25
2015;"0509";"Totalt";0;54;1514;1568;0,0344387755102041;3,44
2016;"0509";"Totalt";0;53;1521;1574;0,0336721728081321;3,37
2017;"0509";"Totalt";0;70;1491;1561;0,0448430493273543;4,48
2018;"0509";"Totalt";0;68;1495;1563;0,0435060780550224;4,35
2019;"0509";"Totalt";0;64;1467;1531;0,0418027433050294;4,18
2020;"0509";"Totalt";0;58;1383;1441;0,0402498265093685;4,02
2021;"0509";"Totalt";0;47;1445;1492;0,0315013404825737;3,15
2022;"0509";"Totalt";0;55;1534;1589;0,0346129641283826;3,46
2007;"0512";"Totalt";0;9;1148;1157;0,00777873811581677;0,78
2008;"0512";"Totalt";0;10;1152;1162;0,00860585197934595;0,86
2009;"0512";"Totalt";0;14;1075;1089;0,0128558310376492;1,29
2010;"0512";"Totalt";0;19;1078;1097;0,0173199635369189;1,73
2011;"0512";"Totalt";0;23;1065;1088;0,0211397058823529;2,11
2012;"0512";"Totalt";0;20;1076;1096;0,0182481751824818;1,82
2013;"0512";"Totalt";0;30;1078;1108;0,0270758122743682;2,71
2014;"0512";"Totalt";0;27;1052;1079;0,0250231696014829;2,5
2015;"0512";"Totalt";0;28;1032;1060;0,0264150943396226;2,64
2016;"0512";"Totalt";0;36;1032;1068;0,0337078651685393;3,37
2017;"0512";"Totalt";0;36;990;1026;0,0350877192982456;3,51
2018;"0512";"Totalt";0;28;961;989;0,0283114256825076;2,83
2019;"0512";"Totalt";0;27;992;1019;0,0264965652600589;2,65
2020;"0512";"Totalt";0;27;924;951;0,028391167192429;2,84
2021;"0512";"Totalt";0;23;1029;1052;0,0218631178707224;2,19
2022;"0512";"Totalt";0;28;1126;1154;0,024263431542461;2,43
2007;"0513";"Totalt";0;81;3194;3275;0,0247328244274809;2,47
2008;"0513";"Totalt";0;62;3172;3234;0,0191713048855906;1,92
2009;"0513";"Totalt";0;62;3026;3088;0,0200777202072539;2,01
2010;"0513";"Totalt";0;67;3091;3158;0,0212159594680177;2,12
2011;"0513";"Totalt";0;66;3120;3186;0,0207156308851224;2,07
2012;"0513";"Totalt";0;57;3135;3192;0,0178571428571429;1,79
2013;"0513";"Totalt";0;62;3034;3096;0,0200258397932817;2
2014;"0513";"Totalt";0;64;3014;3078;0,0207927225471085;2,08
2015;"0513";"Totalt";0;60;2986;3046;0,0196979645436638;1,97
2016;"0513";"Totalt";0;58;3115;3173;0,0182792310116609;1,83
2017;"0513";"Totalt";0;60;3199;3259;0,0184105553850875;1,84
2018;"0513";"Totalt";0;52;3181;3233;0,0160841323847819;1,61
2019;"0513";"Totalt";0;57;3162;3219;0,0177073625349487;1,77
2020;"0513";"Totalt";0;56;3093;3149;0,017783423308987;1,78
2021;"0513";"Totalt";0;50;3186;3236;0,015451174289246;1,55
2022;"0513";"Totalt";0;64;3274;3338;0,0191731575793889;1,92
2007;"0560";"Totalt";0;10;1720;1730;0,00578034682080925;0,58
2008;"0560";"Totalt";0;10;1707;1717;0,005824111822947;0,58
2009;"0560";"Totalt";0;11;1615;1626;0,00676506765067651;0,68
2010;"0560";"Totalt";0;8;1569;1577;0,00507292327203551;0,51
2011;"0560";"Totalt";0;10;1535;1545;0,00647249190938511;0,65
2012;"0560";"Totalt";0;10;1544;1554;0,00643500643500643;0,64
2013;"0560";"Totalt";0;8;1526;1534;0,00521512385919166;0,52
2014;"0560";"Totalt";0;17;1592;1609;0,0105655686761964;1,06
2015;"0560";"Totalt";0;12;1560;1572;0,00763358778625954;0,76
2016;"0560";"Totalt";0;14;1533;1547;0,00904977375565611;0,9
2017;"0560";"Totalt";0;13;1563;1576;0,00824873096446701;0,82
2018;"0560";"Totalt";0;18;1568;1586;0,0113493064312736;1,13
2019;"0560";"Totalt";0;18;1572;1590;0,0113207547169811;1,13
2020;"0560";"Totalt";0;20;1531;1551;0,0128949065119278;1,29
2021;"0560";"Totalt";0;20;1558;1578;0,0126742712294043;1,27
2022;"0560";"Totalt";0;17;1630;1647;0,0103217972070431;1,03
2007;"0561";"Totalt";0;115;3236;3351;0,0343181139958221;3,43
2008;"0561";"Totalt";0;105;3183;3288;0,0319343065693431;3,19
2009;"0561";"Totalt";0;91;2994;3085;0,0294975688816856;2,95
2010;"0561";"Totalt";0;104;3053;3157;0,0329426670890086;3,29
2011;"0561";"Totalt";0;106;3037;3143;0,0337257397391028;3,37
2012;"0561";"Totalt";0;107;2943;3050;0,0350819672131148;3,51
2013;"0561";"Totalt";0;108;2936;3044;0,0354796320630749;3,55
2014;"0561";"Totalt";0;104;2855;2959;0,0351470091247043;3,51
2015;"0561";"Totalt";0;97;2856;2953;0,0328479512360312;3,28
2016;"0561";"Totalt";0;92;2846;2938;0,0313138189244384;3,13
2017;"0561";"Totalt";0;88;2879;2967;0,029659588810246;2,97
2018;"0561";"Totalt";0;78;2810;2888;0,0270083102493075;2,7
2019;"0561";"Totalt";0;80;2915;2995;0,0267111853088481;2,67
2020;"0561";"Totalt";0;76;2837;2913;0,02608994164092;2,61
2021;"0561";"Totalt";0;72;2939;3011;0,0239123214878778;2,39
2022;"0561";"Totalt";0;74;2897;2971;0,0249074385728711;2,49
2007;"0562";"Totalt";0;99;8725;8824;0,011219401631913;1,12
2008;"0562";"Totalt";0;107;8697;8804;0,0121535665606542;1,22
2009;"0562";"Totalt";0;85;8833;8918;0,00953128504148912;0,95
2010;"0562";"Totalt";0;93;8962;9055;0,0102705687465489;1,03
2011;"0562";"Totalt";0;91;9061;9152;0,00994318181818182;0,99
2012;"0562";"Totalt";0;84;9124;9208;0,00912250217202433;0,91
2013;"0562";"Totalt";0;88;8927;9015;0,00976150859678314;0,98
2014;"0562";"Totalt";0;98;8927;9025;0,0108587257617729;1,09
2015;"0562";"Totalt";0;84;8824;8908;0,00942972608890885;0,94
2016;"0562";"Totalt";0;74;8935;9009;0,00821400821400821;0,82
2017;"0562";"Totalt";0;79;9060;9139;0,00864427180216654;0,86
2018;"0562";"Totalt";0;68;9102;9170;0,0074154852780807;0,74
2019;"0562";"Totalt";0;78;8782;8860;0,00880361173814898;0,88
2020;"0562";"Totalt";0;66;8795;8861;0,0074483692585487;0,74
2021;"0562";"Totalt";0;83;8868;8951;0,00927270696011619;0,93
2022;"0562";"Totalt";0;86;9181;9267;0,00928024171792382;0,93
2007;"0563";"Totalt";0;52;2802;2854;0,0182200420462509;1,82
2008;"0563";"Totalt";0;51;2664;2715;0,0187845303867403;1,88
2009;"0563";"Totalt";0;34;2510;2544;0,0133647798742138;1,34
2010;"0563";"Totalt";0;41;2512;2553;0,0160595377986682;1,61
2011;"0563";"Totalt";0;42;2467;2509;0,0167397369469908;1,67
2012;"0563";"Totalt";0;45;2465;2510;0,0179282868525896;1,79
2013;"0563";"Totalt";0;46;2449;2495;0,018436873747495;1,84
2014;"0563";"Totalt";0;45;2467;2512;0,0179140127388535;1,79
2015;"0563";"Totalt";0;55;2367;2422;0,0227085053674649;2,27
2016;"0563";"Totalt";0;49;2445;2494;0,0196471531676022;1,96
2017;"0563";"Totalt";0;45;2421;2466;0,0182481751824818;1,82
2018;"0563";"Totalt";0;36;2395;2431;0,0148087206910736;1,48
2019;"0563";"Totalt";0;65;2319;2384;0,0272651006711409;2,73
2020;"0563";"Totalt";0;30;2214;2244;0,0133689839572193;1,34
2021;"0563";"Totalt";0;32;2242;2274;0,0140721196130167;1,41
2022;"0563";"Totalt";0;35;2341;2376;0,0147306397306397;1,47
2007;"0580";"Totalt";0;2133;66299;68432;0,0311696282440963;3,12
2008;"0580";"Totalt";0;2195;67110;69305;0,0316715965659043;3,17
2009;"0580";"Totalt";0;2092;65983;68075;0,0307308116048476;3,07
2010;"0580";"Totalt";0;2058;67467;69525;0,0296008629989212;2,96
2011;"0580";"Totalt";0;1995;68334;70329;0,0283666766198865;2,84
2012;"0580";"Totalt";0;2156;69841;71997;0,0299456921816187;2,99
2013;"0580";"Totalt";0;2001;71264;73265;0,0273118132805569;2,73
2014;"0580";"Totalt";0;2063;73142;75205;0,0274316867229572;2,74
2015;"0580";"Totalt";0;2050;75027;77077;0,0265967798435331;2,66
2016;"0580";"Totalt";0;1963;77065;79028;0,0248392974641899;2,48
2017;"0580";"Totalt";0;2023;78467;80490;0,025133556963598;2,51
2018;"0580";"Totalt";0;2004;80427;82431;0,0243112421297813;2,43
2019;"0580";"Totalt";0;2250;83230;85480;0,0263219466541881;2,63
2020;"0580";"Totalt";0;2003;83715;85718;0,0233673207494342;2,34
2021;"0580";"Totalt";0;1943;86035;87978;0,0220850667212258;2,21
2022;"0580";"Totalt";0;2054;88329;90383;0,0227255125410752;2,27
2007;"0581";"Totalt";0;2177;53652;55829;0,0389940711816439;3,9
2008;"0581";"Totalt";0;2266;53872;56138;0,0403648152766397;4,04
2009;"0581";"Totalt";0;2146;52710;54856;0,0391206066793058;3,91
2010;"0581";"Totalt";0;2339;54779;57118;0,0409503133863231;4,1
2011;"0581";"Totalt";0;2331;55467;57798;0,0403301152289007;4,03
2012;"0581";"Totalt";0;2322;55989;58311;0,0398209600246952;3,98
2013;"0581";"Totalt";0;2335;56642;58977;0,0395917052410262;3,96
2014;"0581";"Totalt";0;2318;56435;58753;0,03945330451211;3,95
2015;"0581";"Totalt";0;2220;57499;59719;0,0371740986955575;3,72
2016;"0581";"Totalt";0;2207;59415;61622;0,0358151309597222;3,58
2017;"0581";"Totalt";0;2187;60499;62686;0,0348881727977539;3,49
2018;"0581";"Totalt";0;2113;61484;63597;0,0332248376495747;3,32
2019;"0581";"Totalt";0;2078;62840;64918;0,0320096121260667;3,2
2020;"0581";"Totalt";0;1919;61821;63740;0,0301066834013179;3,01
2021;"0581";"Totalt";0;1946;63819;65765;0,0295902075572113;2,96
2022;"0581";"Totalt";0;2141;65260;67401;0,031765107342621;3,18
2007;"0582";"Totalt";0;131;3671;3802;0,0344555497106786;3,45
2008;"0582";"Totalt";0;119;3797;3916;0,030388151174668;3,04
2009;"0582";"Totalt";0;118;3607;3725;0,0316778523489933;3,17
2010;"0582";"Totalt";0;111;3672;3783;0,0293417922283902;2,93
2011;"0582";"Totalt";0;125;3556;3681;0,0339581635425156;3,4
2012;"0582";"Totalt";0;126;3552;3678;0,034257748776509;3,43
2013;"0582";"Totalt";0;122;3542;3664;0,033296943231441;3,33
2014;"0582";"Totalt";0;106;3591;3697;0,0286718961319989;2,87
2015;"0582";"Totalt";0;107;3747;3854;0,0277633627400104;2,78
2016;"0582";"Totalt";0;109;3944;4053;0,0268936590180113;2,69
2017;"0582";"Totalt";0;102;3812;3914;0,026060296371998;2,61
2018;"0582";"Totalt";0;87;3838;3925;0,0221656050955414;2,22
2019;"0582";"Totalt";0;96;3709;3805;0,0252299605781866;2,52
2020;"0582";"Totalt";0;85;3752;3837;0,0221527234818869;2,22
2021;"0582";"Totalt";0;97;3865;3962;0,0244825845532559;2,45
2022;"0582";"Totalt";0;113;3903;4016;0,0281374501992032;2,81
2007;"0583";"Totalt";0;535;15146;15681;0,0341177220840508;3,41
2008;"0583";"Totalt";0;517;14620;15137;0,0341547202219726;3,42
2009;"0583";"Totalt";0;422;13726;14148;0,0298275374611252;2,98
2010;"0583";"Totalt";0;399;13682;14081;0,0283360556778638;2,83
2011;"0583";"Totalt";0;406;13274;13680;0,0296783625730994;2,97
2012;"0583";"Totalt";0;394;13287;13681;0,0287990643958775;2,88
2013;"0583";"Totalt";0;381;13584;13965;0,0272824919441461;2,73
2014;"0583";"Totalt";0;379;13805;14184;0,0267202481669487;2,67
2015;"0583";"Totalt";0;373;13819;14192;0,026282412626832;2,63
2016;"0583";"Totalt";0;344;13843;14187;0,0242475505744696;2,42
2017;"0583";"Totalt";0;344;13965;14309;0,0240408134740373;2,4
2018;"0583";"Totalt";0;313;14010;14323;0,0218529637645745;2,19
2019;"0583";"Totalt";0;301;14033;14334;0,0209990233012418;2,1
2020;"0583";"Totalt";0;279;13648;13927;0,0200330293674158;2
2021;"0583";"Totalt";0;277;13966;14243;0,0194481499684055;1,94
2022;"0583";"Totalt";0;303;14543;14846;0,0204095379226728;2,04
2007;"0584";"Totalt";0;139;2899;3038;0,0457537853851218;4,58
2008;"0584";"Totalt";0;122;2865;2987;0,0408436558419819;4,08
2009;"0584";"Totalt";0;123;2771;2894;0,0425017277125086;4,25
2010;"0584";"Totalt";0;122;2805;2927;0,0416809019473864;4,17
2011;"0584";"Totalt";0;131;2839;2970;0,0441077441077441;4,41
2012;"0584";"Totalt";0;116;2884;3000;0,0386666666666667;3,87
2013;"0584";"Totalt";0;121;2805;2926;0,0413533834586466;4,14
2014;"0584";"Totalt";0;115;2751;2866;0,0401256106071179;4,01
2015;"0584";"Totalt";0;100;2786;2886;0,0346500346500346;3,47
2016;"0584";"Totalt";0;85;2755;2840;0,0299295774647887;2,99
2017;"0584";"Totalt";0;87;2729;2816;0,0308948863636364;3,09
2018;"0584";"Totalt";0;84;2799;2883;0,0291363163371488;2,91
2019;"0584";"Totalt";0;84;2824;2908;0,0288858321870702;2,89
2020;"0584";"Totalt";0;80;2798;2878;0,0277970813064628;2,78
2021;"0584";"Totalt";0;96;2768;2864;0,0335195530726257;3,35
2022;"0584";"Totalt";0;85;2849;2934;0,0289706884798909;2,9
2007;"0586";"Totalt";0;306;9602;9908;0,0308841340331046;3,09
2008;"0586";"Totalt";0;347;9709;10056;0,0345067621320605;3,45
2009;"0586";"Totalt";0;314;9355;9669;0,0324749198469335;3,25
2010;"0586";"Totalt";0;342;9408;9750;0,0350769230769231;3,51
2011;"0586";"Totalt";0;214;9944;10158;0,02106713920063;2,11
2012;"0586";"Totalt";0;208;10328;10536;0,0197418375094913;1,97
2013;"0586";"Totalt";0;194;10660;10854;0,0178735949880228;1,79
2014;"0586";"Totalt";0;166;10629;10795;0,0153774895785086;1,54
2015;"0586";"Totalt";0;173;10736;10909;0,0158584654872124;1,59
2016;"0586";"Totalt";0;145;11230;11375;0,0127472527472527;1,27
2017;"0586";"Totalt";0;159;11580;11739;0,0135445949399438;1,35
2018;"0586";"Totalt";0;159;11685;11844;0,0134245187436677;1,34
2019;"0586";"Totalt";0;163;11759;11922;0,013672202650562;1,37
2020;"0586";"Totalt";0;138;11820;11958;0,0115403913697943;1,15
2021;"0586";"Totalt";0;134;12147;12281;0,0109111635860272;1,09
2022;"0586";"Totalt";0;145;12797;12942;0,0112038324833874;1,12
2007;"0604";"Totalt";0;27;2426;2453;0,0110069302894415;1,1
2008;"0604";"Totalt";0;31;2407;2438;0,0127153404429861;1,27
2009;"0604";"Totalt";0;32;2325;2357;0,013576580398812;1,36
2010;"0604";"Totalt";0;35;2348;2383;0,014687368862778;1,47
2011;"0604";"Totalt";0;27;2332;2359;0,0114455277660025;1,14
2012;"0604";"Totalt";0;28;2313;2341;0,0119607005553182;1,2
2013;"0604";"Totalt";0;33;2347;2380;0,0138655462184874;1,39
2014;"0604";"Totalt";0;32;2287;2319;0,0137990513152221;1,38
2015;"0604";"Totalt";0;29;2348;2377;0,0122002524190156;1,22
2016;"0604";"Totalt";0;30;2373;2403;0,0124843945068664;1,25
2017;"0604";"Totalt";0;27;2362;2389;0,011301799916283;1,13
2018;"0604";"Totalt";0;29;2310;2339;0,0123984608807183;1,24
2019;"0604";"Totalt";0;25;2276;2301;0,0108648413733159;1,09
2020;"0604";"Totalt";0;41;2256;2297;0,0178493687418372;1,78
2021;"0604";"Totalt";0;28;2226;2254;0,0124223602484472;1,24
2022;"0604";"Totalt";0;30;2355;2385;0,0125786163522013;1,26
2007;"0617";"Totalt";0;61;5860;5921;0,0103023137983449;1,03
2008;"0617";"Totalt";0;92;5746;5838;0,0157588215142172;1,58
2009;"0617";"Totalt";0;97;5199;5296;0,0183157099697885;1,83
2010;"0617";"Totalt";0;96;5494;5590;0,0171735241502683;1,72
2011;"0617";"Totalt";0;68;5487;5555;0,0122412241224122;1,22
2012;"0617";"Totalt";0;111;5489;5600;0,0198214285714286;1,98
2013;"0617";"Totalt";0;115;5452;5567;0,0206574456619364;2,07
2014;"0617";"Totalt";0;108;5522;5630;0,0191829484902309;1,92
2015;"0617";"Totalt";0;93;5600;5693;0,0163358510451432;1,63
2016;"0617";"Totalt";0;86;5866;5952;0,0144489247311828;1,44
2017;"0617";"Totalt";0;98;5865;5963;0,0164346805299346;1,64
2018;"0617";"Totalt";0;94;6016;6110;0,0153846153846154;1,54
2019;"0617";"Totalt";0;98;6128;6226;0,0157404433022808;1,57
2020;"0617";"Totalt";0;98;6027;6125;0,016;1,6
2021;"0617";"Totalt";0;173;6223;6396;0,0270481550969356;2,7
2022;"0617";"Totalt";0;180;6364;6544;0,0275061124694377;2,75
2007;"0642";"Totalt";0;59;2410;2469;0,0238963142972864;2,39
2008;"0642";"Totalt";0;56;2353;2409;0,0232461602324616;2,32
2009;"0642";"Totalt";0;45;2198;2243;0,0200624164065983;2,01
2010;"0642";"Totalt";0;43;2316;2359;0,0182280627384485;1,82
2011;"0642";"Totalt";0;55;2339;2394;0,0229741019214703;2,3
2012;"0642";"Totalt";0;70;2360;2430;0,0288065843621399;2,88
2013;"0642";"Totalt";0;65;2425;2490;0,0261044176706827;2,61
2014;"0642";"Totalt";0;70;2472;2542;0,027537372147915;2,75
2015;"0642";"Totalt";0;72;2539;2611;0,0275756415166603;2,76
2016;"0642";"Totalt";0;69;2521;2590;0,0266409266409266;2,66
2017;"0642";"Totalt";0;75;2524;2599;0,0288572527895344;2,89
2018;"0642";"Totalt";0;77;2470;2547;0,0302316450726345;3,02
2019;"0642";"Totalt";0;60;2541;2601;0,0230680507497117;2,31
2020;"0642";"Totalt";0;57;2414;2471;0,0230675839740996;2,31
2021;"0642";"Totalt";0;48;2421;2469;0,0194410692588092;1,94
2022;"0642";"Totalt";0;85;2423;2508;0,0338915470494418;3,39
2007;"0643";"Totalt";0;80;3353;3433;0,0233032333236237;2,33
2008;"0643";"Totalt";0;82;3379;3461;0,0236925744004623;2,37
2009;"0643";"Totalt";0;61;3149;3210;0,0190031152647975;1,9
2010;"0643";"Totalt";0;62;3206;3268;0,0189718482252142;1,9
2011;"0643";"Totalt";0;58;3203;3261;0,0177859552284575;1,78
2012;"0643";"Totalt";0;65;3302;3367;0,0193050193050193;1,93
2013;"0643";"Totalt";0;67;3258;3325;0,0201503759398496;2,02
2014;"0643";"Totalt";0;66;3262;3328;0,0198317307692308;1,98
2015;"0643";"Totalt";0;63;3342;3405;0,0185022026431718;1,85
2016;"0643";"Totalt";0;61;3360;3421;0,0178310435545162;1,78
2017;"0643";"Totalt";0;69;3363;3432;0,0201048951048951;2,01
2018;"0643";"Totalt";0;64;3376;3440;0,0186046511627907;1,86
2019;"0643";"Totalt";0;62;3446;3508;0,0176738882554162;1,77
2020;"0643";"Totalt";0;63;3485;3548;0,0177564825253664;1,78
2021;"0643";"Totalt";0;67;3481;3548;0,0188838782412627;1,89
2022;"0643";"Totalt";0;82;3665;3747;0,0218841740058714;2,19
2007;"0662";"Totalt";0;299;14402;14701;0,0203387524658187;2,03
2008;"0662";"Totalt";0;296;14500;14796;0,0200054068667207;2
2009;"0662";"Totalt";0;271;13299;13570;0,0199705232129698;2
2010;"0662";"Totalt";0;238;13464;13702;0,0173697270471464;1,74
2011;"0662";"Totalt";0;216;13628;13844;0,0156024270442069;1,56
2012;"0662";"Totalt";0;235;13424;13659;0,0172047734094736;1,72
2013;"0662";"Totalt";0;234;13355;13589;0,0172198101405549;1,72
2014;"0662";"Totalt";0;225;13235;13460;0,0167161961367013;1,67
2015;"0662";"Totalt";0;223;13172;13395;0,0166480029861889;1,66
2016;"0662";"Totalt";0;224;13512;13736;0,0163075131042516;1,63
2017;"0662";"Totalt";0;220;13589;13809;0,0159316387862988;1,59
2018;"0662";"Totalt";0;213;13810;14023;0,0151893318120231;1,52
2019;"0662";"Totalt";0;212;13805;14017;0,0151244916886638;1,51
2020;"0662";"Totalt";0;193;13773;13966;0,0138192753830732;1,38
2021;"0662";"Totalt";0;179;14348;14527;0,0123218833895505;1,23
2022;"0662";"Totalt";0;195;14561;14756;0,0132149634047167;1,32
2007;"0665";"Totalt";0;70;5455;5525;0,0126696832579186;1,27
2008;"0665";"Totalt";0;58;5327;5385;0,0107706592386258;1,08
2009;"0665";"Totalt";0;61;4857;4918;0,0124034160227735;1,24
2010;"0665";"Totalt";0;62;5055;5117;0,0121164744967755;1,21
2011;"0665";"Totalt";0;65;5214;5279;0,0123129380564501;1,23
2012;"0665";"Totalt";0;69;5167;5236;0,0131779984721161;1,32
2013;"0665";"Totalt";0;60;5125;5185;0,0115718418514947;1,16
2014;"0665";"Totalt";0;74;4997;5071;0,014592782488661;1,46
2015;"0665";"Totalt";0;81;5041;5122;0,0158141351034752;1,58
2016;"0665";"Totalt";0;85;4985;5070;0,0167652859960552;1,68
2017;"0665";"Totalt";0;75;5160;5235;0,0143266475644699;1,43
2018;"0665";"Totalt";0;96;5268;5364;0,0178970917225951;1,79
2019;"0665";"Totalt";0;94;5300;5394;0,0174267704857249;1,74
2020;"0665";"Totalt";0;64;5169;5233;0,0122300783489394;1,22
2021;"0665";"Totalt";0;58;5108;5166;0,0112272551296942;1,12
2022;"0665";"Totalt";0;63;5411;5474;0,0115089514066496;1,15
2007;"0680";"Totalt";0;2518;58164;60682;0,0414950067565341;4,15
2008;"0680";"Totalt";0;2496;58745;61241;0,0407570091931876;4,08
2009;"0680";"Totalt";0;2366;57277;59643;0,0396693660613987;3,97
2010;"0680";"Totalt";0;2487;59131;61618;0,0403615826544192;4,04
2011;"0680";"Totalt";0;2375;60359;62734;0,0378582586795039;3,79
2012;"0680";"Totalt";0;2332;61388;63720;0,0365976145637163;3,66
2013;"0680";"Totalt";0;2276;61489;63765;0,0356935622990669;3,57
2014;"0680";"Totalt";0;2307;62287;64594;0,0357153915224324;3,57
2015;"0680";"Totalt";0;2201;63653;65854;0,0334224192911592;3,34
2016;"0680";"Totalt";0;2337;66331;68668;0,0340333197413642;3,4
2017;"0680";"Totalt";0;2338;68490;70828;0,0330095442480375;3,3
2018;"0680";"Totalt";0;2289;70303;72592;0,031532400264492;3,15
2019;"0680";"Totalt";0;2519;69879;72398;0,0347937788336694;3,48
2020;"0680";"Totalt";0;2267;70447;72714;0,031176939791512;3,12
2021;"0680";"Totalt";0;2123;72577;74700;0,0284203480589023;2,84
2022;"0680";"Totalt";0;2256;75290;77546;0,0290924096665205;2,91
2007;"0682";"Totalt";0;517;12087;12604;0,0410187242145351;4,1
2008;"0682";"Totalt";0;510;11965;12475;0,0408817635270541;4,09
2009;"0682";"Totalt";0;468;11271;11739;0,0398671096345515;3,99
2010;"0682";"Totalt";0;432;11415;11847;0,0364649278298303;3,65
2011;"0682";"Totalt";0;409;11381;11790;0,0346904156064461;3,47
2012;"0682";"Totalt";0;329;11300;11629;0,0282913406139823;2,83
2013;"0682";"Totalt";0;266;11299;11565;0,0230004323389537;2,3
2014;"0682";"Totalt";0;251;11642;11893;0,0211048515933743;2,11
2015;"0682";"Totalt";0;242;11742;11984;0,0201935914552737;2,02
2016;"0682";"Totalt";0;229;12120;12349;0,0185440116608632;1,85
2017;"0682";"Totalt";0;233;12221;12454;0,0187088485627108;1,87
2018;"0682";"Totalt";0;228;12243;12471;0,0182824152032716;1,83
2019;"0682";"Totalt";0;202;12057;12259;0,0164776898605106;1,65
2020;"0682";"Totalt";0;191;11887;12078;0,0158138764696142;1,58
2021;"0682";"Totalt";0;199;12249;12448;0,0159865038560411;1,6
2022;"0682";"Totalt";0;203;12436;12639;0,0160613972624416;1,61
2007;"0683";"Totalt";0;672;16306;16978;0,0395806337613382;3,96
2008;"0683";"Totalt";0;653;16456;17109;0,0381670465836694;3,82
2009;"0683";"Totalt";0;523;15014;15537;0,0336615820299929;3,37
2010;"0683";"Totalt";0;524;15497;16021;0,0327070719680419;3,27
2011;"0683";"Totalt";0;505;15648;16153;0,0312635423760292;3,13
2012;"0683";"Totalt";0;452;15632;16084;0,0281024620741109;2,81
2013;"0683";"Totalt";0;598;15636;16234;0,0368362695577184;3,68
2014;"0683";"Totalt";0;388;15943;16331;0,0237584961116894;2,38
2015;"0683";"Totalt";0;390;15916;16306;0,023917576352263;2,39
2016;"0683";"Totalt";0;361;16116;16477;0,021909328154397;2,19
2017;"0683";"Totalt";0;352;16219;16571;0,0212419286705691;2,12
2018;"0683";"Totalt";0;339;16506;16845;0,0201246660730187;2,01
2019;"0683";"Totalt";0;360;16665;17025;0,0211453744493392;2,11
2020;"0683";"Totalt";0;332;16231;16563;0,0200446778965163;2
2021;"0683";"Totalt";0;348;16567;16915;0,0205734555128584;2,06
2022;"0683";"Totalt";0;374;17000;17374;0,0215264187866928;2,15
2007;"0684";"Totalt";0;56;4167;4223;0,0132607151314232;1,33
2008;"0684";"Totalt";0;60;4123;4183;0,0143437724121444;1,43
2009;"0684";"Totalt";0;56;3815;3871;0,0144665461121157;1,45
2010;"0684";"Totalt";0;55;3925;3980;0,0138190954773869;1,38
2011;"0684";"Totalt";0;52;3965;4017;0,0129449838187702;1,29
2012;"0684";"Totalt";0;53;4011;4064;0,0130413385826772;1,3
2013;"0684";"Totalt";0;55;3969;4024;0,0136679920477137;1,37
2014;"0684";"Totalt";0;48;3966;4014;0,0119581464872945;1,2
2015;"0684";"Totalt";0;52;4074;4126;0,0126030053320407;1,26
2016;"0684";"Totalt";0;62;4278;4340;0,0142857142857143;1,43
2017;"0684";"Totalt";0;61;4355;4416;0,0138134057971014;1,38
2018;"0684";"Totalt";0;86;4382;4468;0,0192479856759176;1,92
2019;"0684";"Totalt";0;78;4290;4368;0,0178571428571429;1,79
2020;"0684";"Totalt";0;86;4223;4309;0,0199582269668136;2
2021;"0684";"Totalt";0;90;4313;4403;0,0204406086759028;2,04
2022;"0684";"Totalt";0;90;4421;4511;0,0199512303258701;2
2007;"0685";"Totalt";0;213;12068;12281;0,0173438645061477;1,73
2008;"0685";"Totalt";0;233;11792;12025;0,0193762993762994;1,94
2009;"0685";"Totalt";0;214;11033;11247;0,019027296167867;1,9
2010;"0685";"Totalt";0;201;11424;11625;0,0172903225806452;1,73
2011;"0685";"Totalt";0;208;11387;11595;0,0179387667097887;1,79
2012;"0685";"Totalt";0;213;11174;11387;0,0187055414068675;1,87
2013;"0685";"Totalt";0;209;11059;11268;0,0185481008164714;1,85
2014;"0685";"Totalt";0;193;11244;11437;0,0168750546471977;1,69
2015;"0685";"Totalt";0;174;11374;11548;0,0150675441634915;1,51
2016;"0685";"Totalt";0;186;11887;12073;0,0154062784726249;1,54
2017;"0685";"Totalt";0;184;11997;12181;0,0151054921599212;1,51
2018;"0685";"Totalt";0;179;12035;12214;0,0146553135745865;1,47
2019;"0685";"Totalt";0;202;11498;11700;0,0172649572649573;1,73
2020;"0685";"Totalt";0;188;11163;11351;0,0165624174081579;1,66
2021;"0685";"Totalt";0;178;11360;11538;0,015427283758017;1,54
2022;"0685";"Totalt";0;191;11815;12006;0,0159087123105114;1,59
2007;"0686";"Totalt";0;207;8473;8680;0,0238479262672811;2,38
2008;"0686";"Totalt";0;200;8450;8650;0,023121387283237;2,31
2009;"0686";"Totalt";0;207;8138;8345;0,0248052726183343;2,48
2010;"0686";"Totalt";0;211;8169;8380;0,0251789976133652;2,52
2011;"0686";"Totalt";0;195;8308;8503;0,0229330824414912;2,29
2012;"0686";"Totalt";0;198;8190;8388;0,0236051502145923;2,36
2013;"0686";"Totalt";0;193;8444;8637;0,0223457218941762;2,23
2014;"0686";"Totalt";0;165;8467;8632;0,019114921223355;1,91
2015;"0686";"Totalt";0;156;8793;8949;0,0174321153201475;1,74
2016;"0686";"Totalt";0;153;8958;9111;0,0167928877181429;1,68
2017;"0686";"Totalt";0;140;8977;9117;0,0153559284852473;1,54
2018;"0686";"Totalt";0;132;9149;9281;0,0142226053227023;1,42
2019;"0686";"Totalt";0;144;9090;9234;0,0155945419103314;1,56
2020;"0686";"Totalt";0;128;8948;9076;0,0141031291317761;1,41
2021;"0686";"Totalt";0;139;9143;9282;0,0149752208575738;1,5
2022;"0686";"Totalt";0;131;9360;9491;0,0138025497840059;1,38
2007;"0687";"Totalt";0;252;7705;7957;0,0316702274726656;3,17
2008;"0687";"Totalt";0;254;7795;8049;0,0315567151198907;3,16
2009;"0687";"Totalt";0;255;7255;7510;0,0339547270306258;3,4
2010;"0687";"Totalt";0;255;7374;7629;0,0334250884781754;3,34
2011;"0687";"Totalt";0;224;7474;7698;0,0290984671343206;2,91
2012;"0687";"Totalt";0;225;7500;7725;0,029126213592233;2,91
2013;"0687";"Totalt";0;222;7379;7601;0,0292066833311406;2,92
2014;"0687";"Totalt";0;225;7349;7574;0,0297068919989438;2,97
2015;"0687";"Totalt";0;218;7596;7814;0,0278986434604556;2,79
2016;"0687";"Totalt";0;234;7653;7887;0,0296690756941803;2,97
2017;"0687";"Totalt";0;236;7725;7961;0,0296445170204748;2,96
2018;"0687";"Totalt";0;233;7910;8143;0,0286135330959106;2,86
2019;"0687";"Totalt";0;216;7967;8183;0,0263961872174019;2,64
2020;"0687";"Totalt";0;174;7914;8088;0,021513353115727;2,15
2021;"0687";"Totalt";0;171;8080;8251;0,0207247606350745;2,07
2022;"0687";"Totalt";0;160;8460;8620;0,0185614849187935;1,86
2007;"0760";"Totalt";0;38;4849;4887;0,00777573153263761;0,78
2008;"0760";"Totalt";0;41;4814;4855;0,00844490216271885;0,84
2009;"0760";"Totalt";0;39;4403;4442;0,00877982890589824;0,88
2010;"0760";"Totalt";0;39;4459;4498;0,00867052023121387;0,87
2011;"0760";"Totalt";0;38;4397;4435;0,00856820744081173;0,86
2012;"0760";"Totalt";0;33;4236;4269;0,00773014757554462;0,77
2013;"0760";"Totalt";0;31;4195;4226;0,00733554188357785;0,73
2014;"0760";"Totalt";0;33;4285;4318;0,00764242704955998;0,76
2015;"0760";"Totalt";0;30;4307;4337;0,00691722388747982;0,69
2016;"0760";"Totalt";0;29;4381;4410;0,00657596371882086;0,66
2017;"0760";"Totalt";0;24;4560;4584;0,00523560209424084;0,52
2018;"0760";"Totalt";0;24;4730;4754;0,00504838031131679;0,5
2019;"0760";"Totalt";0;25;4579;4604;0,00543006081668115;0,54
2020;"0760";"Totalt";0;25;4627;4652;0,00537403267411866;0,54
2021;"0760";"Totalt";0;26;4754;4780;0,00543933054393305;0,54
2022;"0760";"Totalt";0;37;5060;5097;0,00725917206199725;0,73
2007;"0761";"Totalt";0;129;2725;2854;0,0451997196916608;4,52
2008;"0761";"Totalt";0;116;2730;2846;0,0407589599437807;4,08
2009;"0761";"Totalt";0;135;2563;2698;0,0500370644922165;5
2010;"0761";"Totalt";0;135;2507;2642;0,0510976532929599;5,11
2011;"0761";"Totalt";0;125;2534;2659;0,0470101541933058;4,7
2012;"0761";"Totalt";0;95;2535;2630;0,0361216730038023;3,61
2013;"0761";"Totalt";0;75;2362;2437;0,0307755437012721;3,08
2014;"0761";"Totalt";0;42;2293;2335;0,0179871520342612;1,8
2015;"0761";"Totalt";0;41;2327;2368;0,0173141891891892;1,73
2016;"0761";"Totalt";0;49;2364;2413;0,0203066721922918;2,03
2017;"0761";"Totalt";0;52;2383;2435;0,0213552361396304;2,14
2018;"0761";"Totalt";0;50;2333;2383;0,0209819555182543;2,1
2019;"0761";"Totalt";0;73;2239;2312;0,0315743944636678;3,16
2020;"0761";"Totalt";0;61;2161;2222;0,0274527452745275;2,75
2021;"0761";"Totalt";0;59;2244;2303;0,0256187581415545;2,56
2022;"0761";"Totalt";0;79;2386;2465;0,0320486815415821;3,2
2007;"0763";"Totalt";0;92;5280;5372;0,0171258376768429;1,71
2008;"0763";"Totalt";0;94;5420;5514;0,0170475154153065;1,7
2009;"0763";"Totalt";0;91;5080;5171;0,0175981434925546;1,76
2010;"0763";"Totalt";0;85;5168;5253;0,0161812297734628;1,62
2011;"0763";"Totalt";0;88;5196;5284;0,0166540499621499;1,67
2012;"0763";"Totalt";0;81;5150;5231;0,0154846109730453;1,55
2013;"0763";"Totalt";0;85;4844;4929;0,0172448772570501;1,72
2014;"0763";"Totalt";0;85;4886;4971;0,0170991752162543;1,71
2015;"0763";"Totalt";0;81;4887;4968;0,016304347826087;1,63
2016;"0763";"Totalt";0;75;5100;5175;0,0144927536231884;1,45
2017;"0763";"Totalt";0;67;5177;5244;0,0127765064836003;1,28
2018;"0763";"Totalt";0;71;5236;5307;0,0133785566233277;1,34
2019;"0763";"Totalt";0;73;5325;5398;0,0135235272323083;1,35
2020;"0763";"Totalt";0;64;5333;5397;0,0118584398740041;1,19
2021;"0763";"Totalt";0;63;5419;5482;0,0114921561473915;1,15
2022;"0763";"Totalt";0;71;5554;5625;0,0126222222222222;1,26
2007;"0764";"Totalt";0;110;7235;7345;0,0149761742682097;1,5
2008;"0764";"Totalt";0;102;7389;7491;0,013616339607529;1,36
2009;"0764";"Totalt";0;97;6947;7044;0,0137705848949461;1,38
2010;"0764";"Totalt";0;117;6996;7113;0,0164487557992408;1,64
2011;"0764";"Totalt";0;121;6860;6981;0,0173327603495201;1,73
2012;"0764";"Totalt";0;103;6931;7034;0,0146431617856127;1,46
2013;"0764";"Totalt";0;101;6848;6949;0,0145344653907037;1,45
2014;"0764";"Totalt";0;104;6841;6945;0,0149748020158387;1,5
2015;"0764";"Totalt";0;110;6916;7026;0,0156561343580985;1,57
2016;"0764";"Totalt";0;118;7042;7160;0,0164804469273743;1,65
2017;"0764";"Totalt";0;107;6951;7058;0,0151601020119014;1,52
2018;"0764";"Totalt";0;104;6976;7080;0,0146892655367232;1,47
2019;"0764";"Totalt";0;98;7258;7356;0,0133224578575313;1,33
2020;"0764";"Totalt";0;88;7102;7190;0,0122392211404729;1,22
2021;"0764";"Totalt";0;89;7093;7182;0,0123920913394598;1,24
2022;"0764";"Totalt";0;90;7235;7325;0,0122866894197952;1,23
2007;"0765";"Totalt";0;1428;7980;9408;0,151785714285714;15,18
2008;"0765";"Totalt";0;1389;8183;9572;0,145110739657334;14,51
2009;"0765";"Totalt";0;1464;7721;9185;0,159390310288514;15,94
2010;"0765";"Totalt";0;1545;7761;9306;0,16602192134107;16,6
2011;"0765";"Totalt";0;1603;7775;9378;0,170931968436767;17,09
2012;"0765";"Totalt";0;1300;7625;8925;0,145658263305322;14,57
2013;"0765";"Totalt";0;1199;7726;8925;0,134341736694678;13,43
2014;"0765";"Totalt";0;1691;7887;9578;0,176550428064314;17,66
2015;"0765";"Totalt";0;1874;8182;10056;0,186356404136834;18,64
2016;"0765";"Totalt";0;2175;8255;10430;0,208533077660594;20,85
2017;"0765";"Totalt";0;2570;8266;10836;0,237172388335179;23,72
2018;"0765";"Totalt";0;2785;8246;11031;0,252470310941891;25,25
2019;"0765";"Totalt";0;2746;8149;10895;0,252042221202386;25,2
2020;"0765";"Totalt";0;2949;7900;10849;0,271822287768458;27,18
2021;"0765";"Totalt";0;3206;7846;11052;0,290083242851973;29,01
2022;"0765";"Totalt";0;2550;7936;10486;0,243181384703414;24,32
2007;"0767";"Totalt";0;90;4929;5019;0,017931858936043;1,79
2008;"0767";"Totalt";0;90;4814;4904;0,0183523654159869;1,84
2009;"0767";"Totalt";0;97;4553;4650;0,0208602150537634;2,09
2010;"0767";"Totalt";0;102;4635;4737;0,0215326155794807;2,15
2011;"0767";"Totalt";0;85;4703;4788;0,0177527151211362;1,78
2012;"0767";"Totalt";0;88;4665;4753;0,0185146223437829;1,85
2013;"0767";"Totalt";0;98;4484;4582;0,0213880401571366;2,14
2014;"0767";"Totalt";0;88;4564;4652;0,0189165950128977;1,89
2015;"0767";"Totalt";0;79;4660;4739;0,0166701835830344;1,67
2016;"0767";"Totalt";0;84;4888;4972;0,0168946098149638;1,69
2017;"0767";"Totalt";0;90;5010;5100;0,0176470588235294;1,76
2018;"0767";"Totalt";0;105;5159;5264;0,0199468085106383;1,99
2019;"0767";"Totalt";0;93;5212;5305;0,0175306314797361;1,75
2020;"0767";"Totalt";0;105;5221;5326;0,01971460758543;1,97
2021;"0767";"Totalt";0;109;5571;5680;0,0191901408450704;1,92
2022;"0767";"Totalt";0;50;5691;5741;0,00870928409684724;0,87
2007;"0780";"Totalt";0;1688;38583;40271;0,0419160189714683;4,19
2008;"0780";"Totalt";0;1730;38752;40482;0,0427350427350427;4,27
2009;"0780";"Totalt";0;1693;37087;38780;0,0436565239814337;4,37
2010;"0780";"Totalt";0;1615;38115;39730;0,0406493833375283;4,06
2011;"0780";"Totalt";0;1723;38773;40496;0,042547412090083;4,25
2012;"0780";"Totalt";0;1768;40031;41799;0,0422976626235077;4,23
2013;"0780";"Totalt";0;1801;40338;42139;0,0427395049716415;4,27
2014;"0780";"Totalt";0;1742;40861;42603;0,0408891392624933;4,09
2015;"0780";"Totalt";0;1765;41505;43270;0,0407903859486942;4,08
2016;"0780";"Totalt";0;1692;42537;44229;0,0382554432612087;3,83
2017;"0780";"Totalt";0;1678;43596;45274;0,0370632150903388;3,71
2018;"0780";"Totalt";0;1717;44369;46086;0,0372564336240941;3,73
2019;"0780";"Totalt";0;1755;45083;46838;0,0374695759853111;3,75
2020;"0780";"Totalt";0;1647;44062;45709;0,0360322912336739;3,6
2021;"0780";"Totalt";0;1611;45896;47507;0,0339107920937967;3,39
2022;"0780";"Totalt";0;1619;47408;49027;0,0330226201888755;3,3
2007;"0781";"Totalt";0;913;12508;13421;0,0680277177557559;6,8
2008;"0781";"Totalt";0;936;12575;13511;0,0692768855007031;6,93
2009;"0781";"Totalt";0;921;11750;12671;0,0726856601688896;7,27
2010;"0781";"Totalt";0;910;11652;12562;0,0724406941569814;7,24
2011;"0781";"Totalt";0;884;11879;12763;0,0692627125284024;6,93
2012;"0781";"Totalt";0;904;11819;12723;0,0710524247425922;7,11
2013;"0781";"Totalt";0;860;11654;12514;0,0687230302061691;6,87
2014;"0781";"Totalt";0;864;11614;12478;0,0692418656836031;6,92
2015;"0781";"Totalt";0;529;12066;12595;0,0420007939658595;4,2
2016;"0781";"Totalt";0;522;12179;12701;0,0410991260530667;4,11
2017;"0781";"Totalt";0;500;12109;12609;0,0396542152430803;3,97
2018;"0781";"Totalt";0;493;12267;12760;0,0386363636363636;3,86
2019;"0781";"Totalt";0;484;12142;12626;0,0383335973388246;3,83
2020;"0781";"Totalt";0;461;11724;12185;0,0378334017234305;3,78
2021;"0781";"Totalt";0;481;12053;12534;0,0383756183181746;3,84
2022;"0781";"Totalt";0;498;12522;13020;0,0382488479262673;3,82
2007;"0821";"Totalt";0;22;1791;1813;0,012134583563155;1,21
2008;"0821";"Totalt";0;25;1785;1810;0,0138121546961326;1,38
2009;"0821";"Totalt";0;22;1707;1729;0,0127241179872759;1,27
2010;"0821";"Totalt";0;24;1700;1724;0,0139211136890951;1,39
2011;"0821";"Totalt";0;23;1675;1698;0,013545347467609;1,35
2012;"0821";"Totalt";0;17;1615;1632;0,0104166666666667;1,04
2013;"0821";"Totalt";0;16;1523;1539;0,0103963612735543;1,04
2014;"0821";"Totalt";0;15;1527;1542;0,00972762645914397;0,97
2015;"0821";"Totalt";0;14;1582;1596;0,0087719298245614;0,88
2016;"0821";"Totalt";0;15;1582;1597;0,00939261114589856;0,94
2017;"0821";"Totalt";0;15;1621;1636;0,00916870415647922;0,92
2018;"0821";"Totalt";0;15;1637;1652;0,00907990314769976;0,91
2019;"0821";"Totalt";0;14;1553;1567;0,00893426930440332;0,89
2020;"0821";"Totalt";0;13;1527;1540;0,00844155844155844;0,84
2021;"0821";"Totalt";0;14;1463;1477;0,00947867298578199;0,95
2022;"0821";"Totalt";0;13;1492;1505;0,00863787375415282;0,86
2007;"0834";"Totalt";0;25;2631;2656;0,00941265060240964;0,94
2008;"0834";"Totalt";0;28;2585;2613;0,0107156525066973;1,07
2009;"0834";"Totalt";0;25;2452;2477;0,0100928542591845;1,01
2010;"0834";"Totalt";0;27;2391;2418;0,011166253101737;1,12
2011;"0834";"Totalt";0;27;2305;2332;0,0115780445969125;1,16
2012;"0834";"Totalt";0;27;2175;2202;0,0122615803814714;1,23
2013;"0834";"Totalt";0;26;2130;2156;0,0120593692022263;1,21
2014;"0834";"Totalt";0;24;2208;2232;0,010752688172043;1,08
2015;"0834";"Totalt";0;24;2189;2213;0,0108450067781292;1,08
2016;"0834";"Totalt";0;26;2060;2086;0,012464046021093;1,25
2017;"0834";"Totalt";0;22;2016;2038;0,0107948969578018;1,08
2018;"0834";"Totalt";0;27;2038;2065;0,0130750605326877;1,31
2019;"0834";"Totalt";0;24;2106;2130;0,0112676056338028;1,13
2020;"0834";"Totalt";0;23;2096;2119;0,0108541764983483;1,09
2021;"0834";"Totalt";0;23;2154;2177;0,0105649977032614;1,06
2022;"0834";"Totalt";0;22;2236;2258;0,00974313551815766;0,97
2007;"0840";"Totalt";0;147;3856;4003;0,0367224581563827;3,67
2008;"0840";"Totalt";0;153;3827;3980;0,0384422110552764;3,84
2009;"0840";"Totalt";0;143;3889;4032;0,0354662698412698;3,55
2010;"0840";"Totalt";0;152;4118;4270;0,0355971896955504;3,56
2011;"0840";"Totalt";0;151;4094;4245;0,0355712603062426;3,56
2012;"0840";"Totalt";0;130;4248;4378;0,029693924166286;2,97
2013;"0840";"Totalt";0;127;4260;4387;0,0289491679963529;2,89
2014;"0840";"Totalt";0;123;4392;4515;0,0272425249169435;2,72
2015;"0840";"Totalt";0;125;4535;4660;0,0268240343347639;2,68
2016;"0840";"Totalt";0;124;4659;4783;0,0259251515785072;2,59
2017;"0840";"Totalt";0;126;4655;4781;0,0263543191800878;2,64
2018;"0840";"Totalt";0;126;4607;4733;0,0266215930699345;2,66
2019;"0840";"Totalt";0;121;4430;4551;0,026587563172929;2,66
2020;"0840";"Totalt";0;126;4514;4640;0,0271551724137931;2,72
2021;"0840";"Totalt";0;127;4698;4825;0,0263212435233161;2,63
2022;"0840";"Totalt";0;145;4945;5090;0,0284872298624754;2,85
2007;"0860";"Totalt";0;117;5162;5279;0,0221632885016102;2,22
2008;"0860";"Totalt";0;101;5017;5118;0,0197342711996874;1,97
2009;"0860";"Totalt";0;101;4792;4893;0,020641733088085;2,06
2010;"0860";"Totalt";0;94;4990;5084;0,0184893784421715;1,85
2011;"0860";"Totalt";0;78;5029;5107;0,015273154493832;1,53
2012;"0860";"Totalt";0;54;4921;4975;0,0108542713567839;1,09
2013;"0860";"Totalt";0;55;4838;4893;0,0112405477212344;1,12
2014;"0860";"Totalt";0;49;4717;4766;0,0102811582039446;1,03
2015;"0860";"Totalt";0;50;4686;4736;0,0105574324324324;1,06
2016;"0860";"Totalt";0;48;4773;4821;0,00995644057249533;1
2017;"0860";"Totalt";0;48;4871;4919;0,00975808091075422;0,98
2018;"0860";"Totalt";0;46;4945;4991;0,00921658986175115;0,92
2019;"0860";"Totalt";0;43;4969;5012;0,00857940941739824;0,86
2020;"0860";"Totalt";0;39;4817;4856;0,00803130148270181;0,8
2021;"0860";"Totalt";0;40;4847;4887;0,00818498056067117;0,82
2022;"0860";"Totalt";0;40;4969;5009;0,00798562587342783;0,8
2007;"0861";"Totalt";0;61;4522;4583;0,0133100589133755;1,33
2008;"0861";"Totalt";0;59;4373;4432;0,013312274368231;1,33
2009;"0861";"Totalt";0;59;4109;4168;0,0141554702495202;1,42
2010;"0861";"Totalt";0;58;4185;4243;0,0136695734150365;1,37
2011;"0861";"Totalt";0;56;4177;4233;0,0132293881407985;1,32
2012;"0861";"Totalt";0;52;4157;4209;0,0123544784984557;1,24
2013;"0861";"Totalt";0;49;4209;4258;0,011507750117426;1,15
2014;"0861";"Totalt";0;44;4214;4258;0,0103334899013621;1,03
2015;"0861";"Totalt";0;45;4171;4216;0,010673624288425;1,07
2016;"0861";"Totalt";0;52;4207;4259;0,0122094388354074;1,22
2017;"0861";"Totalt";0;54;4153;4207;0,0128357499405752;1,28
2018;"0861";"Totalt";0;64;4181;4245;0,0150765606595995;1,51
2019;"0861";"Totalt";0;71;4307;4378;0,0162174508908177;1,62
2020;"0861";"Totalt";0;72;4330;4402;0,016356201726488;1,64
2021;"0861";"Totalt";0;66;4225;4291;0,0153810300629224;1,54
2022;"0861";"Totalt";0;62;4314;4376;0,0141681901279707;1,42
2007;"0862";"Totalt";0;69;4442;4511;0,0152959432498337;1,53
2008;"0862";"Totalt";0;67;4492;4559;0,0146962053081816;1,47
2009;"0862";"Totalt";0;73;4249;4322;0,0168903285515965;1,69
2010;"0862";"Totalt";0;68;4241;4309;0,0157809236481782;1,58
2011;"0862";"Totalt";0;59;4217;4276;0,0137979420018709;1,38
2012;"0862";"Totalt";0;77;4075;4152;0,0185452793834297;1,85
2013;"0862";"Totalt";0;83;4011;4094;0,0202735710796287;2,03
2014;"0862";"Totalt";0;80;4104;4184;0,0191204588910134;1,91
2015;"0862";"Totalt";0;73;4137;4210;0,0173396674584323;1,73
2016;"0862";"Totalt";0;72;4154;4226;0,0170373876005679;1,7
2017;"0862";"Totalt";0;73;4113;4186;0,017439082656474;1,74
2018;"0862";"Totalt";0;67;4213;4280;0,0156542056074766;1,57
2019;"0862";"Totalt";0;66;4093;4159;0,0158691993267612;1,59
2020;"0862";"Totalt";0;61;4020;4081;0,0149473168341093;1,49
2021;"0862";"Totalt";0;69;4120;4189;0,0164717116256863;1,65
2022;"0862";"Totalt";0;68;4316;4384;0,0155109489051095;1,55
2007;"0880";"Totalt";0;1389;28094;29483;0,0471118949903334;4,71
2008;"0880";"Totalt";0;1470;27965;29435;0,0499405469678954;4,99
2009;"0880";"Totalt";0;1478;27594;29072;0,0508392955421024;5,08
2010;"0880";"Totalt";0;1546;28286;29832;0,051823545186377;5,18
2011;"0880";"Totalt";0;1505;28428;29933;0,0502789563358167;5,03
2012;"0880";"Totalt";0;1488;28895;30383;0,048974755619919;4,9
2013;"0880";"Totalt";0;1524;29351;30875;0,0493603238866397;4,94
2014;"0880";"Totalt";0;1466;29457;30923;0,0474080781295476;4,74
2015;"0880";"Totalt";0;1433;30093;31526;0,0454545454545455;4,55
2016;"0880";"Totalt";0;1419;31282;32701;0,0433931684046359;4,34
2017;"0880";"Totalt";0;1395;31513;32908;0,0423909079859001;4,24
2018;"0880";"Totalt";0;1323;32335;33658;0,0393071483748292;3,93
2019;"0880";"Totalt";0;1474;32671;34145;0,043168838775809;4,32
2020;"0880";"Totalt";0;1404;33047;34451;0,0407535340048184;4,08
2021;"0880";"Totalt";0;1429;34187;35616;0,0401224168912848;4,01
2022;"0880";"Totalt";0;1426;35245;36671;0,0388863134356849;3,89
2007;"0881";"Totalt";0;136;8163;8299;0,0163875165682612;1,64
2008;"0881";"Totalt";0;135;7925;8060;0,0167493796526055;1,67
2009;"0881";"Totalt";0;116;7214;7330;0,0158253751705321;1,58
2010;"0881";"Totalt";0;124;7270;7394;0,0167703543413579;1,68
2011;"0881";"Totalt";0;130;7380;7510;0,0173102529960053;1,73
2012;"0881";"Totalt";0;135;7238;7373;0,0183100501831005;1,83
2013;"0881";"Totalt";0;125;7121;7246;0,0172508970466464;1,73
2014;"0881";"Totalt";0;120;6962;7082;0,0169443659983056;1,69
2015;"0881";"Totalt";0;117;6841;6958;0,0168151767749353;1,68
2016;"0881";"Totalt";0;107;6835;6942;0,0154134255257851;1,54
2017;"0881";"Totalt";0;100;7149;7249;0,0137950062077528;1,38
2018;"0881";"Totalt";0;97;7279;7376;0,0131507592190889;1,32
2019;"0881";"Totalt";0;100;7497;7597;0,0131630906936949;1,32
2020;"0881";"Totalt";0;98;7192;7290;0,013443072702332;1,34
2021;"0881";"Totalt";0;99;7388;7487;0,0132229197275277;1,32
2022;"0881";"Totalt";0;94;7581;7675;0,0122475570032573;1,22
2007;"0882";"Totalt";0;246;13702;13948;0,0176369371952968;1,76
2008;"0882";"Totalt";0;235;13562;13797;0,017032688265565;1,7
2009;"0882";"Totalt";0;238;13099;13337;0,0178450925995351;1,78
2010;"0882";"Totalt";0;255;12963;13218;0,019291874716296;1,93
2011;"0882";"Totalt";0;229;13083;13312;0,0172025240384615;1,72
2012;"0882";"Totalt";0;231;12881;13112;0,0176174496644295;1,76
2013;"0882";"Totalt";0;248;13236;13484;0,0183921684959953;1,84
2014;"0882";"Totalt";0;246;13437;13683;0,0179785134838851;1,8
2015;"0882";"Totalt";0;231;13643;13874;0,0166498486377397;1,66
2016;"0882";"Totalt";0;206;14309;14515;0,0141922149500517;1,42
2017;"0882";"Totalt";0;180;14326;14506;0,0124086584861437;1,24
2018;"0882";"Totalt";0;169;14003;14172;0,011924922382162;1,19
2019;"0882";"Totalt";0;196;13727;13923;0,0140774258421317;1,41
2020;"0882";"Totalt";0;164;13120;13284;0,0123456790123457;1,23
2021;"0882";"Totalt";0;167;13365;13532;0,0123411173514632;1,23
2022;"0882";"Totalt";0;177;13643;13820;0,0128075253256151;1,28
2007;"0883";"Totalt";0;342;14057;14399;0,0237516494200986;2,38
2008;"0883";"Totalt";0;324;14198;14522;0,0223109764495249;2,23
2009;"0883";"Totalt";0;308;13619;13927;0,0221153155740648;2,21
2010;"0883";"Totalt";0;293;14189;14482;0,0202320121530175;2,02
2011;"0883";"Totalt";0;284;14450;14734;0,019275145920999;1,93
2012;"0883";"Totalt";0;288;14392;14680;0,0196185286103542;1,96
2013;"0883";"Totalt";0;306;14165;14471;0,0211457397553728;2,11
2014;"0883";"Totalt";0;308;14288;14596;0,0211016716908742;2,11
2015;"0883";"Totalt";0;295;14141;14436;0,0204350235522305;2,04
2016;"0883";"Totalt";0;268;13922;14190;0,0188865398167724;1,89
2017;"0883";"Totalt";0;288;13951;14239;0,0202261394760868;2,02
2018;"0883";"Totalt";0;298;13993;14291;0,0208522846546778;2,09
2019;"0883";"Totalt";0;305;13845;14150;0,0215547703180212;2,16
2020;"0883";"Totalt";0;260;13728;13988;0,0185873605947955;1,86
2021;"0883";"Totalt";0;275;14099;14374;0,0191317656880479;1,91
2022;"0883";"Totalt";0;264;14601;14865;0,0177598385469223;1,78
2007;"0884";"Totalt";0;528;6833;7361;0,0717293845944844;7,17
2008;"0884";"Totalt";0;527;6793;7320;0,0719945355191257;7,2
2009;"0884";"Totalt";0;545;6252;6797;0,0801824334265117;8,02
2010;"0884";"Totalt";0;609;6444;7053;0,0863462356444066;8,63
2011;"0884";"Totalt";0;631;6558;7189;0,0877729865071637;8,78
2012;"0884";"Totalt";0;662;6469;7131;0,0928341046136587;9,28
2013;"0884";"Totalt";0;626;6374;7000;0,0894285714285714;8,94
2014;"0884";"Totalt";0;638;6476;7114;0,089682316558898;8,97
2015;"0884";"Totalt";0;665;6484;7149;0,0930200027975941;9,3
2016;"0884";"Totalt";0;649;6511;7160;0,0906424581005587;9,06
2017;"0884";"Totalt";0;632;6639;7271;0,0869206436528676;8,69
2018;"0884";"Totalt";0;630;6727;7357;0,0856327307326356;8,56
2019;"0884";"Totalt";0;643;6911;7554;0,0851204659782896;8,51
2020;"0884";"Totalt";0;461;6590;7051;0,0653807970500638;6,54
2021;"0884";"Totalt";0;590;6748;7338;0,0804033796674843;8,04
2022;"0884";"Totalt";0;598;6989;7587;0,0788190325556874;7,88
2007;"0885";"Totalt";0;151;3551;3702;0,0407887628309022;4,08
2008;"0885";"Totalt";0;152;3348;3500;0,0434285714285714;4,34
2009;"0885";"Totalt";0;160;3374;3534;0,0452744765138653;4,53
2010;"0885";"Totalt";0;163;3566;3729;0,0437114507910968;4,37
2011;"0885";"Totalt";0;145;3524;3669;0,0395203052602889;3,95
2012;"0885";"Totalt";0;145;3540;3685;0,039348710990502;3,93
2013;"0885";"Totalt";0;141;3589;3730;0,0378016085790885;3,78
2014;"0885";"Totalt";0;137;3521;3658;0,037452159650082;3,75
2015;"0885";"Totalt";0;134;3527;3661;0,0366020213056542;3,66
2016;"0885";"Totalt";0;132;3698;3830;0,0344647519582245;3,45
2017;"0885";"Totalt";0;139;3728;3867;0,0359451771399017;3,59
2018;"0885";"Totalt";0;136;3692;3828;0,0355276907001045;3,55
2019;"0885";"Totalt";0;140;3426;3566;0,0392596747055524;3,93
2020;"0885";"Totalt";0;134;3334;3468;0,038638985005767;3,86
2021;"0885";"Totalt";0;133;3509;3642;0,0365183964854476;3,65
2022;"0885";"Totalt";0;139;3680;3819;0,0363969625556428;3,64
2007;"0980";"Totalt";0;1037;22958;23995;0,0432173369451969;4,32
2008;"0980";"Totalt";0;1025;22944;23969;0,0427635696107472;4,28
2009;"0980";"Totalt";0;981;22491;23472;0,0417944785276074;4,18
2010;"0980";"Totalt";0;1031;23032;24063;0,0428458629431077;4,28
2011;"0980";"Totalt";0;1029;23223;24252;0,0424294903513112;4,24
2012;"0980";"Totalt";0;1020;23352;24372;0,0418513047759724;4,19
2013;"0980";"Totalt";0;1011;23242;24253;0,0416855646724117;4,17
2014;"0980";"Totalt";0;979;23479;24458;0,0400278027639218;4
2015;"0980";"Totalt";0;998;23738;24736;0,0403460543337646;4,03
2016;"0980";"Totalt";0;993;24079;25072;0,0396059349074665;3,96
2017;"0980";"Totalt";0;979;24366;25345;0,0386269481159992;3,86
2018;"0980";"Totalt";0;935;24784;25719;0,0363544461293207;3,64
2019;"0980";"Totalt";0;920;24702;25622;0,0359066427289048;3,59
2020;"0980";"Totalt";0;910;24406;25316;0,0359456470216464;3,59
2021;"0980";"Totalt";0;904;25413;26317;0,0343504198806855;3,44
2022;"0980";"Totalt";0;939;26065;27004;0,0347726262775885;3,48
2007;"1060";"Totalt";0;153;7087;7240;0,0211325966850829;2,11
2008;"1060";"Totalt";0;150;6645;6795;0,022075055187638;2,21
2009;"1060";"Totalt";0;94;5796;5890;0,0159592529711375;1,6
2010;"1060";"Totalt";0;95;5673;5768;0,0164701803051318;1,65
2011;"1060";"Totalt";0;92;5862;5954;0,0154517971111858;1,55
2012;"1060";"Totalt";0;86;6091;6177;0,0139226161567104;1,39
2013;"1060";"Totalt";0;73;6156;6229;0,0117193771070798;1,17
2014;"1060";"Totalt";0;76;6166;6242;0,0121755847484781;1,22
2015;"1060";"Totalt";0;67;6380;6447;0,0103924305878703;1,04
2016;"1060";"Totalt";0;68;6706;6774;0,0100383820490109;1
2017;"1060";"Totalt";0;65;7168;7233;0,00898658924374395;0,9
2018;"1060";"Totalt";0;62;7183;7245;0,0085576259489303;0,86
2019;"1060";"Totalt";0;67;6945;7012;0,00955504848830576;0,96
2020;"1060";"Totalt";0;64;6656;6720;0,00952380952380952;0,95
2021;"1060";"Totalt";0;59;6603;6662;0,00885619933953768;0,89
2022;"1060";"Totalt";0;66;6516;6582;0,0100273473108478;1
2007;"1080";"Totalt";0;1010;27313;28323;0,0356600642587297;3,57
2008;"1080";"Totalt";0;994;27265;28259;0,0351746346296755;3,52
2009;"1080";"Totalt";0;952;26925;27877;0,0341500161423396;3,42
2010;"1080";"Totalt";0;1005;27239;28244;0,0355827786432517;3,56
2011;"1080";"Totalt";0;958;27525;28483;0,0336340975318611;3,36
2012;"1080";"Totalt";0;943;27223;28166;0,0334800823688135;3,35
2013;"1080";"Totalt";0;921;27228;28149;0,0327187466695087;3,27
2014;"1080";"Totalt";0;905;27254;28159;0,0321389253879754;3,21
2015;"1080";"Totalt";0;929;27574;28503;0,0325930603796092;3,26
2016;"1080";"Totalt";0;874;28567;29441;0,0296864916273224;2,97
2017;"1080";"Totalt";0;871;29020;29891;0,0291392057810043;2,91
2018;"1080";"Totalt";0;870;28880;29750;0,0292436974789916;2,92
2019;"1080";"Totalt";0;865;28795;29660;0,0291638570465273;2,92
2020;"1080";"Totalt";0;788;28795;29583;0,0266369198526181;2,66
2021;"1080";"Totalt";0;791;29567;30358;0,026055734896897;2,61
2022;"1080";"Totalt";0;833;30314;31147;0,0267441487141619;2,67
2007;"1081";"Totalt";0;245;11567;11812;0,0207416186928547;2,07
2008;"1081";"Totalt";0;291;11212;11503;0,0252977484134574;2,53
2009;"1081";"Totalt";0;241;10081;10322;0,0233481883355939;2,33
2010;"1081";"Totalt";0;252;10245;10497;0,0240068591026007;2,4
2011;"1081";"Totalt";0;204;9983;10187;0,0200255227250417;2
2012;"1081";"Totalt";0;248;10043;10291;0,0240987270430473;2,41
2013;"1081";"Totalt";0;267;10022;10289;0,0259500437360288;2,6
2014;"1081";"Totalt";0;248;9782;10030;0,0247258225324028;2,47
2015;"1081";"Totalt";0;229;9602;9831;0,0232936629030617;2,33
2016;"1081";"Totalt";0;204;9932;10136;0,0201262825572218;2,01
2017;"1081";"Totalt";0;206;10031;10237;0,0201230829344535;2,01
2018;"1081";"Totalt";0;192;10076;10268;0,0186988702765875;1,87
2019;"1081";"Totalt";0;183;9797;9980;0,0183366733466934;1,83
2020;"1081";"Totalt";0;158;9438;9596;0,0164651938307628;1,65
2021;"1081";"Totalt";0;154;9456;9610;0,0160249739854318;1,6
2022;"1081";"Totalt";0;161;9647;9808;0,0164151712887439;1,64
2007;"1082";"Totalt";0;445;11206;11651;0,0381941464251996;3,82
2008;"1082";"Totalt";0;430;10832;11262;0,0381814952939087;3,82
2009;"1082";"Totalt";0;414;10842;11256;0,0367803837953092;3,68
2010;"1082";"Totalt";0;459;11060;11519;0,039847208959111;3,98
2011;"1082";"Totalt";0;478;10951;11429;0,0418234316213142;4,18
2012;"1082";"Totalt";0;482;10782;11264;0,0427911931818182;4,28
2013;"1082";"Totalt";0;503;10910;11413;0,0440725488478051;4,41
2014;"1082";"Totalt";0;488;10939;11427;0,0427058720574079;4,27
2015;"1082";"Totalt";0;457;11184;11641;0,039257795722017;3,93
2016;"1082";"Totalt";0;416;11358;11774;0,0353320876507559;3,53
2017;"1082";"Totalt";0;385;11617;12002;0,0320779870021663;3,21
2018;"1082";"Totalt";0;383;11770;12153;0,0315148522998437;3,15
2019;"1082";"Totalt";0;395;11914;12309;0,0320903404013324;3,21
2020;"1082";"Totalt";0;271;11932;12203;0,0222076538556093;2,22
2021;"1082";"Totalt";0;258;12089;12347;0,0208957641532356;2,09
2022;"1082";"Totalt";0;247;12374;12621;0,019570557008161;1,96
2007;"1083";"Totalt";0;191;5664;5855;0,0326216908625107;3,26
2008;"1083";"Totalt";0;195;5568;5763;0,0338365434669443;3,38
2009;"1083";"Totalt";0;179;5129;5308;0,0337226827430294;3,37
2010;"1083";"Totalt";0;182;5156;5338;0,034095166729112;3,41
2011;"1083";"Totalt";0;170;5249;5419;0,0313711016792766;3,14
2012;"1083";"Totalt";0;161;5287;5448;0,0295521292217327;2,96
2013;"1083";"Totalt";0;152;5407;5559;0,0273430473106674;2,73
2014;"1083";"Totalt";0;157;5481;5638;0,0278467541681447;2,78
2015;"1083";"Totalt";0;134;5550;5684;0,0235749472202674;2,36
2016;"1083";"Totalt";0;145;5588;5733;0,025292168149311;2,53
2017;"1083";"Totalt";0;147;5770;5917;0,024843670779111;2,48
2018;"1083";"Totalt";0;136;5690;5826;0,0233436319945074;2,33
2019;"1083";"Totalt";0;147;5485;5632;0,0261008522727273;2,61
2020;"1083";"Totalt";0;124;5400;5524;0,0224475018102824;2,24
2021;"1083";"Totalt";0;128;5627;5755;0,022241529105126;2,22
2022;"1083";"Totalt";0;133;5712;5845;0,0227544910179641;2,28
2007;"1214";"Totalt";0;48;3293;3341;0,0143669560011972;1,44
2008;"1214";"Totalt";0;53;3195;3248;0,0163177339901478;1,63
2009;"1214";"Totalt";0;45;3090;3135;0,0143540669856459;1,44
2010;"1214";"Totalt";0;52;3171;3223;0,0161340366118523;1,61
2011;"1214";"Totalt";0;59;3152;3211;0,0183743382123949;1,84
2012;"1214";"Totalt";0;60;3179;3239;0,0185242358752701;1,85
2013;"1214";"Totalt";0;52;3205;3257;0,0159656125268652;1,6
2014;"1214";"Totalt";0;54;3238;3292;0,0164034021871203;1,64
2015;"1214";"Totalt";0;55;3275;3330;0,0165165165165165;1,65
2016;"1214";"Totalt";0;72;3360;3432;0,020979020979021;2,1
2017;"1214";"Totalt";0;76;3492;3568;0,0213004484304933;2,13
2018;"1214";"Totalt";0;68;3528;3596;0,0189098998887653;1,89
2019;"1214";"Totalt";0;79;3593;3672;0,0215141612200436;2,15
2020;"1214";"Totalt";0;65;3567;3632;0,0178964757709251;1,79
2021;"1214";"Totalt";0;60;3778;3838;0,0156331422615946;1,56
2022;"1214";"Totalt";0;46;3562;3608;0,0127494456762749;1,27
2007;"1230";"Totalt";0;145;4861;5006;0,0289652417099481;2,9
2008;"1230";"Totalt";0;134;5102;5236;0,0255920550038197;2,56
2009;"1230";"Totalt";0;127;4919;5046;0,0251684502576298;2,52
2010;"1230";"Totalt";0;127;5122;5249;0,024195084778053;2,42
2011;"1230";"Totalt";0;130;5292;5422;0,0239763924751014;2,4
2012;"1230";"Totalt";0;127;5293;5420;0,0234317343173432;2,34
2013;"1230";"Totalt";0;148;5338;5486;0,026977761574918;2,7
2014;"1230";"Totalt";0;185;5403;5588;0,0331066571224052;3,31
2015;"1230";"Totalt";0;167;5692;5859;0,0285031575354156;2,85
2016;"1230";"Totalt";0;125;5944;6069;0,0205964738836711;2,06
2017;"1230";"Totalt";0;130;5983;6113;0,0212661540978243;2,13
2018;"1230";"Totalt";0;120;6278;6398;0,0187558612066271;1,88
2019;"1230";"Totalt";0;130;6432;6562;0,0198110332215788;1,98
2020;"1230";"Totalt";0;110;6652;6762;0,0162673765158237;1,63
2021;"1230";"Totalt";0;103;6695;6798;0,0151515151515152;1,52
2022;"1230";"Totalt";0;109;6835;6944;0,0156970046082949;1,57
2007;"1231";"Totalt";0;327;7372;7699;0,0424730484478504;4,25
2008;"1231";"Totalt";0;346;7203;7549;0,0458338852828189;4,58
2009;"1231";"Totalt";0;351;7027;7378;0,0475738682569802;4,76
2010;"1231";"Totalt";0;251;7214;7465;0,0336235766912257;3,36
2011;"1231";"Totalt";0;286;7395;7681;0,037234735060539;3,72
2012;"1231";"Totalt";0;286;7495;7781;0,0367562010024418;3,68
2013;"1231";"Totalt";0;277;7319;7596;0,0364665613480779;3,65
2014;"1231";"Totalt";0;260;7349;7609;0,0341700617689578;3,42
2015;"1231";"Totalt";0;259;7348;7607;0,0340475877481267;3,4
2016;"1231";"Totalt";0;270;7432;7702;0,0350558296546352;3,51
2017;"1231";"Totalt";0;318;7726;8044;0,0395325708602685;3,95
2018;"1231";"Totalt";0;318;7898;8216;0,0387049659201558;3,87
2019;"1231";"Totalt";0;274;8081;8355;0,0327947336923998;3,28
2020;"1231";"Totalt";0;173;8416;8589;0,0201420421469321;2,01
2021;"1231";"Totalt";0;169;8636;8805;0,0191936399772856;1,92
2022;"1231";"Totalt";0;166;8812;8978;0,0184896413455112;1,85
2007;"1233";"Totalt";0;481;6617;7098;0,0677655677655678;6,78
2008;"1233";"Totalt";0;522;6734;7256;0,0719404630650496;7,19
2009;"1233";"Totalt";0;483;6528;7011;0,0688917415489944;6,89
2010;"1233";"Totalt";0;508;6874;7382;0,0688160390138174;6,88
2011;"1233";"Totalt";0;499;6730;7229;0,0690275280121732;6,9
2012;"1233";"Totalt";0;493;6982;7475;0,0659531772575251;6,6
2013;"1233";"Totalt";0;462;7041;7503;0,0615753698520592;6,16
2014;"1233";"Totalt";0;390;7098;7488;0,0520833333333333;5,21
2015;"1233";"Totalt";0;367;7392;7759;0,0472999097821884;4,73
2016;"1233";"Totalt";0;353;7845;8198;0,0430592827518907;4,31
2017;"1233";"Totalt";0;335;8033;8368;0,0400334608030593;4
2018;"1233";"Totalt";0;329;7997;8326;0,0395147730002402;3,95
2019;"1233";"Totalt";0;315;8093;8408;0,0374643196955281;3,75
2020;"1233";"Totalt";0;316;8185;8501;0,0371720974003058;3,72
2021;"1233";"Totalt";0;302;8480;8782;0,0343885219767707;3,44
2022;"1233";"Totalt";0;326;8823;9149;0,0356323095420265;3,56
2007;"1256";"Totalt";0;110;4797;4907;0,0224169553698798;2,24
2008;"1256";"Totalt";0;101;4440;4541;0,0222417969610218;2,22
2009;"1256";"Totalt";0;88;3856;3944;0,0223123732251521;2,23
2010;"1256";"Totalt";0;102;3886;3988;0,0255767301905717;2,56
2011;"1256";"Totalt";0;120;3909;4029;0,0297840655249442;2,98
2012;"1256";"Totalt";0;122;3827;3949;0,0308938971891618;3,09
2013;"1256";"Totalt";0;127;3796;3923;0,0323731837879174;3,24
2014;"1256";"Totalt";0;118;3766;3884;0,0303810504634398;3,04
2015;"1256";"Totalt";0;118;3853;3971;0,029715436917653;2,97
2016;"1256";"Totalt";0;104;3890;3994;0,0260390585878818;2,6
2017;"1256";"Totalt";0;102;3939;4041;0,0252412769116555;2,52
2018;"1256";"Totalt";0;103;3860;3963;0,0259904113045672;2,6
2019;"1256";"Totalt";0;97;3824;3921;0,0247385870951288;2,47
2020;"1256";"Totalt";0;96;3621;3717;0,0258272800645682;2,58
2021;"1256";"Totalt";0;102;3622;3724;0,027389903329753;2,74
2022;"1256";"Totalt";0;112;3601;3713;0,0301642876380285;3,02
2007;"1257";"Totalt";0;43;3929;3972;0,0108257804632427;1,08
2008;"1257";"Totalt";0;45;3858;3903;0,0115295926210607;1,15
2009;"1257";"Totalt";0;40;3418;3458;0,0115673799884326;1,16
2010;"1257";"Totalt";0;34;3393;3427;0,00992121388969945;0,99
2011;"1257";"Totalt";0;42;3368;3410;0,012316715542522;1,23
2012;"1257";"Totalt";0;43;3376;3419;0,012576776835332;1,26
2013;"1257";"Totalt";0;42;3351;3393;0,0123784261715296;1,24
2014;"1257";"Totalt";0;48;3127;3175;0,0151181102362205;1,51
2015;"1257";"Totalt";0;40;3260;3300;0,0121212121212121;1,21
2016;"1257";"Totalt";0;44;3272;3316;0,0132689987937274;1,33
2017;"1257";"Totalt";0;40;3380;3420;0,0116959064327485;1,17
2018;"1257";"Totalt";0;37;3382;3419;0,0108218777420298;1,08
2019;"1257";"Totalt";0;34;3288;3322;0,0102347983142685;1,02
2020;"1257";"Totalt";0;32;3305;3337;0,00958945160323644;0,96
2021;"1257";"Totalt";0;42;3383;3425;0,0122627737226277;1,23
2022;"1257";"Totalt";0;52;3328;3380;0,0153846153846154;1,54
2007;"1260";"Totalt";0;32;4709;4741;0,00674963087956127;0,67
2008;"1260";"Totalt";0;64;4536;4600;0,0139130434782609;1,39
2009;"1260";"Totalt";0;53;4337;4390;0,0120728929384966;1,21
2010;"1260";"Totalt";0;60;4343;4403;0,0136270724506019;1,36
2011;"1260";"Totalt";0;32;4384;4416;0,0072463768115942;0,72
2012;"1260";"Totalt";0;21;4350;4371;0,00480439258750858;0,48
2013;"1260";"Totalt";0;21;4264;4285;0,00490081680280047;0,49
2014;"1260";"Totalt";0;32;4312;4344;0,00736648250460405;0,74
2015;"1260";"Totalt";0;29;4467;4496;0,00645017793594306;0,65
2016;"1260";"Totalt";0;27;4616;4643;0,00581520568597889;0,58
2017;"1260";"Totalt";0;29;4351;4380;0,00662100456621005;0,66
2018;"1260";"Totalt";0;26;3961;3987;0,00652119388011036;0,65
2019;"1260";"Totalt";0;29;4093;4122;0,00703541969917516;0,7
2020;"1260";"Totalt";0;27;4306;4333;0,00623124855758135;0,62
2021;"1260";"Totalt";0;30;4916;4946;0,00606550748079256;0,61
2022;"1260";"Totalt";0;31;5141;5172;0,0059938128383604;0,6
2007;"1261";"Totalt";0;321;6646;6967;0,046074350509545;4,61
2008;"1261";"Totalt";0;330;6272;6602;0,0499848530748258;5
2009;"1261";"Totalt";0;316;5819;6135;0,0515077424612877;5,15
2010;"1261";"Totalt";0;324;6135;6459;0,0501625638643753;5,02
2011;"1261";"Totalt";0;313;6353;6666;0,046954695469547;4,7
2012;"1261";"Totalt";0;316;6537;6853;0,0461111921786079;4,61
2013;"1261";"Totalt";0;296;6711;7007;0,0422434708148994;4,22
2014;"1261";"Totalt";0;291;6746;7037;0,0413528492255222;4,14
2015;"1261";"Totalt";0;287;6902;7189;0,0399221032132425;3,99
2016;"1261";"Totalt";0;305;6886;7191;0,0424141287720762;4,24
2017;"1261";"Totalt";0;292;6965;7257;0,0402370125396169;4,02
2018;"1261";"Totalt";0;291;7010;7301;0,0398575537597589;3,99
2019;"1261";"Totalt";0;306;7250;7556;0,040497617787189;4,05
2020;"1261";"Totalt";0;289;7260;7549;0,0382832163200424;3,83
2021;"1261";"Totalt";0;273;7571;7844;0,0348036715961244;3,48
2022;"1261";"Totalt";0;271;7784;8055;0,0336436995654873;3,36
2007;"1262";"Totalt";0;169;4193;4362;0,0387436955524989;3,87
2008;"1262";"Totalt";0;137;4264;4401;0,0311292887980005;3,11
2009;"1262";"Totalt";0;143;4256;4399;0,032507388042737;3,25
2010;"1262";"Totalt";0;163;4411;4574;0,0356362046348929;3,56
2011;"1262";"Totalt";0;168;4585;4753;0,0353460972017673;3,53
2012;"1262";"Totalt";0;183;4776;4959;0,0369026013309135;3,69
2013;"1262";"Totalt";0;198;4798;4996;0,0396317053642914;3,96
2014;"1262";"Totalt";0;180;4935;5115;0,0351906158357771;3,52
2015;"1262";"Totalt";0;183;5198;5381;0,0340085485969151;3,4
2016;"1262";"Totalt";0;171;5394;5565;0,0307277628032345;3,07
2017;"1262";"Totalt";0;176;5454;5630;0,0312611012433393;3,13
2018;"1262";"Totalt";0;188;5358;5546;0,0338983050847458;3,39
2019;"1262";"Totalt";0;203;5464;5667;0,0358214222692783;3,58
2020;"1262";"Totalt";0;226;5517;5743;0,0393522549190319;3,94
2021;"1262";"Totalt";0;201;5633;5834;0,0344532053479602;3,45
2022;"1262";"Totalt";0;252;5874;6126;0,0411361410381978;4,11
2007;"1263";"Totalt";0;213;5554;5767;0,0369342812554188;3,69
2008;"1263";"Totalt";0;206;5735;5941;0,0346742972563541;3,47
2009;"1263";"Totalt";0;198;5678;5876;0,0336963921034718;3,37
2010;"1263";"Totalt";0;193;5847;6040;0,031953642384106;3,2
2011;"1263";"Totalt";0;198;6038;6236;0,0317511225144323;3,18
2012;"1263";"Totalt";0;202;6043;6245;0,0323458767013611;3,23
2013;"1263";"Totalt";0;178;6045;6223;0,0286035674112165;2,86
2014;"1263";"Totalt";0;162;6032;6194;0,026154342912496;2,62
2015;"1263";"Totalt";0;167;6136;6303;0,026495319689037;2,65
2016;"1263";"Totalt";0;179;6163;6342;0,0282245348470514;2,82
2017;"1263";"Totalt";0;146;6287;6433;0,022695476449557;2,27
2018;"1263";"Totalt";0;153;6221;6374;0,0240037652965171;2,4
2019;"1263";"Totalt";0;170;6516;6686;0,0254262638348789;2,54
2020;"1263";"Totalt";0;143;6148;6291;0,0227308853918296;2,27
2021;"1263";"Totalt";0;165;6378;6543;0,0252177900045851;2,52
2022;"1263";"Totalt";0;168;6753;6921;0,0242739488513221;2,43
2007;"1264";"Totalt";0;147;3414;3561;0,0412805391743892;4,13
2008;"1264";"Totalt";0;143;3365;3508;0,0407639680729761;4,08
2009;"1264";"Totalt";0;144;3342;3486;0,0413080895008606;4,13
2010;"1264";"Totalt";0;148;3443;3591;0,0412141464773044;4,12
2011;"1264";"Totalt";0;159;3495;3654;0,0435139573070608;4,35
2012;"1264";"Totalt";0;145;3490;3635;0,0398899587345254;3,99
2013;"1264";"Totalt";0;136;3456;3592;0,0378619153674833;3,79
2014;"1264";"Totalt";0;128;3545;3673;0,034848897359107;3,48
2015;"1264";"Totalt";0;121;3627;3748;0,0322838847385272;3,23
2016;"1264";"Totalt";0;112;3670;3782;0,029613960867266;2,96
2017;"1264";"Totalt";0;115;3715;3830;0,0300261096605744;3
2018;"1264";"Totalt";0;126;3804;3930;0,0320610687022901;3,21
2019;"1264";"Totalt";0;118;3873;3991;0,0295665246805312;2,96
2020;"1264";"Totalt";0;113;3941;4054;0,0278737049827331;2,79
2021;"1264";"Totalt";0;113;3996;4109;0,0275006084205403;2,75
2022;"1264";"Totalt";0;118;4107;4225;0,0279289940828402;2,79
2007;"1265";"Totalt";0;150;5200;5350;0,0280373831775701;2,8
2008;"1265";"Totalt";0;153;5344;5497;0,0278333636529016;2,78
2009;"1265";"Totalt";0;142;5211;5353;0,0265271810199888;2,65
2010;"1265";"Totalt";0;140;5210;5350;0,0261682242990654;2,62
2011;"1265";"Totalt";0;109;4951;5060;0,0215415019762846;2,15
2012;"1265";"Totalt";0;105;5128;5233;0,0200649722912287;2,01
2013;"1265";"Totalt";0;111;5215;5326;0,0208411565903117;2,08
2014;"1265";"Totalt";0;106;5219;5325;0,019906103286385;1,99
2015;"1265";"Totalt";0;99;5173;5272;0,0187784522003035;1,88
2016;"1265";"Totalt";0;106;5255;5361;0,0197724305166946;1,98
2017;"1265";"Totalt";0;106;5395;5501;0,019269223777495;1,93
2018;"1265";"Totalt";0;108;5489;5597;0,0192960514561372;1,93
2019;"1265";"Totalt";0;94;5510;5604;0,016773733047823;1,68
2020;"1265";"Totalt";0;93;5557;5650;0,0164601769911504;1,65
2021;"1265";"Totalt";0;91;5573;5664;0,016066384180791;1,61
2022;"1265";"Totalt";0;100;5774;5874;0,0170241743275451;1,7
2007;"1266";"Totalt";0;100;4105;4205;0,0237812128418549;2,38
2008;"1266";"Totalt";0;109;4179;4288;0,025419776119403;2,54
2009;"1266";"Totalt";0;103;4155;4258;0,0241897604509159;2,42
2010;"1266";"Totalt";0;106;4328;4434;0,0239061795218764;2,39
2011;"1266";"Totalt";0;87;4350;4437;0,0196078431372549;1,96
2012;"1266";"Totalt";0;89;4551;4640;0,0191810344827586;1,92
2013;"1266";"Totalt";0;91;4577;4668;0,0194944301628106;1,95
2014;"1266";"Totalt";0;87;4580;4667;0,0186415256053139;1,86
2015;"1266";"Totalt";0;105;4512;4617;0,0227420402858999;2,27
2016;"1266";"Totalt";0;93;4524;4617;0,0201429499675114;2,01
2017;"1266";"Totalt";0;92;4613;4705;0,0195536663124336;1,96
2018;"1266";"Totalt";0;80;4722;4802;0,0166597251145356;1,67
2019;"1266";"Totalt";0;74;4563;4637;0,0159585939184818;1,6
2020;"1266";"Totalt";0;80;4446;4526;0,0176756517896597;1,77
2021;"1266";"Totalt";0;78;4476;4554;0,0171277997364954;1,71
2022;"1266";"Totalt";0;72;4679;4751;0,0151547042727847;1,52
2007;"1267";"Totalt";0;107;4079;4186;0,0255613951266125;2,56
2008;"1267";"Totalt";0;99;4106;4205;0,0235434007134364;2,35
2009;"1267";"Totalt";0;100;4046;4146;0,0241196333815726;2,41
2010;"1267";"Totalt";0;113;4212;4325;0,0261271676300578;2,61
2011;"1267";"Totalt";0;107;4185;4292;0,0249301025163094;2,49
2012;"1267";"Totalt";0;116;4091;4207;0,0275730924649394;2,76
2013;"1267";"Totalt";0;115;4062;4177;0,0275317213310989;2,75
2014;"1267";"Totalt";0;117;4063;4180;0,0279904306220096;2,8
2015;"1267";"Totalt";0;119;4240;4359;0,0272998394127093;2,73
2016;"1267";"Totalt";0;112;4495;4607;0,0243108313436076;2,43
2017;"1267";"Totalt";0;104;4564;4668;0,0222793487574979;2,23
2018;"1267";"Totalt";0;117;4529;4646;0,0251829530779165;2,52
2019;"1267";"Totalt";0;110;4493;4603;0,0238974581794482;2,39
2020;"1267";"Totalt";0;108;4353;4461;0,0242098184263618;2,42
2021;"1267";"Totalt";0;110;4569;4679;0,0235092968583031;2,35
2022;"1267";"Totalt";0;117;4603;4720;0,0247881355932203;2,48
2007;"1270";"Totalt";0;140;4092;4232;0,0330812854442344;3,31
2008;"1270";"Totalt";0;127;4187;4314;0,0294390356977283;2,94
2009;"1270";"Totalt";0;134;4102;4236;0,0316336166194523;3,16
2010;"1270";"Totalt";0;139;4070;4209;0,0330244713708719;3,3
2011;"1270";"Totalt";0;143;4180;4323;0,0330788804071247;3,31
2012;"1270";"Totalt";0;169;4344;4513;0,0374473742521604;3,74
2013;"1270";"Totalt";0;149;4348;4497;0,0331331999110518;3,31
2014;"1270";"Totalt";0;145;4455;4600;0,0315217391304348;3,15
2015;"1270";"Totalt";0;149;4530;4679;0,0318444111989741;3,18
2016;"1270";"Totalt";0;131;4438;4569;0,0286714817246662;2,87
2017;"1270";"Totalt";0;131;4464;4595;0,0285092491838955;2,85
2018;"1270";"Totalt";0;132;4450;4582;0,0288083806198167;2,88
2019;"1270";"Totalt";0;144;4396;4540;0,0317180616740088;3,17
2020;"1270";"Totalt";0;124;4425;4549;0,0272587381842163;2,73
2021;"1270";"Totalt";0;115;4587;4702;0,0244576775840068;2,45
2022;"1270";"Totalt";0;132;4908;5040;0,0261904761904762;2,62
2007;"1272";"Totalt";0;59;4752;4811;0,0122635626688838;1,23
2008;"1272";"Totalt";0;62;4746;4808;0,0128951747088186;1,29
2009;"1272";"Totalt";0;64;4422;4486;0,0142666072224699;1,43
2010;"1272";"Totalt";0;67;4511;4578;0,0146352118829183;1,46
2011;"1272";"Totalt";0;63;4417;4480;0,0140625;1,41
2012;"1272";"Totalt";0;71;4210;4281;0,0165849100677412;1,66
2013;"1272";"Totalt";0;68;4059;4127;0,0164768597043858;1,65
2014;"1272";"Totalt";0;70;3991;4061;0,0172371337109086;1,72
2015;"1272";"Totalt";0;67;3895;3962;0,0169106511862696;1,69
2016;"1272";"Totalt";0;71;4145;4216;0,0168406072106262;1,68
2017;"1272";"Totalt";0;67;4092;4159;0,0161096417408031;1,61
2018;"1272";"Totalt";0;67;4215;4282;0,0156468939747781;1,56
2019;"1272";"Totalt";0;65;4106;4171;0,0155837928554304;1,56
2020;"1272";"Totalt";0;59;4009;4068;0,0145034414945919;1,45
2021;"1272";"Totalt";0;60;4086;4146;0,0144717800289436;1,45
2022;"1272";"Totalt";0;73;4213;4286;0,0170321978534764;1,7
2007;"1273";"Totalt";0;85;4019;4104;0,0207115009746589;2,07
2008;"1273";"Totalt";0;82;3939;4021;0,0203929370803283;2,04
2009;"1273";"Totalt";0;77;3772;3849;0,0200051961548454;2
2010;"1273";"Totalt";0;83;3899;3982;0,020843797086891;2,08
2011;"1273";"Totalt";0;78;3993;4071;0,0191599115696389;1,92
2012;"1273";"Totalt";0;75;3998;4073;0,0184139454947213;1,84
2013;"1273";"Totalt";0;78;3839;3917;0,0199131988766913;1,99
2014;"1273";"Totalt";0;81;4001;4082;0,01984321411073;1,98
2015;"1273";"Totalt";0;76;3941;4017;0,0189195917351257;1,89
2016;"1273";"Totalt";0;79;3995;4074;0,0193912616593029;1,94
2017;"1273";"Totalt";0;84;3960;4044;0,0207715133531157;2,08
2018;"1273";"Totalt";0;57;3987;4044;0,0140949554896142;1,41
2019;"1273";"Totalt";0;71;4069;4140;0,0171497584541063;1,71
2020;"1273";"Totalt";0;85;3942;4027;0,0211075242115719;2,11
2021;"1273";"Totalt";0;83;4010;4093;0,0202785243097972;2,03
2022;"1273";"Totalt";0;81;4097;4178;0,0193872666347535;1,94
2007;"1275";"Totalt";0;24;3132;3156;0,00760456273764259;0,76
2008;"1275";"Totalt";0;22;3118;3140;0,00700636942675159;0,7
2009;"1275";"Totalt";0;20;2878;2898;0,00690131124913734;0,69
2010;"1275";"Totalt";0;20;2822;2842;0,00703729767769177;0,7
2011;"1275";"Totalt";0;22;2872;2894;0,00760193503800968;0,76
2012;"1275";"Totalt";0;25;2883;2908;0,00859697386519945;0,86
2013;"1275";"Totalt";0;23;2882;2905;0,00791738382099828;0,79
2014;"1275";"Totalt";0;25;2878;2903;0,00861178091629349;0,86
2015;"1275";"Totalt";0;20;2930;2950;0,00677966101694915;0,68
2016;"1275";"Totalt";0;20;3027;3047;0,00656383327863472;0,66
2017;"1275";"Totalt";0;21;3059;3080;0,00681818181818182;0,68
2018;"1275";"Totalt";0;20;3064;3084;0,00648508430609598;0,65
2019;"1275";"Totalt";0;17;2992;3009;0,00564971751412429;0,56
2020;"1275";"Totalt";0;16;2958;2974;0,00537995965030262;0,54
2021;"1275";"Totalt";0;13;3002;3015;0,00431177446102819;0,43
2022;"1275";"Totalt";0;14;3083;3097;0,00452050371327091;0,45
2007;"1276";"Totalt";0;193;5315;5508;0,035039941902687;3,5
2008;"1276";"Totalt";0;182;5366;5548;0,0328046142754146;3,28
2009;"1276";"Totalt";0;163;5198;5361;0,0304047752285021;3,04
2010;"1276";"Totalt";0;163;5327;5490;0,0296903460837887;2,97
2011;"1276";"Totalt";0;149;4972;5121;0,0290958797109939;2,91
2012;"1276";"Totalt";0;98;4905;5003;0,0195882470517689;1,96
2013;"1276";"Totalt";0;146;4696;4842;0,030152829409335;3,02
2014;"1276";"Totalt";0;148;4652;4800;0,0308333333333333;3,08
2015;"1276";"Totalt";0;138;4817;4955;0,0278506559031282;2,79
2016;"1276";"Totalt";0;135;4954;5089;0,0265278050697583;2,65
2017;"1276";"Totalt";0;146;5101;5247;0,0278254240518391;2,78
2018;"1276";"Totalt";0;147;5085;5232;0,0280963302752294;2,81
2019;"1276";"Totalt";0;142;5162;5304;0,0267722473604827;2,68
2020;"1276";"Totalt";0;128;5179;5307;0,0241190879969851;2,41
2021;"1276";"Totalt";0;123;5256;5379;0,0228667038482989;2,29
2022;"1276";"Totalt";0;138;6078;6216;0,0222007722007722;2,22
2007;"1277";"Totalt";0;212;5274;5486;0,038643820634342;3,86
2008;"1277";"Totalt";0;134;5357;5491;0,0244035694773265;2,44
2009;"1277";"Totalt";0;183;5074;5257;0,0348107285524063;3,48
2010;"1277";"Totalt";0;166;5206;5372;0,0309009679821296;3,09
2011;"1277";"Totalt";0;160;5243;5403;0,0296131778641495;2,96
2012;"1277";"Totalt";0;153;5178;5331;0,0287000562746201;2,87
2013;"1277";"Totalt";0;133;5281;5414;0,0245659401551533;2,46
2014;"1277";"Totalt";0;131;5327;5458;0,0240014657383657;2,4
2015;"1277";"Totalt";0;142;5363;5505;0,025794732061762;2,58
2016;"1277";"Totalt";0;137;5573;5710;0,0239929947460595;2,4
2017;"1277";"Totalt";0;128;5711;5839;0,0219215619112862;2,19
2018;"1277";"Totalt";0;86;5870;5956;0,0144392209536602;1,44
2019;"1277";"Totalt";0;47;5831;5878;0,00799591697856414;0,8
2020;"1277";"Totalt";0;54;5631;5685;0,00949868073878628;0,95
2021;"1277";"Totalt";0;61;5686;5747;0,0106142335131373;1,06
2022;"1277";"Totalt";0;63;5726;5789;0,0108827085852479;1,09
2007;"1278";"Totalt";0;296;5733;6029;0,049096035826837;4,91
2008;"1278";"Totalt";0;297;5790;6087;0,0487925086249384;4,88
2009;"1278";"Totalt";0;274;5610;5884;0,0465669612508498;4,66
2010;"1278";"Totalt";0;288;5734;6022;0,0478246429757556;4,78
2011;"1278";"Totalt";0;267;5779;6046;0,044161429043996;4,42
2012;"1278";"Totalt";0;262;5699;5961;0,0439523569870827;4,4
2013;"1278";"Totalt";0;263;5724;5987;0,0439285117755136;4,39
2014;"1278";"Totalt";0;212;5625;5837;0,0363200274113414;3,63
2015;"1278";"Totalt";0;215;5709;5924;0,0362930452397029;3,63
2016;"1278";"Totalt";0;206;5870;6076;0,0339038841342989;3,39
2017;"1278";"Totalt";0;178;5877;6055;0,0293971924029728;2,94
2018;"1278";"Totalt";0;185;5898;6083;0,0304126253493342;3,04
2019;"1278";"Totalt";0;147;5867;6014;0,024442966411706;2,44
2020;"1278";"Totalt";0;151;5989;6140;0,0245928338762215;2,46
2021;"1278";"Totalt";0;172;6329;6501;0,0264574680818336;2,65
2022;"1278";"Totalt";0;173;6617;6790;0,0254786450662739;2,55
2007;"1280";"Totalt";0;10009;131478;141487;0,0707414815495417;7,07
2008;"1280";"Totalt";0;10008;134133;144141;0,069432014485816;6,94
2009;"1280";"Totalt";0;10041;132393;142434;0,0704958085850289;7,05
2010;"1280";"Totalt";0;10388;136090;146478;0,0709184997064406;7,09
2011;"1280";"Totalt";0;10439;139181;149620;0,0697700842133405;6,98
2012;"1280";"Totalt";0;10397;142405;152802;0,0680423031112158;6,8
2013;"1280";"Totalt";0;10525;144422;154947;0,0679264522707765;6,79
2014;"1280";"Totalt";0;10258;147089;157347;0,0651934895485773;6,52
2015;"1280";"Totalt";0;10408;151666;162074;0,0642175796241223;6,42
2016;"1280";"Totalt";0;10774;156728;167502;0,0643216200403577;6,43
2017;"1280";"Totalt";0;10879;162079;172958;0,0628996635021219;6,29
2018;"1280";"Totalt";0;10980;165534;176514;0,0622046976443795;6,22
2019;"1280";"Totalt";0;11082;170478;181560;0,0610376734963648;6,1
2020;"1280";"Totalt";0;10631;169799;180430;0,0589203569251233;5,89
2021;"1280";"Totalt";0;10868;177179;188047;0,0577940621227672;5,78
2022;"1280";"Totalt";0;12099;185783;197882;0,0611424990650994;6,11
2007;"1281";"Totalt";0;2489;58285;60774;0,040955013657156;4,1
2008;"1281";"Totalt";0;3701;58659;62360;0,0593489416292495;5,93
2009;"1281";"Totalt";0;3654;57818;61472;0,0594416970327954;5,94
2010;"1281";"Totalt";0;2286;60423;62709;0,0364540974979668;3,65
2011;"1281";"Totalt";0;2251;60404;62655;0,0359269012848137;3,59
2012;"1281";"Totalt";0;2132;60826;62958;0,0338638457384288;3,39
2013;"1281";"Totalt";0;2081;61470;63551;0,0327453541250334;3,27
2014;"1281";"Totalt";0;2012;62876;64888;0,0310072740722476;3,1
2015;"1281";"Totalt";0;1998;63139;65137;0,0306738105838464;3,07
2016;"1281";"Totalt";0;2011;63982;65993;0,0304729289470095;3,05
2017;"1281";"Totalt";0;1959;64224;66183;0,029599746158379;2,96
2018;"1281";"Totalt";0;2006;66795;68801;0,0291565529570791;2,92
2019;"1281";"Totalt";0;2159;67801;69960;0,0308604917095483;3,09
2020;"1281";"Totalt";0;2031;67704;69735;0,0291245429124543;2,91
2021;"1281";"Totalt";0;2091;68938;71029;0,0294386799757845;2,94
2022;"1281";"Totalt";0;2199;71021;73220;0,0300327779295275;3
2007;"1282";"Totalt";0;651;13451;14102;0,0461636647284073;4,62
2008;"1282";"Totalt";0;631;13398;14029;0,04497825931998;4,5
2009;"1282";"Totalt";0;612;12586;13198;0,0463706622215487;4,64
2010;"1282";"Totalt";0;564;12562;13126;0,0429681548072528;4,3
2011;"1282";"Totalt";0;579;12602;13181;0,0439268644260678;4,39
2012;"1282";"Totalt";0;540;12922;13462;0,0401129104145001;4,01
2013;"1282";"Totalt";0;538;13251;13789;0,0390166074407136;3,9
2014;"1282";"Totalt";0;520;13371;13891;0,0374343099848823;3,74
2015;"1282";"Totalt";0;497;13825;14322;0,0347018572825024;3,47
2016;"1282";"Totalt";0;510;13960;14470;0,0352453351762267;3,52
2017;"1282";"Totalt";0;487;14089;14576;0,0334110867178924;3,34
2018;"1282";"Totalt";0;426;14520;14946;0,0285026093938177;2,85
2019;"1282";"Totalt";0;426;14651;15077;0,0282549578828679;2,83
2020;"1282";"Totalt";0;379;14765;15144;0,025026413100898;2,5
2021;"1282";"Totalt";0;409;15020;15429;0,0265085229114006;2,65
2022;"1282";"Totalt";0;390;15434;15824;0,0246461071789687;2,46
2007;"1283";"Totalt";0;4069;56637;60706;0,0670279708760254;6,7
2008;"1283";"Totalt";0;3962;56908;60870;0,0650895350747495;6,51
2009;"1283";"Totalt";0;3720;55066;58786;0,0632803728778961;6,33
2010;"1283";"Totalt";0;3465;56596;60061;0,0576913471304174;5,77
2011;"1283";"Totalt";0;3658;57549;61207;0,0597644060319898;5,98
2012;"1283";"Totalt";0;4241;58073;62314;0,0680585422216516;6,81
2013;"1283";"Totalt";0;4210;58997;63207;0,0666065467432405;6,66
2014;"1283";"Totalt";0;3697;60347;64044;0,0577259384173381;5,77
2015;"1283";"Totalt";0;3511;61132;64643;0,0543136921244373;5,43
2016;"1283";"Totalt";0;3239;63485;66724;0,0485432528025898;4,85
2017;"1283";"Totalt";0;3265;64819;68084;0,0479554667763351;4,8
2018;"1283";"Totalt";0;3235;66821;70056;0,0461773438392143;4,62
2019;"1283";"Totalt";0;3195;67164;70359;0,0454099688739181;4,54
2020;"1283";"Totalt";0;2939;68171;71110;0,0413303332864576;4,13
2021;"1283";"Totalt";0;2888;69467;72355;0,0399143113813835;3,99
2022;"1283";"Totalt";0;3174;70809;73983;0,0429017476987957;4,29
2007;"1284";"Totalt";0;251;6635;6886;0,0364507696776067;3,65
2008;"1284";"Totalt";0;237;6701;6938;0,0341597002017873;3,42
2009;"1284";"Totalt";0;235;6550;6785;0,0346352247605011;3,46
2010;"1284";"Totalt";0;257;6741;6998;0,0367247785081452;3,67
2011;"1284";"Totalt";0;341;6884;7225;0,04719723183391;4,72
2012;"1284";"Totalt";0;282;6971;7253;0,0388804632565835;3,89
2013;"1284";"Totalt";0;252;7149;7401;0,0340494527766518;3,4
2014;"1284";"Totalt";0;263;7228;7491;0,0351087972233347;3,51
2015;"1284";"Totalt";0;308;7301;7609;0,0404783808647654;4,05
2016;"1284";"Totalt";0;304;7496;7800;0,038974358974359;3,9
2017;"1284";"Totalt";0;356;7488;7844;0,0453850076491586;4,54
2018;"1284";"Totalt";0;331;7626;7957;0,0415985924343346;4,16
2019;"1284";"Totalt";0;327;7654;7981;0,0409723092344318;4,1
2020;"1284";"Totalt";0;300;7751;8051;0,037262451869333;3,73
2021;"1284";"Totalt";0;282;8038;8320;0,0338942307692308;3,39
2022;"1284";"Totalt";0;312;8270;8582;0,0363551619669075;3,64
2007;"1285";"Totalt";0;293;10049;10342;0,0283310771610907;2,83
2008;"1285";"Totalt";0;315;9835;10150;0,0310344827586207;3,1
2009;"1285";"Totalt";0;315;9488;9803;0,0321330205039274;3,21
2010;"1285";"Totalt";0;334;9454;9788;0,0341234164282795;3,41
2011;"1285";"Totalt";0;294;9514;9808;0,0299755301794454;3
2012;"1285";"Totalt";0;301;9649;9950;0,030251256281407;3,03
2013;"1285";"Totalt";0;295;9730;10025;0,029426433915212;2,94
2014;"1285";"Totalt";0;309;9757;10066;0,0306973971786211;3,07
2015;"1285";"Totalt";0;291;9920;10211;0,0284986778963862;2,85
2016;"1285";"Totalt";0;302;10080;10382;0,0290888075515315;2,91
2017;"1285";"Totalt";0;314;9909;10223;0,0307150542893475;3,07
2018;"1285";"Totalt";0;299;9968;10267;0,0291224310898997;2,91
2019;"1285";"Totalt";0;292;10171;10463;0,0279078658128644;2,79
2020;"1285";"Totalt";0;287;10046;10333;0,0277750895190167;2,78
2021;"1285";"Totalt";0;300;10097;10397;0,0288544772530538;2,89
2022;"1285";"Totalt";0;496;10457;10953;0,045284396968867;4,53
2007;"1286";"Totalt";0;510;10386;10896;0,0468061674008811;4,68
2008;"1286";"Totalt";0;483;10309;10792;0,0447553743513714;4,48
2009;"1286";"Totalt";0;460;10505;10965;0,0419516643866849;4,2
2010;"1286";"Totalt";0;468;10743;11211;0,0417447150120417;4,17
2011;"1286";"Totalt";0;476;10965;11441;0,0416047548291233;4,16
2012;"1286";"Totalt";0;472;10686;11158;0,0423014877218139;4,23
2013;"1286";"Totalt";0;474;10775;11249;0,0421370788514535;4,21
2014;"1286";"Totalt";0;445;10963;11408;0,039007713884993;3,9
2015;"1286";"Totalt";0;431;11163;11594;0,0371744005520097;3,72
2016;"1286";"Totalt";0;432;11433;11865;0,036409608091024;3,64
2017;"1286";"Totalt";0;413;11610;12023;0,0343508275804708;3,44
2018;"1286";"Totalt";0;419;11723;12142;0,0345083182342283;3,45
2019;"1286";"Totalt";0;437;11732;12169;0,0359109211931958;3,59
2020;"1286";"Totalt";0;418;11872;12290;0,0340113913751017;3,4
2021;"1286";"Totalt";0;436;12221;12657;0,034447341392115;3,44
2022;"1286";"Totalt";0;417;12614;13031;0,0320006139206508;3,2
2007;"1287";"Totalt";0;348;12557;12905;0,0269662921348315;2,7
2008;"1287";"Totalt";0;344;12479;12823;0,0268267956016533;2,68
2009;"1287";"Totalt";0;334;12235;12569;0,0265733152995465;2,66
2010;"1287";"Totalt";0;322;12525;12847;0,0250642173270024;2,51
2011;"1287";"Totalt";0;303;12308;12611;0,0240266434065498;2,4
2012;"1287";"Totalt";0;310;12188;12498;0,0248039686349816;2,48
2013;"1287";"Totalt";0;317;12045;12362;0,0256430998220353;2,56
2014;"1287";"Totalt";0;321;11984;12305;0,0260869565217391;2,61
2015;"1287";"Totalt";0;286;12175;12461;0,0229516090201428;2,3
2016;"1287";"Totalt";0;264;12103;12367;0,0213471335004447;2,13
2017;"1287";"Totalt";0;277;12205;12482;0,0221919564172408;2,22
2018;"1287";"Totalt";0;272;12241;12513;0,0217373931111644;2,17
2019;"1287";"Totalt";0;305;12313;12618;0,0241718180377239;2,42
2020;"1287";"Totalt";0;292;12168;12460;0,0234349919743178;2,34
2021;"1287";"Totalt";0;297;12467;12764;0,0232685678470699;2,33
2022;"1287";"Totalt";0;291;12597;12888;0,0225791433891993;2,26
2007;"1290";"Totalt";0;1187;32518;33705;0,0352173268061119;3,52
2008;"1290";"Totalt";0;1191;32106;33297;0,0357689881971349;3,58
2009;"1290";"Totalt";0;1125;31526;32651;0,0344552999908119;3,45
2010;"1290";"Totalt";0;1195;32541;33736;0,0354221010196822;3,54
2011;"1290";"Totalt";0;1176;33035;34211;0,0343749086551109;3,44
2012;"1290";"Totalt";0;1150;33394;34544;0,0332908754052802;3,33
2013;"1290";"Totalt";0;1129;32863;33992;0,0332136973405507;3,32
2014;"1290";"Totalt";0;1158;33484;34642;0,0334276311991225;3,34
2015;"1290";"Totalt";0;1262;33105;34367;0,0367212733145168;3,67
2016;"1290";"Totalt";0;1178;33845;35023;0,0336350398309682;3,36
2017;"1290";"Totalt";0;1152;34294;35446;0,03250014105964;3,25
2018;"1290";"Totalt";0;1201;34537;35738;0,0336056858246125;3,36
2019;"1290";"Totalt";0;1187;35311;36498;0,0325223299906844;3,25
2020;"1290";"Totalt";0;1130;35646;36776;0,0307265608005221;3,07
2021;"1290";"Totalt";0;1094;36360;37454;0,0292091632402414;2,92
2022;"1290";"Totalt";0;1179;37239;38418;0,0306887396532875;3,07
2007;"1291";"Totalt";0;266;6162;6428;0,0413814561294337;4,14
2008;"1291";"Totalt";0;268;6369;6637;0,0403796896188037;4,04
2009;"1291";"Totalt";0;271;5991;6262;0,0432769083359949;4,33
2010;"1291";"Totalt";0;273;6236;6509;0,0419419265632202;4,19
2011;"1291";"Totalt";0;256;6287;6543;0,0391257832798411;3,91
2012;"1291";"Totalt";0;259;6370;6629;0,0390707497360085;3,91
2013;"1291";"Totalt";0;262;6443;6705;0,0390753169276659;3,91
2014;"1291";"Totalt";0;266;6567;6833;0,0389287282306454;3,89
2015;"1291";"Totalt";0;240;6615;6855;0,0350109409190372;3,5
2016;"1291";"Totalt";0;229;6713;6942;0,032987611639297;3,3
2017;"1291";"Totalt";0;239;6765;7004;0,0341233580810965;3,41
2018;"1291";"Totalt";0;240;6679;6919;0,0346870935106229;3,47
2019;"1291";"Totalt";0;272;6512;6784;0,0400943396226415;4,01
2020;"1291";"Totalt";0;253;6500;6753;0,0374648304457278;3,75
2021;"1291";"Totalt";0;286;6634;6920;0,0413294797687861;4,13
2022;"1291";"Totalt";0;298;6780;7078;0,0421022887821418;4,21
2007;"1292";"Totalt";0;545;14641;15186;0,0358883181878046;3,59
2008;"1292";"Totalt";0;562;14671;15233;0,0368935862929167;3,69
2009;"1292";"Totalt";0;521;14370;14891;0,0349875763884225;3,5
2010;"1292";"Totalt";0;534;14931;15465;0,034529582929195;3,45
2011;"1292";"Totalt";0;492;15163;15655;0,0314276588949218;3,14
2012;"1292";"Totalt";0;487;15504;15991;0,0304546307297855;3,05
2013;"1292";"Totalt";0;478;15325;15803;0,0302474213756882;3,02
2014;"1292";"Totalt";0;487;15506;15993;0,0304508222347277;3,05
2015;"1292";"Totalt";0;486;15742;16228;0,0299482376140005;2,99
2016;"1292";"Totalt";0;522;16207;16729;0,0312032996592743;3,12
2017;"1292";"Totalt";0;499;16552;17051;0,0292651457392528;2,93
2018;"1292";"Totalt";0;502;16734;17236;0,0291250870271525;2,91
2019;"1292";"Totalt";0;581;16880;17461;0,0332741538285322;3,33
2020;"1292";"Totalt";0;526;16880;17406;0,0302194645524532;3,02
2021;"1292";"Totalt";0;567;17511;18078;0,0313640889478925;3,14
2022;"1292";"Totalt";0;593;18289;18882;0,031405571443703;3,14
2007;"1293";"Totalt";0;633;19713;20346;0,031111766440578;3,11
2008;"1293";"Totalt";0;607;19561;20168;0,0300971836572789;3,01
2009;"1293";"Totalt";0;570;18195;18765;0,0303756994404476;3,04
2010;"1293";"Totalt";0;548;18041;18589;0,0294797998816504;2,95
2011;"1293";"Totalt";0;498;17985;18483;0,0269436779743548;2,69
2012;"1293";"Totalt";0;462;18072;18534;0,024927160893493;2,49
2013;"1293";"Totalt";0;456;17991;18447;0,0247194665799317;2,47
2014;"1293";"Totalt";0;479;18041;18520;0,0258639308855292;2,59
2015;"1293";"Totalt";0;429;18440;18869;0,0227357040648683;2,27
2016;"1293";"Totalt";0;413;18793;19206;0,0215036967614287;2,15
2017;"1293";"Totalt";0;401;19216;19617;0,0204414538410562;2,04
2018;"1293";"Totalt";0;416;19259;19675;0,021143583227446;2,11
2019;"1293";"Totalt";0;461;19076;19537;0,0235962532630394;2,36
2020;"1293";"Totalt";0;404;18770;19174;0,0210701992281214;2,11
2021;"1293";"Totalt";0;390;19517;19907;0,0195910986085297;1,96
2022;"1293";"Totalt";0;396;19913;20309;0,0194987443990349;1,95
2007;"1315";"Totalt";0;94;4657;4751;0,0197853083561355;1,98
2008;"1315";"Totalt";0;84;4588;4672;0,0179794520547945;1,8
2009;"1315";"Totalt";0;78;4287;4365;0,0178694158075601;1,79
2010;"1315";"Totalt";0;80;4361;4441;0,0180139608196352;1,8
2011;"1315";"Totalt";0;83;4415;4498;0,0184526456202757;1,85
2012;"1315";"Totalt";0;74;4304;4378;0,0169026952946551;1,69
2013;"1315";"Totalt";0;72;4172;4244;0,0169651272384543;1,7
2014;"1315";"Totalt";0;75;4125;4200;0,0178571428571429;1,79
2015;"1315";"Totalt";0;72;4125;4197;0,0171551107934239;1,72
2016;"1315";"Totalt";0;59;4225;4284;0,0137721755368814;1,38
2017;"1315";"Totalt";0;66;4304;4370;0,0151029748283753;1,51
2018;"1315";"Totalt";0;69;4385;4454;0,0154916928603502;1,55
2019;"1315";"Totalt";0;72;4230;4302;0,0167364016736402;1,67
2020;"1315";"Totalt";0;61;4163;4224;0,0144412878787879;1,44
2021;"1315";"Totalt";0;65;4230;4295;0,0151338766006985;1,51
2022;"1315";"Totalt";0;65;4305;4370;0,0148741418764302;1,49
2007;"1380";"Totalt";0;2017;39309;41326;0,0488070464114601;4,88
2008;"1380";"Totalt";0;2001;39550;41551;0,048157685735602;4,82
2009;"1380";"Totalt";0;1920;38672;40592;0,0472999605833662;4,73
2010;"1380";"Totalt";0;2002;40057;42059;0,0475998002805583;4,76
2011;"1380";"Totalt";0;1969;40719;42688;0,0461253748125937;4,61
2012;"1380";"Totalt";0;1863;41332;43195;0,0431299918972103;4,31
2013;"1380";"Totalt";0;1714;41856;43570;0,0393389947211384;3,93
2014;"1380";"Totalt";0;1603;42435;44038;0,0364003814887143;3,64
2015;"1380";"Totalt";0;1560;42943;44503;0,0350538165966339;3,51
2016;"1380";"Totalt";0;1397;44278;45675;0,0305856595511768;3,06
2017;"1380";"Totalt";0;1321;44936;46257;0,0285578398945025;2,86
2018;"1380";"Totalt";0;1392;45750;47142;0,0295278095965381;2,95
2019;"1380";"Totalt";0;1414;46652;48066;0,0294178837431865;2,94
2020;"1380";"Totalt";0;1356;47057;48413;0,0280090058455374;2,8
2021;"1380";"Totalt";0;1344;48684;50028;0,0268649556248501;2,69
2022;"1380";"Totalt";0;1401;49726;51127;0,0274023510082735;2,74
2007;"1381";"Totalt";0;364;7444;7808;0,0466188524590164;4,66
2008;"1381";"Totalt";0;359;7497;7856;0,0456975560081466;4,57
2009;"1381";"Totalt";0;334;7026;7360;0,0453804347826087;4,54
2010;"1381";"Totalt";0;335;7233;7568;0,0442653276955603;4,43
2011;"1381";"Totalt";0;306;7421;7727;0,0396013976963893;3,96
2012;"1381";"Totalt";0;303;7431;7734;0,039177657098526;3,92
2013;"1381";"Totalt";0;291;7305;7596;0,0383096366508689;3,83
2014;"1381";"Totalt";0;282;7361;7643;0,0368965066073531;3,69
2015;"1381";"Totalt";0;276;7534;7810;0,0353393085787452;3,53
2016;"1381";"Totalt";0;272;7673;7945;0,034235368156073;3,42
2017;"1381";"Totalt";0;289;7685;7974;0,0362427890644595;3,62
2018;"1381";"Totalt";0;278;7829;8107;0,0342913531515974;3,43
2019;"1381";"Totalt";0;274;7819;8093;0,0338564191276412;3,39
2020;"1381";"Totalt";0;244;7855;8099;0,0301271761945919;3,01
2021;"1381";"Totalt";0;255;8141;8396;0,0303716055264412;3,04
2022;"1381";"Totalt";0;261;8303;8564;0,0304764128911723;3,05
2007;"1382";"Totalt";0;1533;15315;16848;0,0909900284900285;9,1
2008;"1382";"Totalt";0;1549;15374;16923;0,0915322342374284;9,15
2009;"1382";"Totalt";0;1600;15154;16754;0,0954995821893279;9,55
2010;"1382";"Totalt";0;1691;15329;17020;0,0993537015276146;9,94
2011;"1382";"Totalt";0;706;16578;17284;0,0408470261513539;4,08
2012;"1382";"Totalt";0;668;17228;17896;0,0373267769333929;3,73
2013;"1382";"Totalt";0;696;17511;18207;0,0382270555280936;3,82
2014;"1382";"Totalt";0;666;17715;18381;0,0362330667537131;3,62
2015;"1382";"Totalt";0;661;18065;18726;0,0352985154330877;3,53
2016;"1382";"Totalt";0;637;18464;19101;0,0333490393173132;3,33
2017;"1382";"Totalt";0;639;18781;19420;0,0329042224510814;3,29
2018;"1382";"Totalt";0;612;19031;19643;0,031156137046276;3,12
2019;"1382";"Totalt";0;636;19220;19856;0,032030620467365;3,2
2020;"1382";"Totalt";0;637;18714;19351;0,032918195442096;3,29
2021;"1382";"Totalt";0;634;19130;19764;0,0320785266140457;3,21
2022;"1382";"Totalt";0;730;19963;20693;0,0352776301164645;3,53
2007;"1383";"Totalt";0;1158;23441;24599;0,0470750843530225;4,71
2008;"1383";"Totalt";0;1195;23686;24881;0,0480286162131747;4,8
2009;"1383";"Totalt";0;1129;23477;24606;0,0458831179387141;4,59
2010;"1383";"Totalt";0;1185;24016;25201;0,0470219435736677;4,7
2011;"1383";"Totalt";0;1230;24811;26041;0,0472332091701548;4,72
2012;"1383";"Totalt";0;1245;25118;26363;0,0472252778515343;4,72
2013;"1383";"Totalt";0;1243;25375;26618;0,0466977233451048;4,67
2014;"1383";"Totalt";0;1239;25847;27086;0,045743188362992;4,57
2015;"1383";"Totalt";0;1208;26831;28039;0,0430828488890474;4,31
2016;"1383";"Totalt";0;1187;27133;28320;0,0419138418079096;4,19
2017;"1383";"Totalt";0;1197;27451;28648;0,0417830215023736;4,18
2018;"1383";"Totalt";0;1245;27400;28645;0,0434630825624018;4,35
2019;"1383";"Totalt";0;1225;27866;29091;0,0421092434086143;4,21
2020;"1383";"Totalt";0;1119;28130;29249;0,0382577182125885;3,83
2021;"1383";"Totalt";0;1098;28807;29905;0,0367162681825782;3,67
2022;"1383";"Totalt";0;1083;29437;30520;0,0354849279161206;3,55
2007;"1384";"Totalt";0;1460;18952;20412;0,0715265530080345;7,15
2008;"1384";"Totalt";0;1472;19045;20517;0,0717453818784423;7,17
2009;"1384";"Totalt";0;1427;18526;19953;0,0715180674585275;7,15
2010;"1384";"Totalt";0;1389;19439;20828;0,066689072402535;6,67
2011;"1384";"Totalt";0;1323;20162;21485;0,0615778450081452;6,16
2012;"1384";"Totalt";0;1368;20697;22065;0,0619986403806934;6,2
2013;"1384";"Totalt";0;1349;20817;22166;0,0608589732022016;6,09
2014;"1384";"Totalt";0;1367;20837;22204;0,0615654836966312;6,16
2015;"1384";"Totalt";0;1343;21081;22424;0,0598911880128434;5,99
2016;"1384";"Totalt";0;1365;21790;23155;0,0589505506370114;5,9
2017;"1384";"Totalt";0;1322;22162;23484;0,0562936467382047;5,63
2018;"1384";"Totalt";0;1313;22246;23559;0,0557324164862685;5,57
2019;"1384";"Totalt";0;1372;22493;23865;0,0574900481877226;5,75
2020;"1384";"Totalt";0;1231;22581;23812;0,0516966235511507;5,17
2021;"1384";"Totalt";0;1230;23165;24395;0,0504201680672269;5,04
2022;"1384";"Totalt";0;1319;24071;25390;0,0519495864513588;5,19
2007;"1401";"Totalt";0;590;11325;11915;0,0495174150230802;4,95
2008;"1401";"Totalt";0;550;11950;12500;0,044;4,4
2009;"1401";"Totalt";0;568;11448;12016;0,0472703062583222;4,73
2010;"1401";"Totalt";0;728;11692;12420;0,0586151368760064;5,86
2011;"1401";"Totalt";0;687;11873;12560;0,0546974522292994;5,47
2012;"1401";"Totalt";0;574;12037;12611;0,045515819522639;4,55
2013;"1401";"Totalt";0;611;12172;12783;0,0477978565282015;4,78
2014;"1401";"Totalt";0;635;12366;13001;0,0488423967387124;4,88
2015;"1401";"Totalt";0;614;12847;13461;0,0456132531015526;4,56
2016;"1401";"Totalt";0;639;13966;14605;0,0437521396781924;4,38
2017;"1401";"Totalt";0;630;14490;15120;0,0416666666666667;4,17
2018;"1401";"Totalt";0;610;14762;15372;0,0396825396825397;3,97
2019;"1401";"Totalt";0;528;15065;15593;0,0338613480407875;3,39
2020;"1401";"Totalt";0;440;14426;14866;0,02959773980896;2,96
2021;"1401";"Totalt";0;390;15244;15634;0,0249456313163618;2,49
2022;"1401";"Totalt";0;385;15880;16265;0,0236704580387335;2,37
2007;"1402";"Totalt";0;451;9548;9999;0,0451045104510451;4,51
2008;"1402";"Totalt";0;575;9630;10205;0,0563449289563939;5,63
2009;"1402";"Totalt";0;581;9303;9884;0,0587818696883853;5,88
2010;"1402";"Totalt";0;648;9580;10228;0,0633554947203754;6,34
2011;"1402";"Totalt";0;636;9821;10457;0,0608205030123362;6,08
2012;"1402";"Totalt";0;660;10142;10802;0,0610997963340122;6,11
2013;"1402";"Totalt";0;680;10247;10927;0,0622311704951039;6,22
2014;"1402";"Totalt";0;712;10066;10778;0,0660604935980701;6,61
2015;"1402";"Totalt";0;747;10246;10993;0,067952333303011;6,8
2016;"1402";"Totalt";0;760;10646;11406;0,0666315974048746;6,66
2017;"1402";"Totalt";0;786;10699;11485;0,0684370918589464;6,84
2018;"1402";"Totalt";0;731;10789;11520;0,0634548611111111;6,35
2019;"1402";"Totalt";0;668;11024;11692;0,0571330824495381;5,71
2020;"1402";"Totalt";0;612;10844;11456;0,0534217877094972;5,34
2021;"1402";"Totalt";0;614;11013;11627;0,0528081190332846;5,28
2022;"1402";"Totalt";0;649;11433;12082;0,0537162721403741;5,37
2007;"1407";"Totalt";0;63;2594;2657;0,0237109522017313;2,37
2008;"1407";"Totalt";0;72;2586;2658;0,0270880361173815;2,71
2009;"1407";"Totalt";0;59;2742;2801;0,0210639057479472;2,11
2010;"1407";"Totalt";0;62;2886;2948;0,0210312075983718;2,1
2011;"1407";"Totalt";0;72;2946;3018;0,0238568588469185;2,39
2012;"1407";"Totalt";0;66;3031;3097;0,0213109460768486;2,13
2013;"1407";"Totalt";0;81;3069;3150;0,0257142857142857;2,57
2014;"1407";"Totalt";0;81;3156;3237;0,0250231696014829;2,5
2015;"1407";"Totalt";0;88;3213;3301;0,0266585883065738;2,67
2016;"1407";"Totalt";0;84;3223;3307;0,0254006652555186;2,54
2017;"1407";"Totalt";0;83;3230;3313;0,0250528222155146;2,51
2018;"1407";"Totalt";0;79;3167;3246;0,0243376463339495;2,43
2019;"1407";"Totalt";0;89;3179;3268;0,027233782129743;2,72
2020;"1407";"Totalt";0;81;3125;3206;0,0252651278852152;2,53
2021;"1407";"Totalt";0;84;3166;3250;0,0258461538461538;2,58
2022;"1407";"Totalt";0;82;3246;3328;0,0246394230769231;2,46
2007;"1415";"Totalt";0;322;9878;10200;0,0315686274509804;3,16
2008;"1415";"Totalt";0;309;10168;10477;0,0294931755273456;2,95
2009;"1415";"Totalt";0;289;10094;10383;0,0278339593566407;2,78
2010;"1415";"Totalt";0;308;10556;10864;0,0283505154639175;2,84
2011;"1415";"Totalt";0;332;10840;11172;0,0297171500179019;2,97
2012;"1415";"Totalt";0;299;10652;10951;0,027303442607981;2,73
2013;"1415";"Totalt";0;313;10784;11097;0,0282058213931693;2,82
2014;"1415";"Totalt";0;295;10894;11189;0,026365180087586;2,64
2015;"1415";"Totalt";0;343;11201;11544;0,0297124047124047;2,97
2016;"1415";"Totalt";0;347;11582;11929;0,0290887752535837;2,91
2017;"1415";"Totalt";0;351;11687;12038;0,0291576673866091;2,92
2018;"1415";"Totalt";0;331;11841;12172;0,0271935589878409;2,72
2019;"1415";"Totalt";0;314;11797;12111;0,0259268433655355;2,59
2020;"1415";"Totalt";0;264;11560;11824;0,0223274695534506;2,23
2021;"1415";"Totalt";0;238;11800;12038;0,019770726034225;1,98
2022;"1415";"Totalt";0;256;12147;12403;0,0206401677013626;2,06
2007;"1419";"Totalt";0;102;4114;4216;0,0241935483870968;2,42
2008;"1419";"Totalt";0;93;4075;4168;0,0223128598848369;2,23
2009;"1419";"Totalt";0;97;3921;4018;0,0241413638626182;2,41
2010;"1419";"Totalt";0;100;4226;4326;0,0231160425335183;2,31
2011;"1419";"Totalt";0;99;4168;4267;0,0232013123974689;2,32
2012;"1419";"Totalt";0;101;4297;4398;0,0229649840836744;2,3
2013;"1419";"Totalt";0;103;4279;4382;0,0235052487448654;2,35
2014;"1419";"Totalt";0;99;4382;4481;0,0220932827493863;2,21
2015;"1419";"Totalt";0;105;4249;4354;0,0241157556270096;2,41
2016;"1419";"Totalt";0;97;4523;4620;0,020995670995671;2,1
2017;"1419";"Totalt";0;96;4618;4714;0,0203648705982181;2,04
2018;"1419";"Totalt";0;91;4609;4700;0,0193617021276596;1,94
2019;"1419";"Totalt";0;99;4485;4584;0,0215968586387435;2,16
2020;"1419";"Totalt";0;81;4469;4550;0,0178021978021978;1,78
2021;"1419";"Totalt";0;82;4520;4602;0,0178183398522382;1,78
2022;"1419";"Totalt";0;93;4386;4479;0,0207635632953784;2,08
2007;"1421";"Totalt";0;66;4833;4899;0,0134721371708512;1,35
2008;"1421";"Totalt";0;59;4785;4844;0,0121800165152766;1,22
2009;"1421";"Totalt";0;56;4506;4562;0,0122753178430513;1,23
2010;"1421";"Totalt";0;63;4569;4632;0,0136010362694301;1,36
2011;"1421";"Totalt";0;70;4585;4655;0,0150375939849624;1,5
2012;"1421";"Totalt";0;66;4421;4487;0,0147091597949632;1,47
2013;"1421";"Totalt";0;51;4282;4333;0,0117701361643203;1,18
2014;"1421";"Totalt";0;56;4217;4273;0,0131055464544816;1,31
2015;"1421";"Totalt";0;61;4222;4283;0,014242353490544;1,42
2016;"1421";"Totalt";0;62;4266;4328;0,0143253234750462;1,43
2017;"1421";"Totalt";0;65;4349;4414;0,0147258722247395;1,47
2018;"1421";"Totalt";0;59;4305;4364;0,0135197066911091;1,35
2019;"1421";"Totalt";0;72;4323;4395;0,016382252559727;1,64
2020;"1421";"Totalt";0;76;4232;4308;0,0176415970287837;1,76
2021;"1421";"Totalt";0;76;4311;4387;0,0173239115568726;1,73
2022;"1421";"Totalt";0;74;4457;4531;0,0163319355550651;1,63
2007;"1427";"Totalt";0;57;3627;3684;0,0154723127035831;1,55
2008;"1427";"Totalt";0;61;3663;3724;0,0163802363050483;1,64
2009;"1427";"Totalt";0;65;3605;3670;0,0177111716621253;1,77
2010;"1427";"Totalt";0;68;3604;3672;0,0185185185185185;1,85
2011;"1427";"Totalt";0;72;3626;3698;0,0194699837750135;1,95
2012;"1427";"Totalt";0;86;3627;3713;0,0231618637220576;2,32
2013;"1427";"Totalt";0;87;3669;3756;0,0231629392971246;2,32
2014;"1427";"Totalt";0;78;3630;3708;0,0210355987055016;2,1
2015;"1427";"Totalt";0;70;3667;3737;0,0187316028900187;1,87
2016;"1427";"Totalt";0;72;3841;3913;0,0184002044467161;1,84
2017;"1427";"Totalt";0;84;3817;3901;0,0215329402717252;2,15
2018;"1427";"Totalt";0;88;3744;3832;0,022964509394572;2,3
2019;"1427";"Totalt";0;73;3680;3753;0,019451105782041;1,95
2020;"1427";"Totalt";0;61;3617;3678;0,0165851005981512;1,66
2021;"1427";"Totalt";0;69;3700;3769;0,0183072433006102;1,83
2022;"1427";"Totalt";0;64;3725;3789;0,0168910002639219;1,69
2007;"1430";"Totalt";0;140;3350;3490;0,0401146131805158;4,01
2008;"1430";"Totalt";0;148;3309;3457;0,0428116864333237;4,28
2009;"1430";"Totalt";0;126;3156;3282;0,0383912248628885;3,84
2010;"1430";"Totalt";0;128;3315;3443;0,0371768806273599;3,72
2011;"1430";"Totalt";0;137;3321;3458;0,0396182764603817;3,96
2012;"1430";"Totalt";0;121;3421;3542;0,0341614906832298;3,42
2013;"1430";"Totalt";0;125;3238;3363;0,0371691941718704;3,72
2014;"1430";"Totalt";0;128;3319;3447;0,0371337394836089;3,71
2015;"1430";"Totalt";0;136;3303;3439;0,0395463797615586;3,95
2016;"1430";"Totalt";0;129;3517;3646;0,0353812397147559;3,54
2017;"1430";"Totalt";0;132;3420;3552;0,0371621621621622;3,72
2018;"1430";"Totalt";0;134;3405;3539;0,0378638033342752;3,79
2019;"1430";"Totalt";0;145;3364;3509;0,0413223140495868;4,13
2020;"1430";"Totalt";0;128;3412;3540;0,0361581920903955;3,62
2021;"1430";"Totalt";0;147;3442;3589;0,0409584842574533;4,1
2022;"1430";"Totalt";0;166;3479;3645;0,0455418381344307;4,55
2007;"1435";"Totalt";0;252;4458;4710;0,0535031847133758;5,35
2008;"1435";"Totalt";0;231;4349;4580;0,0504366812227074;5,04
2009;"1435";"Totalt";0;245;4025;4270;0,0573770491803279;5,74
2010;"1435";"Totalt";0;172;4172;4344;0,0395948434622468;3,96
2011;"1435";"Totalt";0;155;4170;4325;0,0358381502890173;3,58
2012;"1435";"Totalt";0;184;4366;4550;0,0404395604395604;4,04
2013;"1435";"Totalt";0;173;4510;4683;0,0369421311125347;3,69
2014;"1435";"Totalt";0;212;4545;4757;0,0445659028799664;4,46
2015;"1435";"Totalt";0;251;4669;4920;0,0510162601626016;5,1
2016;"1435";"Totalt";0;251;4802;5053;0,0496734613101128;4,97
2017;"1435";"Totalt";0;235;4723;4958;0,0473981444130698;4,74
2018;"1435";"Totalt";0;222;4780;5002;0,0443822471011595;4,44
2019;"1435";"Totalt";0;221;4622;4843;0,0456328721866612;4,56
2020;"1435";"Totalt";0;209;4483;4692;0,0445439045183291;4,45
2021;"1435";"Totalt";0;196;4675;4871;0,0402381441182509;4,02
2022;"1435";"Totalt";0;199;4869;5068;0,0392659826361484;3,93
2007;"1438";"Totalt";0;53;1712;1765;0,030028328611898;3
2008;"1438";"Totalt";0;27;1840;1867;0,0144617032672737;1,45
2009;"1438";"Totalt";0;32;1759;1791;0,0178671133445003;1,79
2010;"1438";"Totalt";0;32;1820;1852;0,0172786177105832;1,73
2011;"1438";"Totalt";0;41;1772;1813;0,0226144511858798;2,26
2012;"1438";"Totalt";0;21;1790;1811;0,0115958034235229;1,16
2013;"1438";"Totalt";0;20;1829;1849;0,0108166576527853;1,08
2014;"1438";"Totalt";0;22;1815;1837;0,0119760479041916;1,2
2015;"1438";"Totalt";0;20;1803;1823;0,0109709270433352;1,1
2016;"1438";"Totalt";0;24;1815;1839;0,0130505709624796;1,31
2017;"1438";"Totalt";0;22;1836;1858;0,0118406889128095;1,18
2018;"1438";"Totalt";0;23;1984;2007;0,0114598903836572;1,15
2019;"1438";"Totalt";0;21;2012;2033;0,0103295622233153;1,03
2020;"1438";"Totalt";0;20;2013;2033;0,00983767830791933;0,98
2021;"1438";"Totalt";0;19;1987;2006;0,0094715852442672;0,95
2022;"1438";"Totalt";0;16;1952;1968;0,00813008130081301;0,81
2007;"1439";"Totalt";0;13;2016;2029;0,00640709709216363;0,64
2008;"1439";"Totalt";0;10;1940;1950;0,00512820512820513;0,51
2009;"1439";"Totalt";0;17;1785;1802;0,00943396226415094;0,94
2010;"1439";"Totalt";0;22;1970;1992;0,0110441767068273;1,1
2011;"1439";"Totalt";0;25;1894;1919;0,0130276185513288;1,3
2012;"1439";"Totalt";0;26;1800;1826;0,0142387732749179;1,42
2013;"1439";"Totalt";0;25;1793;1818;0,0137513751375138;1,38
2014;"1439";"Totalt";0;11;1847;1858;0,00592034445640474;0,59
2015;"1439";"Totalt";0;11;1922;1933;0,00569063631660631;0,57
2016;"1439";"Totalt";0;11;2017;2028;0,00542406311637081;0,54
2017;"1439";"Totalt";0;9;2164;2173;0,00414173953060285;0,41
2018;"1439";"Totalt";0;12;2085;2097;0,00572246065808298;0,57
2019;"1439";"Totalt";0;11;2053;2064;0,00532945736434109;0,53
2020;"1439";"Totalt";0;9;1980;1989;0,00452488687782805;0,45
2021;"1439";"Totalt";0;9;1982;1991;0,00452034153691612;0,45
2022;"1439";"Totalt";0;8;2065;2073;0,00385914134105162;0,39
2007;"1440";"Totalt";0;118;6147;6265;0,0188347964884278;1,88
2008;"1440";"Totalt";0;122;6019;6141;0,0198664712587526;1,99
2009;"1440";"Totalt";0;109;5845;5954;0,0183070204904266;1,83
2010;"1440";"Totalt";0;121;5911;6032;0,0200596816976127;2,01
2011;"1440";"Totalt";0;124;6105;6229;0,0199068871407931;1,99
2012;"1440";"Totalt";0;153;6204;6357;0,024067956583294;2,41
2013;"1440";"Totalt";0;189;6221;6410;0,0294851794071763;2,95
2014;"1440";"Totalt";0;193;6161;6354;0,0303745672017627;3,04
2015;"1440";"Totalt";0;187;6360;6547;0,0285627004734993;2,86
2016;"1440";"Totalt";0;168;6415;6583;0,0255202795078232;2,55
2017;"1440";"Totalt";0;166;6841;7007;0,0236905951191665;2,37
2018;"1440";"Totalt";0;150;6927;7077;0,0211954217888936;2,12
2019;"1440";"Totalt";0;170;6883;7053;0,0241032184885864;2,41
2020;"1440";"Totalt";0;144;7020;7164;0,0201005025125628;2,01
2021;"1440";"Totalt";0;153;7318;7471;0,0204791861865881;2,05
2022;"1440";"Totalt";0;174;7666;7840;0,0221938775510204;2,22
2007;"1441";"Totalt";0;337;8005;8342;0,0403979860944618;4,04
2008;"1441";"Totalt";0;353;8170;8523;0,0414173413117447;4,14
2009;"1441";"Totalt";0;348;7740;8088;0,043026706231454;4,3
2010;"1441";"Totalt";0;356;8023;8379;0,0424871703067192;4,25
2011;"1441";"Totalt";0;344;8162;8506;0,0404420409122972;4,04
2012;"1441";"Totalt";0;344;8302;8646;0,0397871848253528;3,98
2013;"1441";"Totalt";0;337;8303;8640;0,0390046296296296;3,9
2014;"1441";"Totalt";0;323;8862;9185;0,0351660315732172;3,52
2015;"1441";"Totalt";0;336;9158;9494;0,0353907731198652;3,54
2016;"1441";"Totalt";0;332;9297;9629;0,0344791774846817;3,45
2017;"1441";"Totalt";0;347;9219;9566;0,0362743048296049;3,63
2018;"1441";"Totalt";0;338;9216;9554;0,0353778522084991;3,54
2019;"1441";"Totalt";0;336;9430;9766;0,0344050788449724;3,44
2020;"1441";"Totalt";0;349;9243;9592;0,0363844870725605;3,64
2021;"1441";"Totalt";0;361;9640;10001;0,0360963903609639;3,61
2022;"1441";"Totalt";0;397;10108;10505;0,0377915278438839;3,78
2007;"1442";"Totalt";0;105;4596;4701;0,0223356732610083;2,23
2008;"1442";"Totalt";0;92;4476;4568;0,0201401050788091;2,01
2009;"1442";"Totalt";0;85;4132;4217;0,0201565093668485;2,02
2010;"1442";"Totalt";0;71;4101;4172;0,0170182166826462;1,7
2011;"1442";"Totalt";0;84;4127;4211;0,0199477558774638;1,99
2012;"1442";"Totalt";0;72;4149;4221;0,0170575692963753;1,71
2013;"1442";"Totalt";0;73;4158;4231;0,0172536043488537;1,73
2014;"1442";"Totalt";0;62;4188;4250;0,0145882352941176;1,46
2015;"1442";"Totalt";0;73;4339;4412;0,0165457842248413;1,65
2016;"1442";"Totalt";0;73;4465;4538;0,0160863816659321;1,61
2017;"1442";"Totalt";0;67;4617;4684;0,0143040136635354;1,43
2018;"1442";"Totalt";0;46;4638;4684;0,00982066609735269;0,98
2019;"1442";"Totalt";0;59;4871;4930;0,0119675456389452;1,2
2020;"1442";"Totalt";0;42;4855;4897;0,00857667959975495;0,86
2021;"1442";"Totalt";0;44;5096;5140;0,00856031128404669;0,86
2022;"1442";"Totalt";0;43;5497;5540;0,00776173285198556;0,78
2007;"1443";"Totalt";0;68;2199;2267;0,0299955888839877;3
2008;"1443";"Totalt";0;65;2247;2312;0,0281141868512111;2,81
2009;"1443";"Totalt";0;62;1923;1985;0,0312342569269521;3,12
2010;"1443";"Totalt";0;62;2074;2136;0,0290262172284644;2,9
2011;"1443";"Totalt";0;100;2107;2207;0,0453103760761214;4,53
2012;"1443";"Totalt";0;113;2174;2287;0,0494097070397901;4,94
2013;"1443";"Totalt";0;104;2207;2311;0,045002163565556;4,5
2014;"1443";"Totalt";0;108;2217;2325;0,0464516129032258;4,65
2015;"1443";"Totalt";0;105;2249;2354;0,0446049277824979;4,46
2016;"1443";"Totalt";0;111;2322;2433;0,0456226880394575;4,56
2017;"1443";"Totalt";0;111;2345;2456;0,0451954397394137;4,52
2018;"1443";"Totalt";0;118;2364;2482;0,0475423045930701;4,75
2019;"1443";"Totalt";0;104;2338;2442;0,0425880425880426;4,26
2020;"1443";"Totalt";0;114;2305;2419;0,0471269119470856;4,71
2021;"1443";"Totalt";0;111;2354;2465;0,0450304259634888;4,5
2022;"1443";"Totalt";0;111;2415;2526;0,0439429928741093;4,39
2007;"1444";"Totalt";0;18;1476;1494;0,0120481927710843;1,2
2008;"1444";"Totalt";0;25;1433;1458;0,0171467764060357;1,71
2009;"1444";"Totalt";0;21;1404;1425;0,0147368421052632;1,47
2010;"1444";"Totalt";0;26;1447;1473;0,0176510522742702;1,77
2011;"1444";"Totalt";0;20;1442;1462;0,0136798905608755;1,37
2012;"1444";"Totalt";0;15;1506;1521;0,00986193293885602;0,99
2013;"1444";"Totalt";0;14;1449;1463;0,00956937799043062;0,96
2014;"1444";"Totalt";0;18;1433;1451;0,0124052377670572;1,24
2015;"1444";"Totalt";0;21;1449;1470;0,0142857142857143;1,43
2016;"1444";"Totalt";0;27;1461;1488;0,0181451612903226;1,81
2017;"1444";"Totalt";0;28;1509;1537;0,0182173064411191;1,82
2018;"1444";"Totalt";0;31;1505;1536;0,0201822916666667;2,02
2019;"1444";"Totalt";0;25;1549;1574;0,0158831003811944;1,59
2020;"1444";"Totalt";0;40;1532;1572;0,0254452926208651;2,54
2021;"1444";"Totalt";0;25;1620;1645;0,0151975683890578;1,52
2022;"1444";"Totalt";0;24;1754;1778;0,0134983127109111;1,35
2007;"1445";"Totalt";0;111;1754;1865;0,0595174262734584;5,95
2008;"1445";"Totalt";0;113;1781;1894;0,059662090813094;5,97
2009;"1445";"Totalt";0;101;1700;1801;0,0560799555802332;5,61
2010;"1445";"Totalt";0;93;1723;1816;0,0512114537444934;5,12
2011;"1445";"Totalt";0;102;1849;1951;0,0522808815991799;5,23
2012;"1445";"Totalt";0;94;1840;1934;0,0486039296794209;4,86
2013;"1445";"Totalt";0;91;1819;1910;0,0476439790575916;4,76
2014;"1445";"Totalt";0;80;1859;1939;0,0412583806085611;4,13
2015;"1445";"Totalt";0;76;1855;1931;0,0393578456758156;3,94
2016;"1445";"Totalt";0;75;1896;1971;0,0380517503805175;3,81
2017;"1445";"Totalt";0;74;1970;2044;0,0362035225048924;3,62
2018;"1445";"Totalt";0;67;1968;2035;0,0329238329238329;3,29
2019;"1445";"Totalt";0;60;1959;2019;0,0297176820208024;2,97
2020;"1445";"Totalt";0;69;1827;1896;0,0363924050632911;3,64
2021;"1445";"Totalt";0;61;1872;1933;0,0315571650284532;3,16
2022;"1445";"Totalt";0;63;2014;2077;0,0303322099181512;3,03
2007;"1446";"Totalt";0;44;2640;2684;0,0163934426229508;1,64
2008;"1446";"Totalt";0;50;2720;2770;0,0180505415162455;1,81
2009;"1446";"Totalt";0;44;2606;2650;0,0166037735849057;1,66
2010;"1446";"Totalt";0;47;2687;2734;0,0171909290416971;1,72
2011;"1446";"Totalt";0;46;2843;2889;0,0159224645205954;1,59
2012;"1446";"Totalt";0;50;2833;2883;0,017343045438779;1,73
2013;"1446";"Totalt";0;46;2943;2989;0,015389762462362;1,54
2014;"1446";"Totalt";0;44;2967;3011;0,0146130853537031;1,46
2015;"1446";"Totalt";0;37;2820;2857;0,0129506475323766;1,3
2016;"1446";"Totalt";0;43;2853;2896;0,0148480662983425;1,48
2017;"1446";"Totalt";0;56;2835;2891;0,0193704600484262;1,94
2018;"1446";"Totalt";0;48;2773;2821;0,0170152428216944;1,7
2019;"1446";"Totalt";0;53;2696;2749;0,0192797380865769;1,93
2020;"1446";"Totalt";0;52;2749;2801;0,0185647982863263;1,86
2021;"1446";"Totalt";0;58;2621;2679;0,0216498693542367;2,16
2022;"1446";"Totalt";0;57;2816;2873;0,0198398886181692;1,98
2007;"1447";"Totalt";0;14;1819;1833;0,00763775231860338;0,76
2008;"1447";"Totalt";0;13;1738;1751;0,00742432895488292;0,74
2009;"1447";"Totalt";0;10;1721;1731;0,00577700751010976;0,58
2010;"1447";"Totalt";0;22;1746;1768;0,0124434389140271;1,24
2011;"1447";"Totalt";0;25;1753;1778;0,0140607424071991;1,41
2012;"1447";"Totalt";0;14;1758;1772;0,00790067720090293;0,79
2013;"1447";"Totalt";0;18;1698;1716;0,0104895104895105;1,05
2014;"1447";"Totalt";0;23;1673;1696;0,013561320754717;1,36
2015;"1447";"Totalt";0;18;1679;1697;0,0106069534472599;1,06
2016;"1447";"Totalt";0;20;1762;1782;0,0112233445566779;1,12
2017;"1447";"Totalt";0;19;1721;1740;0,0109195402298851;1,09
2018;"1447";"Totalt";0;17;1746;1763;0,00964265456608054;0,96
2019;"1447";"Totalt";0;16;1745;1761;0,00908574673480977;0,91
2020;"1447";"Totalt";0;13;1494;1507;0,0086264100862641;0,86
2021;"1447";"Totalt";0;15;1526;1541;0,00973393900064893;0,97
2022;"1447";"Totalt";0;15;1603;1618;0,00927070457354759;0,93
2007;"1452";"Totalt";0;256;5555;5811;0,0440543796248494;4,41
2008;"1452";"Totalt";0;247;5556;5803;0,0425641909357229;4,26
2009;"1452";"Totalt";0;230;5182;5412;0,0424981522542498;4,25
2010;"1452";"Totalt";0;239;5278;5517;0,0433206452782309;4,33
2011;"1452";"Totalt";0;251;5342;5593;0,0448775254782764;4,49
2012;"1452";"Totalt";0;196;5396;5592;0,0350500715307582;3,51
2013;"1452";"Totalt";0;186;5384;5570;0,0333931777378815;3,34
2014;"1452";"Totalt";0;178;5333;5511;0,0322990382870622;3,23
2015;"1452";"Totalt";0;180;5327;5507;0,0326856727800981;3,27
2016;"1452";"Totalt";0;167;5403;5570;0,0299820466786355;3
2017;"1452";"Totalt";0;159;5492;5651;0,0281366129888515;2,81
2018;"1452";"Totalt";0;155;5532;5687;0,0272551433093019;2,73
2019;"1452";"Totalt";0;163;5615;5778;0,0282104534440983;2,82
2020;"1452";"Totalt";0;161;5514;5675;0,0283700440528634;2,84
2021;"1452";"Totalt";0;165;5483;5648;0,02921388101983;2,92
2022;"1452";"Totalt";0;187;5614;5801;0,0322358214101017;3,22
2007;"1460";"Totalt";0;115;3689;3804;0,0302313354363828;3,02
2008;"1460";"Totalt";0;126;3577;3703;0,0340264650283554;3,4
2009;"1460";"Totalt";0;126;3510;3636;0,0346534653465347;3,47
2010;"1460";"Totalt";0;117;3668;3785;0,0309114927344782;3,09
2011;"1460";"Totalt";0;125;3745;3870;0,0322997416020672;3,23
2012;"1460";"Totalt";0;113;3642;3755;0,0300932090545939;3,01
2013;"1460";"Totalt";0;121;3675;3796;0,0318756585879874;3,19
2014;"1460";"Totalt";0;111;3684;3795;0,0292490118577075;2,92
2015;"1460";"Totalt";0;115;3674;3789;0,0303510160992346;3,04
2016;"1460";"Totalt";0;113;3689;3802;0,0297211993687533;2,97
2017;"1460";"Totalt";0;110;3697;3807;0,0288941423693197;2,89
2018;"1460";"Totalt";0;116;3779;3895;0,0297817715019255;2,98
2019;"1460";"Totalt";0;129;3769;3898;0,0330938943047717;3,31
2020;"1460";"Totalt";0;119;3656;3775;0,031523178807947;3,15
2021;"1460";"Totalt";0;118;3717;3835;0,0307692307692308;3,08
2022;"1460";"Totalt";0;117;3780;3897;0,0300230946882217;3
2007;"1461";"Totalt";0;64;3013;3077;0,0207994800129997;2,08
2008;"1461";"Totalt";0;56;3023;3079;0,0181877232867814;1,82
2009;"1461";"Totalt";0;59;2749;2808;0,021011396011396;2,1
2010;"1461";"Totalt";0;66;2656;2722;0,0242468772961058;2,42
2011;"1461";"Totalt";0;99;2664;2763;0,0358306188925081;3,58
2012;"1461";"Totalt";0;60;2764;2824;0,0212464589235127;2,12
2013;"1461";"Totalt";0;64;2690;2754;0,0232389251997095;2,32
2014;"1461";"Totalt";0;86;2662;2748;0,0312954876273654;3,13
2015;"1461";"Totalt";0;81;2676;2757;0,029379760609358;2,94
2016;"1461";"Totalt";0;82;2838;2920;0,0280821917808219;2,81
2017;"1461";"Totalt";0;84;2900;2984;0,0281501340482574;2,82
2018;"1461";"Totalt";0;83;2909;2992;0,0277406417112299;2,77
2019;"1461";"Totalt";0;70;2923;2993;0,0233879051119278;2,34
2020;"1461";"Totalt";0;71;2880;2951;0,0240596407997289;2,41
2021;"1461";"Totalt";0;70;2922;2992;0,0233957219251337;2,34
2022;"1461";"Totalt";0;78;2938;3016;0,0258620689655172;2,59
2007;"1462";"Totalt";0;41;3760;3801;0,0107866350960274;1,08
2008;"1462";"Totalt";0;48;3720;3768;0,0127388535031847;1,27
2009;"1462";"Totalt";0;37;3613;3650;0,0101369863013699;1,01
2010;"1462";"Totalt";0;57;3672;3729;0,0152855993563958;1,53
2011;"1462";"Totalt";0;58;3627;3685;0,0157394843962008;1,57
2012;"1462";"Totalt";0;54;3578;3632;0,0148678414096916;1,49
2013;"1462";"Totalt";0;56;3582;3638;0,0153930731170973;1,54
2014;"1462";"Totalt";0;45;3549;3594;0,0125208681135225;1,25
2015;"1462";"Totalt";0;52;3652;3704;0,0140388768898488;1,4
2016;"1462";"Totalt";0;49;3748;3797;0,0129049249407427;1,29
2017;"1462";"Totalt";0;45;3796;3841;0,0117156990367092;1,17
2018;"1462";"Totalt";0;44;3766;3810;0,0115485564304462;1,15
2019;"1462";"Totalt";0;52;3685;3737;0,0139149050040139;1,39
2020;"1462";"Totalt";0;49;3599;3648;0,0134320175438596;1,34
2021;"1462";"Totalt";0;50;3571;3621;0,0138083402375035;1,38
2022;"1462";"Totalt";0;46;3669;3715;0,0123822341857335;1,24
2007;"1463";"Totalt";0;873;10275;11148;0,0783100107642627;7,83
2008;"1463";"Totalt";0;531;10585;11116;0,0477689816480748;4,78
2009;"1463";"Totalt";0;511;9954;10465;0,0488294314381271;4,88
2010;"1463";"Totalt";0;508;10058;10566;0,0480787431383684;4,81
2011;"1463";"Totalt";0;454;10296;10750;0,0422325581395349;4,22
2012;"1463";"Totalt";0;441;10360;10801;0,0408295528191834;4,08
2013;"1463";"Totalt";0;437;10195;10632;0,0411023325808879;4,11
2014;"1463";"Totalt";0;425;10201;10626;0,0399962356484096;4
2015;"1463";"Totalt";0;411;10221;10632;0,0386568848758465;3,87
2016;"1463";"Totalt";0;398;10319;10717;0,0371372585611645;3,71
2017;"1463";"Totalt";0;402;10213;10615;0,0378709373528026;3,79
2018;"1463";"Totalt";0;386;10234;10620;0,036346516007533;3,63
2019;"1463";"Totalt";0;368;10303;10671;0,0344859900665355;3,45
2020;"1463";"Totalt";0;343;10071;10414;0,032936431726522;3,29
2021;"1463";"Totalt";0;354;10174;10528;0,0336246200607903;3,36
2022;"1463";"Totalt";0;363;10818;11181;0,0324657901797692;3,25
2007;"1465";"Totalt";0;553;3465;4018;0,137630662020906;13,76
2008;"1465";"Totalt";0;493;3397;3890;0,126735218508997;12,67
2009;"1465";"Totalt";0;397;3242;3639;0,109095905468535;10,91
2010;"1465";"Totalt";0;420;3301;3721;0,112872883633432;11,29
2011;"1465";"Totalt";0;356;3288;3644;0,0976948408342481;9,77
2012;"1465";"Totalt";0;370;3182;3552;0,104166666666667;10,42
2013;"1465";"Totalt";0;354;2977;3331;0,106274392074452;10,63
2014;"1465";"Totalt";0;314;2973;3287;0,0955278369333739;9,55
2015;"1465";"Totalt";0;312;3036;3348;0,0931899641577061;9,32
2016;"1465";"Totalt";0;339;3202;3541;0,0957356678904264;9,57
2017;"1465";"Totalt";0;338;3192;3530;0,0957507082152975;9,58
2018;"1465";"Totalt";0;396;3141;3537;0,111959287531807;11,2
2019;"1465";"Totalt";0;398;3168;3566;0,111609646662928;11,16
2020;"1465";"Totalt";0;418;3245;3663;0,114114114114114;11,41
2021;"1465";"Totalt";0;449;3407;3856;0,116441908713693;11,64
2022;"1465";"Totalt";0;511;3595;4106;0,124452021432051;12,45
2007;"1466";"Totalt";0;35;3851;3886;0,00900669068450849;0,9
2008;"1466";"Totalt";0;25;3719;3744;0,00667735042735043;0,67
2009;"1466";"Totalt";0;31;3546;3577;0,00866648029074644;0,87
2010;"1466";"Totalt";0;49;3671;3720;0,0131720430107527;1,32
2011;"1466";"Totalt";0;28;3642;3670;0,00762942779291553;0,76
2012;"1466";"Totalt";0;32;3586;3618;0,00884466556108347;0,88
2013;"1466";"Totalt";0;26;3540;3566;0,00729108244531688;0,73
2014;"1466";"Totalt";0;29;3561;3590;0,00807799442896936;0,81
2015;"1466";"Totalt";0;23;3545;3568;0,00644618834080718;0,64
2016;"1466";"Totalt";0;23;3652;3675;0,00625850340136054;0,63
2017;"1466";"Totalt";0;28;3580;3608;0,00776053215077605;0,78
2018;"1466";"Totalt";0;26;3476;3502;0,00742432895488292;0,74
2019;"1466";"Totalt";0;27;3297;3324;0,00812274368231047;0,81
2020;"1466";"Totalt";0;32;3380;3412;0,00937866354044549;0,94
2021;"1466";"Totalt";0;33;3453;3486;0,00946643717728055;0,95
2022;"1466";"Totalt";0;38;3602;3640;0,0104395604395604;1,04
2007;"1470";"Totalt";0;151;7688;7839;0,0192626610537058;1,93
2008;"1470";"Totalt";0;157;7650;7807;0,0201101575509158;2,01
2009;"1470";"Totalt";0;168;7073;7241;0,0232012153017539;2,32
2010;"1470";"Totalt";0;147;7188;7335;0,020040899795501;2
2011;"1470";"Totalt";0;138;7369;7507;0,0183828426801652;1,84
2012;"1470";"Totalt";0;133;7230;7363;0,0180632894200733;1,81
2013;"1470";"Totalt";0;141;7102;7243;0,0194670716553914;1,95
2014;"1470";"Totalt";0;128;6681;6809;0,0187986488471141;1,88
2015;"1470";"Totalt";0;133;6911;7044;0,0188813174332765;1,89
2016;"1470";"Totalt";0;137;7065;7202;0,0190224937517356;1,9
2017;"1470";"Totalt";0;138;7102;7240;0,019060773480663;1,91
2018;"1470";"Totalt";0;127;7249;7376;0,0172180043383948;1,72
2019;"1470";"Totalt";0;131;7172;7303;0,0179378337669451;1,79
2020;"1470";"Totalt";0;113;7217;7330;0,0154160982264666;1,54
2021;"1470";"Totalt";0;112;7217;7329;0,0152817574021012;1,53
2022;"1470";"Totalt";0;126;7482;7608;0,0165615141955836;1,66
2007;"1471";"Totalt";0;120;6044;6164;0,0194678780012979;1,95
2008;"1471";"Totalt";0;94;6037;6131;0,0153319197520796;1,53
2009;"1471";"Totalt";0;80;5551;5631;0,0142070680163381;1,42
2010;"1471";"Totalt";0;80;5690;5770;0,0138648180242634;1,39
2011;"1471";"Totalt";0;68;5666;5734;0,0118590861527729;1,19
2012;"1471";"Totalt";0;60;5462;5522;0,0108656283955089;1,09
2013;"1471";"Totalt";0;60;5352;5412;0,0110864745011086;1,11
2014;"1471";"Totalt";0;63;5250;5313;0,0118577075098814;1,19
2015;"1471";"Totalt";0;58;5346;5404;0,0107327905255366;1,07
2016;"1471";"Totalt";0;61;5669;5730;0,0106457242582897;1,06
2017;"1471";"Totalt";0;57;5836;5893;0,00967249278805362;0,97
2018;"1471";"Totalt";0;55;5808;5863;0,00938086303939963;0,94
2019;"1471";"Totalt";0;45;5785;5830;0,00771869639794168;0,77
2020;"1471";"Totalt";0;52;5826;5878;0,00884654644436883;0,88
2021;"1471";"Totalt";0;52;6093;6145;0,00846216436126932;0,85
2022;"1471";"Totalt";0;60;6518;6578;0,00912131346913956;0,91
2007;"1472";"Totalt";0;64;3870;3934;0,016268429079817;1,63
2008;"1472";"Totalt";0;63;3693;3756;0,0167731629392971;1,68
2009;"1472";"Totalt";0;60;3455;3515;0,0170697012802276;1,71
2010;"1472";"Totalt";0;42;3539;3581;0,0117285674392628;1,17
2011;"1472";"Totalt";0;51;3534;3585;0,0142259414225941;1,42
2012;"1472";"Totalt";0;45;3425;3470;0,0129682997118156;1,3
2013;"1472";"Totalt";0;52;3280;3332;0,0156062424969988;1,56
2014;"1472";"Totalt";0;50;3173;3223;0,0155134967421657;1,55
2015;"1472";"Totalt";0;49;3193;3242;0,0151141270820481;1,51
2016;"1472";"Totalt";0;46;3310;3356;0,0137067938021454;1,37
2017;"1472";"Totalt";0;50;3306;3356;0,0148986889153754;1,49
2018;"1472";"Totalt";0;46;3379;3425;0,0134306569343066;1,34
2019;"1472";"Totalt";0;41;3416;3457;0,011859994214637;1,19
2020;"1472";"Totalt";0;35;3311;3346;0,0104602510460251;1,05
2021;"1472";"Totalt";0;34;3313;3347;0,0101583507618763;1,02
2022;"1472";"Totalt";0;38;3380;3418;0,0111176126389702;1,11
2007;"1473";"Totalt";0;48;3128;3176;0,0151133501259446;1,51
2008;"1473";"Totalt";0;47;3011;3058;0,0153695225637672;1,54
2009;"1473";"Totalt";0;45;2875;2920;0,0154109589041096;1,54
2010;"1473";"Totalt";0;43;2913;2956;0,0145466847090663;1,45
2011;"1473";"Totalt";0;37;2955;2992;0,0123663101604278;1,24
2012;"1473";"Totalt";0;41;2921;2962;0,0138419986495611;1,38
2013;"1473";"Totalt";0;41;2897;2938;0,0139550714771954;1,4
2014;"1473";"Totalt";0;39;2862;2901;0,0134436401240951;1,34
2015;"1473";"Totalt";0;42;2864;2906;0,0144528561596696;1,45
2016;"1473";"Totalt";0;41;2872;2913;0,0140748369378647;1,41
2017;"1473";"Totalt";0;31;2974;3005;0,0103161397670549;1,03
2018;"1473";"Totalt";0;32;3151;3183;0,0100534087338988;1,01
2019;"1473";"Totalt";0;36;3081;3117;0,0115495668912416;1,15
2020;"1473";"Totalt";0;41;3141;3182;0,0128849780012571;1,29
2021;"1473";"Totalt";0;33;3188;3221;0,0102452654455138;1,02
2022;"1473";"Totalt";0;40;3235;3275;0,0122137404580153;1,22
2007;"1480";"Totalt";0;16524;275282;291806;0,0566266629198851;5,66
2008;"1480";"Totalt";0;16822;278959;295781;0,0568731595335738;5,69
2009;"1480";"Totalt";0;16039;270236;286275;0,0560265478997467;5,6
2010;"1480";"Totalt";0;16276;276745;293021;0,0555455069773156;5,55
2011;"1480";"Totalt";0;16228;281549;297777;0,0544971572686944;5,45
2012;"1480";"Totalt";0;16692;288770;305462;0,0546450949708965;5,46
2013;"1480";"Totalt";0;16239;293071;309310;0,0525007274255601;5,25
2014;"1480";"Totalt";0;16166;294164;310330;0,0520929333290368;5,21
2015;"1480";"Totalt";0;16211;302915;319126;0,0507981173580341;5,08
2016;"1480";"Totalt";0;16508;312412;328920;0,0501884956828408;5,02
2017;"1480";"Totalt";0;16515;325172;341687;0,0483337089207374;4,83
2018;"1480";"Totalt";0;16822;333282;350104;0,0480485798505587;4,8
2019;"1480";"Totalt";0;17255;339152;356407;0,0484137516939903;4,84
2020;"1480";"Totalt";0;16307;331026;347333;0,0469491813331875;4,69
2021;"1480";"Totalt";0;15896;341994;357890;0,0444158819749085;4,44
2022;"1480";"Totalt";0;16777;355873;372650;0,0450207969944989;4,5
2007;"1481";"Totalt";0;1600;30029;31629;0,0505864870846375;5,06
2008;"1481";"Totalt";0;1608;30478;32086;0,0501153150906938;5,01
2009;"1481";"Totalt";0;1536;30058;31594;0,0486168259796164;4,86
2010;"1481";"Totalt";0;1566;31900;33466;0,0467937608318891;4,68
2011;"1481";"Totalt";0;1628;32886;34514;0,0471692646462305;4,72
2012;"1481";"Totalt";0;1652;33266;34918;0,0473108425453921;4,73
2013;"1481";"Totalt";0;1643;34051;35694;0,0460301451224295;4,6
2014;"1481";"Totalt";0;1621;35334;36955;0,043864159112434;4,39
2015;"1481";"Totalt";0;1503;36341;37844;0,0397156748758059;3,97
2016;"1481";"Totalt";0;1419;36686;38105;0,0372392074530901;3,72
2017;"1481";"Totalt";0;1587;38014;39601;0,0400747455872326;4,01
2018;"1481";"Totalt";0;1707;38850;40557;0,0420889119017679;4,21
2019;"1481";"Totalt";0;1699;38910;40609;0,0418380162033047;4,18
2020;"1481";"Totalt";0;1606;38977;40583;0,0395732203139246;3,96
2021;"1481";"Totalt";0;1623;40328;41951;0,0386879931348478;3,87
2022;"1481";"Totalt";0;1687;42335;44022;0,0383217482168007;3,83
2007;"1482";"Totalt";0;400;13530;13930;0,0287150035893754;2,87
2008;"1482";"Totalt";0;417;13469;13886;0,0300302462912286;3
2009;"1482";"Totalt";0;431;13348;13779;0,0312794832716453;3,13
2010;"1482";"Totalt";0;432;13817;14249;0,0303179170468103;3,03
2011;"1482";"Totalt";0;472;14194;14666;0,0321832810582299;3,22
2012;"1482";"Totalt";0;468;14597;15065;0,0310653833388649;3,11
2013;"1482";"Totalt";0;478;14718;15196;0,0314556462226902;3,15
2014;"1482";"Totalt";0;418;14860;15278;0,0273596020421521;2,74
2015;"1482";"Totalt";0;447;15268;15715;0,0284441616290169;2,84
2016;"1482";"Totalt";0;446;15846;16292;0,0273753989688191;2,74
2017;"1482";"Totalt";0;465;15752;16217;0,0286736141086514;2,87
2018;"1482";"Totalt";0;471;16429;16900;0,0278698224852071;2,79
2019;"1482";"Totalt";0;498;16675;17173;0,0289990100739533;2,9
2020;"1482";"Totalt";0;449;16794;17243;0,0260395522820855;2,6
2021;"1482";"Totalt";0;438;17248;17686;0,0247653511251838;2,48
2022;"1482";"Totalt";0;441;17696;18137;0,0243149363180239;2,43
2007;"1484";"Totalt";0;131;5510;5641;0,0232228328310583;2,32
2008;"1484";"Totalt";0;136;5475;5611;0,0242381037248262;2,42
2009;"1484";"Totalt";0;131;5299;5430;0,0241252302025783;2,41
2010;"1484";"Totalt";0;143;5424;5567;0,0256870846057122;2,57
2011;"1484";"Totalt";0;139;5369;5508;0,0252360203340595;2,52
2012;"1484";"Totalt";0;150;5508;5658;0,0265111346765642;2,65
2013;"1484";"Totalt";0;139;5488;5627;0,0247023280611338;2,47
2014;"1484";"Totalt";0;126;5519;5645;0,0223206377325066;2,23
2015;"1484";"Totalt";0;123;5638;5761;0,0213504599895851;2,14
2016;"1484";"Totalt";0;108;5610;5718;0,018887722980063;1,89
2017;"1484";"Totalt";0;100;5745;5845;0,0171086398631309;1,71
2018;"1484";"Totalt";0;103;5759;5862;0,0175707949505288;1,76
2019;"1484";"Totalt";0;111;5709;5820;0,0190721649484536;1,91
2020;"1484";"Totalt";0;103;5481;5584;0,018445558739255;1,84
2021;"1484";"Totalt";0;101;5415;5516;0,0183103698332125;1,83
2022;"1484";"Totalt";0;110;5605;5715;0,0192475940507437;1,92
2007;"1485";"Totalt";0;1065;21347;22412;0,0475191861502766;4,75
2008;"1485";"Totalt";0;1017;21336;22353;0,0454972486914508;4,55
2009;"1485";"Totalt";0;1042;20711;21753;0,0479014388819933;4,79
2010;"1485";"Totalt";0;1061;20922;21983;0,0482645680753309;4,83
2011;"1485";"Totalt";0;944;20840;21784;0,043334557473375;4,33
2012;"1485";"Totalt";0;940;21250;22190;0,0423614240648941;4,24
2013;"1485";"Totalt";0;936;21289;22225;0,0421147356580427;4,21
2014;"1485";"Totalt";0;895;21254;22149;0,0404081448372387;4,04
2015;"1485";"Totalt";0;824;21606;22430;0,03673651359786;3,67
2016;"1485";"Totalt";0;817;22218;23035;0,0354677664423703;3,55
2017;"1485";"Totalt";0;825;22879;23704;0,0348042524468444;3,48
2018;"1485";"Totalt";0;831;23158;23989;0,0346408770686565;3,46
2019;"1485";"Totalt";0;796;22858;23654;0,0336518136467405;3,37
2020;"1485";"Totalt";0;767;22836;23603;0,0324958691691734;3,25
2021;"1485";"Totalt";0;773;23452;24225;0,0319091847265222;3,19
2022;"1485";"Totalt";0;813;23919;24732;0,0328723920426977;3,29
2007;"1486";"Totalt";0;303;5179;5482;0,0552717986136447;5,53
2008;"1486";"Totalt";0;334;5271;5605;0,0595896520963426;5,96
2009;"1486";"Totalt";0;406;5241;5647;0,0718965822560652;7,19
2010;"1486";"Totalt";0;431;5481;5912;0,0729025710419486;7,29
2011;"1486";"Totalt";0;456;5465;5921;0,0770140179023814;7,7
2012;"1486";"Totalt";0;455;5645;6100;0,0745901639344262;7,46
2013;"1486";"Totalt";0;439;5794;6233;0,0704315738809562;7,04
2014;"1486";"Totalt";0;366;5711;6077;0,060227085733092;6,02
2015;"1486";"Totalt";0;397;5608;6005;0,0661115736885928;6,61
2016;"1486";"Totalt";0;347;5572;5919;0,0586247676972462;5,86
2017;"1486";"Totalt";0;347;5592;5939;0,05842734467082;5,84
2018;"1486";"Totalt";0;314;5634;5948;0,0527908540685945;5,28
2019;"1486";"Totalt";0;286;5520;5806;0,0492593868411988;4,93
2020;"1486";"Totalt";0;214;5037;5251;0,0407541420681775;4,08
2021;"1486";"Totalt";0;213;5087;5300;0,040188679245283;4,02
2022;"1486";"Totalt";0;233;5556;5789;0,0402487476248057;4,02
2007;"1487";"Totalt";0;367;12810;13177;0,0278515595355544;2,79
2008;"1487";"Totalt";0;332;12370;12702;0,0261376161234451;2,61
2009;"1487";"Totalt";0;289;11704;11993;0,0240973901442508;2,41
2010;"1487";"Totalt";0;299;11642;11941;0,0250397789129889;2,5
2011;"1487";"Totalt";0;319;11735;12054;0,0264642442342791;2,65
2012;"1487";"Totalt";0;303;11757;12060;0,0251243781094527;2,51
2013;"1487";"Totalt";0;295;11749;12044;0,0244935237462637;2,45
2014;"1487";"Totalt";0;332;11778;12110;0,0274153592072667;2,74
2015;"1487";"Totalt";0;321;11979;12300;0,0260975609756098;2,61
2016;"1487";"Totalt";0;369;12378;12747;0,0289479877618263;2,89
2017;"1487";"Totalt";0;356;12496;12852;0,0276999688764395;2,77
2018;"1487";"Totalt";0;377;12757;13134;0,0287041266940764;2,87
2019;"1487";"Totalt";0;375;12659;13034;0,0287709068589842;2,88
2020;"1487";"Totalt";0;351;12535;12886;0,0272388638832842;2,72
2021;"1487";"Totalt";0;342;12968;13310;0,025694966190834;2,57
2022;"1487";"Totalt";0;369;13291;13660;0,02701317715959;2,7
2007;"1488";"Totalt";0;687;28394;29081;0,0236236718132114;2,36
2008;"1488";"Totalt";0;691;28158;28849;0,0239523033727339;2,4
2009;"1488";"Totalt";0;669;26696;27365;0,0244472866800658;2,44
2010;"1488";"Totalt";0;679;26936;27615;0,0245880861850444;2,46
2011;"1488";"Totalt";0;714;26302;27016;0,0264287829434409;2,64
2012;"1488";"Totalt";0;692;24302;24994;0,0276866447947507;2,77
2013;"1488";"Totalt";0;746;24042;24788;0,0300952073583992;3,01
2014;"1488";"Totalt";0;720;24469;25189;0,0285839056731113;2,86
2015;"1488";"Totalt";0;741;24810;25551;0,0290008218856405;2,9
2016;"1488";"Totalt";0;756;25751;26507;0,0285207680989927;2,85
2017;"1488";"Totalt";0;724;26290;27014;0,0268009180424965;2,68
2018;"1488";"Totalt";0;688;26853;27541;0,0249809375113467;2,5
2019;"1488";"Totalt";0;764;27071;27835;0,0274474582360338;2,74
2020;"1488";"Totalt";0;681;26478;27159;0,0250745609190324;2,51
2021;"1488";"Totalt";0;653;26671;27324;0,0238984043331869;2,39
2022;"1488";"Totalt";0;689;27462;28151;0,0244751518596142;2,45
2007;"1489";"Totalt";0;570;12641;13211;0,0431458632957384;4,31
2008;"1489";"Totalt";0;494;12509;13003;0,0379912327924325;3,8
2009;"1489";"Totalt";0;470;12231;12701;0,0370049602393512;3,7
2010;"1489";"Totalt";0;483;12368;12851;0,0375846237646876;3,76
2011;"1489";"Totalt";0;481;12505;12986;0,0370398891113507;3,7
2012;"1489";"Totalt";0;495;12689;13184;0,0375455097087379;3,75
2013;"1489";"Totalt";0;507;12774;13281;0,0381748362322114;3,82
2014;"1489";"Totalt";0;520;13036;13556;0,0383593980525229;3,84
2015;"1489";"Totalt";0;520;13291;13811;0,0376511476359424;3,77
2016;"1489";"Totalt";0;543;13567;14110;0,038483345145287;3,85
2017;"1489";"Totalt";0;498;13669;14167;0,0351521140679043;3,52
2018;"1489";"Totalt";0;477;13873;14350;0,0332404181184669;3,32
2019;"1489";"Totalt";0;508;14041;14549;0,0349164891057805;3,49
2020;"1489";"Totalt";0;465;14479;14944;0,0311161670235546;3,11
2021;"1489";"Totalt";0;490;14317;14807;0,0330924562706828;3,31
2022;"1489";"Totalt";0;531;14527;15058;0,0352636472307079;3,53
2007;"1490";"Totalt";0;4847;42423;47270;0,102538607996615;10,25
2008;"1490";"Totalt";0;4745;43489;48234;0,0983745905377949;9,84
2009;"1490";"Totalt";0;4524;42618;47142;0,0959653811887489;9,6
2010;"1490";"Totalt";0;4703;44061;48764;0,0964440981051595;9,64
2011;"1490";"Totalt";0;4618;45009;49627;0,0930541842142382;9,31
2012;"1490";"Totalt";0;4626;46227;50853;0,0909680844787918;9,1
2013;"1490";"Totalt";0;4495;46646;51141;0,0878942531432706;8,79
2014;"1490";"Totalt";0;4470;46603;51073;0,087521782546551;8,75
2015;"1490";"Totalt";0;4573;47175;51748;0,0883705650459921;8,84
2016;"1490";"Totalt";0;4632;48105;52737;0,0878320723590648;8,78
2017;"1490";"Totalt";0;4723;48913;53636;0,0880565291968081;8,81
2018;"1490";"Totalt";0;4738;49743;54481;0,0869660982727923;8,7
2019;"1490";"Totalt";0;5118;50083;55201;0,09271571167189;9,27
2020;"1490";"Totalt";0;4928;49567;54495;0,0904303147077714;9,04
2021;"1490";"Totalt";0;4851;51802;56653;0,0856265334580693;8,56
2022;"1490";"Totalt";0;5146;52726;57872;0,0889203760022118;8,89
2007;"1491";"Totalt";0;671;7385;8056;0,083291956305859;8,33
2008;"1491";"Totalt";0;681;7503;8184;0,0832111436950147;8,32
2009;"1491";"Totalt";0;656;7171;7827;0,0838124441037435;8,38
2010;"1491";"Totalt";0;664;7262;7926;0,0837749179914206;8,38
2011;"1491";"Totalt";0;637;7464;8101;0,0786322676212813;7,86
2012;"1491";"Totalt";0;637;7635;8272;0,0770067698259188;7,7
2013;"1491";"Totalt";0;620;7680;8300;0,0746987951807229;7,47
2014;"1491";"Totalt";0;645;7727;8372;0,0770425226946966;7,7
2015;"1491";"Totalt";0;649;7992;8641;0,0751070477953941;7,51
2016;"1491";"Totalt";0;619;8239;8858;0,0698803341612102;6,99
2017;"1491";"Totalt";0;595;8475;9070;0,0656008820286659;6,56
2018;"1491";"Totalt";0;611;8482;9093;0,0671945452545914;6,72
2019;"1491";"Totalt";0;629;8414;9043;0,069556563087471;6,96
2020;"1491";"Totalt";0;617;8377;8994;0,0686012897487214;6,86
2021;"1491";"Totalt";0;619;8594;9213;0,0671876695973082;6,72
2022;"1491";"Totalt";0;645;8893;9538;0,067624239882575;6,76
2007;"1492";"Totalt";0;158;4539;4697;0,0336384926548861;3,36
2008;"1492";"Totalt";0;155;4417;4572;0,0339020122484689;3,39
2009;"1492";"Totalt";0;138;4093;4231;0,0326164027416686;3,26
2010;"1492";"Totalt";0;123;4070;4193;0,0293346052945385;2,93
2011;"1492";"Totalt";0;121;4045;4166;0,029044647143543;2,9
2012;"1492";"Totalt";0;118;4034;4152;0,0284200385356455;2,84
2013;"1492";"Totalt";0;101;4014;4115;0,0245443499392467;2,45
2014;"1492";"Totalt";0;93;4055;4148;0,022420443587271;2,24
2015;"1492";"Totalt";0;95;4024;4119;0,0230638504491381;2,31
2016;"1492";"Totalt";0;106;4077;4183;0,0253406645947884;2,53
2017;"1492";"Totalt";0;101;4084;4185;0,0241338112305854;2,41
2018;"1492";"Totalt";0;89;4169;4258;0,0209018318459371;2,09
2019;"1492";"Totalt";0;77;4123;4200;0,0183333333333333;1,83
2020;"1492";"Totalt";0;85;4044;4129;0,0205860983288932;2,06
2021;"1492";"Totalt";0;68;4101;4169;0,0163108659150876;1,63
2022;"1492";"Totalt";0;72;4188;4260;0,0169014084507042;1,69
2007;"1493";"Totalt";0;184;9171;9355;0,0196686264029931;1,97
2008;"1493";"Totalt";0;181;8847;9028;0,020048737261852;2
2009;"1493";"Totalt";0;177;8516;8693;0,0203612101691016;2,04
2010;"1493";"Totalt";0;176;8676;8852;0,0198825124265703;1,99
2011;"1493";"Totalt";0;175;8481;8656;0,0202171903881701;2,02
2012;"1493";"Totalt";0;190;8381;8571;0,0221677750554194;2,22
2013;"1493";"Totalt";0;217;8290;8507;0,0255084048430704;2,55
2014;"1493";"Totalt";0;221;8170;8391;0,0263377428196878;2,63
2015;"1493";"Totalt";0;203;8314;8517;0,0238346835740284;2,38
2016;"1493";"Totalt";0;204;8473;8677;0,0235104298720756;2,35
2017;"1493";"Totalt";0;192;8429;8621;0,0222711982368635;2,23
2018;"1493";"Totalt";0;206;8546;8752;0,0235374771480804;2,35
2019;"1493";"Totalt";0;193;8371;8564;0,0225361980382999;2,25
2020;"1493";"Totalt";0;188;8490;8678;0,0216639778750864;2,17
2021;"1493";"Totalt";0;183;8803;8986;0,0203650122412642;2,04
2022;"1493";"Totalt";0;222;9180;9402;0,0236119974473516;2,36
2007;"1494";"Totalt";0;495;15571;16066;0,0308104070708328;3,08
2008;"1494";"Totalt";0;493;15545;16038;0,0307394937024567;3,07
2009;"1494";"Totalt";0;496;15601;16097;0,0308131950052805;3,08
2010;"1494";"Totalt";0;506;15655;16161;0,0313099436916032;3,13
2011;"1494";"Totalt";0;527;15615;16142;0,0326477512080287;3,26
2012;"1494";"Totalt";0;525;15774;16299;0,0322105650653414;3,22
2013;"1494";"Totalt";0;531;15353;15884;0,0334298665323596;3,34
2014;"1494";"Totalt";0;523;15600;16123;0,0324381318613161;3,24
2015;"1494";"Totalt";0;490;15801;16291;0,030077957154257;3,01
2016;"1494";"Totalt";0;485;16242;16727;0,0289950379625755;2,9
2017;"1494";"Totalt";0;476;16509;16985;0,0280247277009126;2,8
2018;"1494";"Totalt";0;463;16608;17071;0,0271220197996602;2,71
2019;"1494";"Totalt";0;430;16671;17101;0,0251447283784574;2,51
2020;"1494";"Totalt";0;442;16713;17155;0,0257650830661615;2,58
2021;"1494";"Totalt";0;427;17187;17614;0,0242420801635063;2,42
2022;"1494";"Totalt";0;453;17753;18206;0,0248819070636054;2,49
2007;"1495";"Totalt";0;305;8050;8355;0,0365050867743866;3,65
2008;"1495";"Totalt";0;300;7949;8249;0,0363680446114681;3,64
2009;"1495";"Totalt";0;290;7799;8089;0,0358511558907158;3,59
2010;"1495";"Totalt";0;289;7853;8142;0,0354949643822157;3,55
2011;"1495";"Totalt";0;266;7557;7823;0,0340023009075802;3,4
2012;"1495";"Totalt";0;250;7678;7928;0,0315338042381433;3,15
2013;"1495";"Totalt";0;214;7568;7782;0,0274993574916474;2,75
2014;"1495";"Totalt";0;217;7534;7751;0,0279963875628951;2,8
2015;"1495";"Totalt";0;194;7548;7742;0,025058124515629;2,51
2016;"1495";"Totalt";0;192;7786;7978;0,0240661820005014;2,41
2017;"1495";"Totalt";0;189;7927;8116;0,0232873336619024;2,33
2018;"1495";"Totalt";0;204;7930;8134;0,0250799114826654;2,51
2019;"1495";"Totalt";0;200;7895;8095;0,0247066090179123;2,47
2020;"1495";"Totalt";0;179;7775;7954;0,022504400301735;2,25
2021;"1495";"Totalt";0;193;7911;8104;0,0238153998025666;2,38
2022;"1495";"Totalt";0;180;8354;8534;0,0210921021795172;2,11
2007;"1496";"Totalt";0;769;28060;28829;0,0266745291199833;2,67
2008;"1496";"Totalt";0;773;28728;29501;0,0262025016101149;2,62
2009;"1496";"Totalt";0;774;26807;27581;0,028062796852906;2,81
2010;"1496";"Totalt";0;786;27575;28361;0,0277141144529459;2,77
2011;"1496";"Totalt";0;816;28915;29731;0,0274461000302714;2,74
2012;"1496";"Totalt";0;798;29027;29825;0,026756077116513;2,68
2013;"1496";"Totalt";0;816;29821;30637;0,0266344615987205;2,66
2014;"1496";"Totalt";0;838;30016;30854;0,0271601737213975;2,72
2015;"1496";"Totalt";0;831;30337;31168;0,0266619609856263;2,67
2016;"1496";"Totalt";0;750;30891;31641;0,0237034227742486;2,37
2017;"1496";"Totalt";0;771;31957;32728;0,0235578098264483;2,36
2018;"1496";"Totalt";0;782;32638;33420;0,0233991621783363;2,34
2019;"1496";"Totalt";0;877;32548;33425;0,0262378459237098;2,62
2020;"1496";"Totalt";0;828;31961;32789;0,0252523712220562;2,53
2021;"1496";"Totalt";0;844;32683;33527;0,025173740567304;2,52
2022;"1496";"Totalt";0;911;34063;34974;0,0260479213129754;2,6
2007;"1497";"Totalt";0;70;2710;2780;0,0251798561151079;2,52
2008;"1497";"Totalt";0;74;2669;2743;0,026977761574918;2,7
2009;"1497";"Totalt";0;71;2495;2566;0,0276695245518316;2,77
2010;"1497";"Totalt";0;59;2552;2611;0,0225967062428188;2,26
2011;"1497";"Totalt";0;66;2551;2617;0,0252197172334734;2,52
2012;"1497";"Totalt";0;57;2588;2645;0,0215500945179584;2,16
2013;"1497";"Totalt";0;50;2571;2621;0,0190766882869134;1,91
2014;"1497";"Totalt";0;48;2565;2613;0,0183696900114811;1,84
2015;"1497";"Totalt";0;50;2603;2653;0,0188465887674331;1,88
2016;"1497";"Totalt";0;46;2759;2805;0,0163992869875223;1,64
2017;"1497";"Totalt";0;42;2709;2751;0,0152671755725191;1,53
2018;"1497";"Totalt";0;40;2657;2697;0,0148312940304042;1,48
2019;"1497";"Totalt";0;42;2714;2756;0,0152394775036284;1,52
2020;"1497";"Totalt";0;40;2715;2755;0,014519056261343;1,45
2021;"1497";"Totalt";0;37;2790;2827;0,0130880792359392;1,31
2022;"1497";"Totalt";0;39;2924;2963;0,0131623354708066;1,32
2007;"1498";"Totalt";0;88;4569;4657;0,0188962851621215;1,89
2008;"1498";"Totalt";0;90;4416;4506;0,0199733688415446;2
2009;"1498";"Totalt";0;93;4073;4166;0,0223235717714834;2,23
2010;"1498";"Totalt";0;89;3943;4032;0,0220734126984127;2,21
2011;"1498";"Totalt";0;98;3941;4039;0,024263431542461;2,43
2012;"1498";"Totalt";0;105;4133;4238;0,0247758376592732;2,48
2013;"1498";"Totalt";0;103;4059;4162;0,0247477174435368;2,47
2014;"1498";"Totalt";0;97;4079;4176;0,023227969348659;2,32
2015;"1498";"Totalt";0;94;4081;4175;0,0225149700598802;2,25
2016;"1498";"Totalt";0;103;4216;4319;0,0238481129891179;2,38
2017;"1498";"Totalt";0;100;4319;4419;0,0226295541977823;2,26
2018;"1498";"Totalt";0;96;4360;4456;0,0215439856373429;2,15
2019;"1498";"Totalt";0;105;4355;4460;0,023542600896861;2,35
2020;"1498";"Totalt";0;103;4276;4379;0,023521351906828;2,35
2021;"1498";"Totalt";0;113;4447;4560;0,024780701754386;2,48
2022;"1498";"Totalt";0;111;4666;4777;0,0232363407996651;2,32
2007;"1499";"Totalt";0;415;11719;12134;0,0342014175045327;3,42
2008;"1499";"Totalt";0;404;12000;12404;0,0325701386649468;3,26
2009;"1499";"Totalt";0;372;11474;11846;0,0314030052338342;3,14
2010;"1499";"Totalt";0;368;11610;11978;0,0307229921522792;3,07
2011;"1499";"Totalt";0;406;11760;12166;0,0333716915995397;3,34
2012;"1499";"Totalt";0;373;11840;12213;0,0305412265618603;3,05
2013;"1499";"Totalt";0;528;11629;12157;0,0434317677058485;4,34
2014;"1499";"Totalt";0;449;11373;11822;0,0379800372187447;3,8
2015;"1499";"Totalt";0;457;11507;11964;0,0381979271146774;3,82
2016;"1499";"Totalt";0;446;11539;11985;0,0372131831455987;3,72
2017;"1499";"Totalt";0;485;11649;12134;0,039970331300478;4
2018;"1499";"Totalt";0;467;11740;12207;0,0382567379372491;3,83
2019;"1499";"Totalt";0;252;12085;12337;0,0204263597308908;2,04
2020;"1499";"Totalt";0;216;11811;12027;0,017959590920429;1,8
2021;"1499";"Totalt";0;219;11772;11991;0,01826369777333;1,83
2022;"1499";"Totalt";0;242;12056;12298;0,0196779964221825;1,97
2007;"1715";"Totalt";0;61;3030;3091;0,0197347136848916;1,97
2008;"1715";"Totalt";0;61;3009;3070;0,0198697068403909;1,99
2009;"1715";"Totalt";0;56;2771;2827;0,0198089847895295;1,98
2010;"1715";"Totalt";0;60;2854;2914;0,0205902539464653;2,06
2011;"1715";"Totalt";0;66;2998;3064;0,0215404699738903;2,15
2012;"1715";"Totalt";0;62;3026;3088;0,0200777202072539;2,01
2013;"1715";"Totalt";0;55;2988;3043;0,0180742688136707;1,81
2014;"1715";"Totalt";0;60;2989;3049;0,0196785831420138;1,97
2015;"1715";"Totalt";0;61;3004;3065;0,0199021207177814;1,99
2016;"1715";"Totalt";0;52;3072;3124;0,0166453265044814;1,66
2017;"1715";"Totalt";0;54;3080;3134;0,017230376515635;1,72
2018;"1715";"Totalt";0;75;3155;3230;0,0232198142414861;2,32
2019;"1715";"Totalt";0;65;3064;3129;0,020773410035155;2,08
2020;"1715";"Totalt";0;58;3068;3126;0,018554062699936;1,86
2021;"1715";"Totalt";0;61;3061;3122;0,0195387572069186;1,95
2022;"1715";"Totalt";0;65;3083;3148;0,0206480304955527;2,06
2007;"1730";"Totalt";0;108;2973;3081;0,0350535540408958;3,51
2008;"1730";"Totalt";0;144;2988;3132;0,0459770114942529;4,6
2009;"1730";"Totalt";0;126;2836;2962;0,0425388251181634;4,25
2010;"1730";"Totalt";0;132;2973;3105;0,042512077294686;4,25
2011;"1730";"Totalt";0;141;3029;3170;0,0444794952681388;4,45
2012;"1730";"Totalt";0;139;3062;3201;0,0434239300218682;4,34
2013;"1730";"Totalt";0;136;3099;3235;0,0420401854714065;4,2
2014;"1730";"Totalt";0;129;3229;3358;0,0384157236450268;3,84
2015;"1730";"Totalt";0;127;3335;3462;0,036683997689197;3,67
2016;"1730";"Totalt";0;123;3374;3497;0,0351730054332285;3,52
2017;"1730";"Totalt";0;122;3394;3516;0,0346985210466439;3,47
2018;"1730";"Totalt";0;140;3428;3568;0,039237668161435;3,92
2019;"1730";"Totalt";0;140;3355;3495;0,0400572246065808;4,01
2020;"1730";"Totalt";0;116;3180;3296;0,0351941747572816;3,52
2021;"1730";"Totalt";0;96;3116;3212;0,0298879202988792;2,99
2022;"1730";"Totalt";0;108;3151;3259;0,0331389996931574;3,31
2007;"1737";"Totalt";0;86;4788;4874;0,017644645055396;1,76
2008;"1737";"Totalt";0;86;4734;4820;0,0178423236514523;1,78
2009;"1737";"Totalt";0;85;4480;4565;0,0186199342825849;1,86
2010;"1737";"Totalt";0;88;4744;4832;0,0182119205298013;1,82
2011;"1737";"Totalt";0;98;4827;4925;0,0198984771573604;1,99
2012;"1737";"Totalt";0;90;4774;4864;0,0185032894736842;1,85
2013;"1737";"Totalt";0;89;4820;4909;0,0181299653697291;1,81
2014;"1737";"Totalt";0;91;4792;4883;0,01863608437436;1,86
2015;"1737";"Totalt";0;70;4742;4812;0,014546965918537;1,45
2016;"1737";"Totalt";0;67;4900;4967;0,0134890275820415;1,35
2017;"1737";"Totalt";0;70;4881;4951;0,0141385578670976;1,41
2018;"1737";"Totalt";0;63;4821;4884;0,0128992628992629;1,29
2019;"1737";"Totalt";0;65;4735;4800;0,0135416666666667;1,35
2020;"1737";"Totalt";0;67;4619;4686;0,0142979086641058;1,43
2021;"1737";"Totalt";0;73;4632;4705;0,0155154091392136;1,55
2022;"1737";"Totalt";0;73;4698;4771;0,0153007755187592;1,53
2007;"1760";"Totalt";0;6;1199;1205;0,00497925311203319;0,5
2008;"1760";"Totalt";0;4;1241;1245;0,00321285140562249;0,32
2009;"1760";"Totalt";0;8;1084;1092;0,00732600732600733;0,73
2010;"1760";"Totalt";0;7;1047;1054;0,00664136622390892;0,66
2011;"1760";"Totalt";0;7;1052;1059;0,00661000944287063;0,66
2012;"1760";"Totalt";0;5;1050;1055;0,004739336492891;0,47
2013;"1760";"Totalt";0;9;1029;1038;0,00867052023121387;0,87
2014;"1760";"Totalt";0;6;988;994;0,00603621730382294;0,6
2015;"1760";"Totalt";0;7;956;963;0,00726895119418484;0,73
2016;"1760";"Totalt";0;12;954;966;0,0124223602484472;1,24
2017;"1760";"Totalt";0;11;979;990;0,0111111111111111;1,11
2018;"1760";"Totalt";0;5;986;991;0,00504540867810293;0,5
2019;"1760";"Totalt";0;7;954;961;0,0072840790842872;0,73
2020;"1760";"Totalt";0;8;909;917;0,00872410032715376;0,87
2021;"1760";"Totalt";0;10;908;918;0,0108932461873638;1,09
2022;"1760";"Totalt";0;13;901;914;0,0142231947483589;1,42
2007;"1761";"Totalt";0;35;3910;3945;0,00887198986058302;0,89
2008;"1761";"Totalt";0;40;3780;3820;0,0104712041884817;1,05
2009;"1761";"Totalt";0;43;3598;3641;0,0118099423235375;1,18
2010;"1761";"Totalt";0;56;3779;3835;0,0146023468057366;1,46
2011;"1761";"Totalt";0;84;3710;3794;0,022140221402214;2,21
2012;"1761";"Totalt";0;72;3681;3753;0,0191846522781775;1,92
2013;"1761";"Totalt";0;74;3728;3802;0,0194634402945818;1,95
2014;"1761";"Totalt";0;78;3576;3654;0,0213464696223317;2,13
2015;"1761";"Totalt";0;76;3595;3671;0,0207028057749932;2,07
2016;"1761";"Totalt";0;83;3777;3860;0,0215025906735751;2,15
2017;"1761";"Totalt";0;84;3857;3941;0,0213143872113677;2,13
2018;"1761";"Totalt";0;75;3835;3910;0,0191815856777494;1,92
2019;"1761";"Totalt";0;74;3724;3798;0,0194839389152185;1,95
2020;"1761";"Totalt";0;77;3748;3825;0,0201307189542484;2,01
2021;"1761";"Totalt";0;79;3782;3861;0,0204610204610205;2,05
2022;"1761";"Totalt";0;90;3859;3949;0,022790579893644;2,28
2007;"1762";"Totalt";0;52;1415;1467;0,0354464894342195;3,54
2008;"1762";"Totalt";0;57;1373;1430;0,0398601398601399;3,99
2009;"1762";"Totalt";0;50;1264;1314;0,0380517503805175;3,81
2010;"1762";"Totalt";0;49;1324;1373;0,0356882738528769;3,57
2011;"1762";"Totalt";0;52;1365;1417;0,036697247706422;3,67
2012;"1762";"Totalt";0;55;1392;1447;0,0380096751900484;3,8
2013;"1762";"Totalt";0;47;1333;1380;0,0340579710144928;3,41
2014;"1762";"Totalt";0;39;1330;1369;0,0284879474068663;2,85
2015;"1762";"Totalt";0;34;1339;1373;0,0247632920611799;2,48
2016;"1762";"Totalt";0;26;1405;1431;0,0181691125087351;1,82
2017;"1762";"Totalt";0;27;1450;1477;0,018280297901151;1,83
2018;"1762";"Totalt";0;29;1509;1538;0,0188556566970091;1,89
2019;"1762";"Totalt";0;26;1455;1481;0,0175557056043214;1,76
2020;"1762";"Totalt";0;17;1473;1490;0,0114093959731544;1,14
2021;"1762";"Totalt";0;18;1514;1532;0,0117493472584856;1,17
2022;"1762";"Totalt";0;15;1532;1547;0,0096961861667744;0,97
2007;"1763";"Totalt";0;46;2542;2588;0,017774343122102;1,78
2008;"1763";"Totalt";0;45;2355;2400;0,01875;1,88
2009;"1763";"Totalt";0;45;2265;2310;0,0194805194805195;1,95
2010;"1763";"Totalt";0;43;2209;2252;0,0190941385435169;1,91
2011;"1763";"Totalt";0;49;2166;2215;0,0221218961625282;2,21
2012;"1763";"Totalt";0;45;2283;2328;0,0193298969072165;1,93
2013;"1763";"Totalt";0;40;2262;2302;0,0173761946133797;1,74
2014;"1763";"Totalt";0;41;2246;2287;0,0179274158285964;1,79
2015;"1763";"Totalt";0;44;2312;2356;0,0186757215619694;1,87
2016;"1763";"Totalt";0;52;2400;2452;0,0212071778140294;2,12
2017;"1763";"Totalt";0;50;2427;2477;0,020185708518369;2,02
2018;"1763";"Totalt";0;36;2426;2462;0,0146222583265638;1,46
2019;"1763";"Totalt";0;36;2417;2453;0,0146759070525887;1,47
2020;"1763";"Totalt";0;36;2377;2413;0,0149191877331123;1,49
2021;"1763";"Totalt";0;40;2427;2467;0,016214025131739;1,62
2022;"1763";"Totalt";0;38;2565;2603;0,0145985401459854;1,46
2007;"1764";"Totalt";0;20;3178;3198;0,00625390869293308;0,63
2008;"1764";"Totalt";0;19;3120;3139;0,00605288308378464;0,61
2009;"1764";"Totalt";0;18;2943;2961;0,0060790273556231;0,61
2010;"1764";"Totalt";0;21;2976;2997;0,00700700700700701;0,7
2011;"1764";"Totalt";0;21;2950;2971;0,00706832716257152;0,71
2012;"1764";"Totalt";0;25;2872;2897;0,00862961684501208;0,86
2013;"1764";"Totalt";0;28;2920;2948;0,00949796472184532;0,95
2014;"1764";"Totalt";0;21;2831;2852;0,0073632538569425;0,74
2015;"1764";"Totalt";0;24;2880;2904;0,00826446280991736;0,83
2016;"1764";"Totalt";0;29;2987;3016;0,00961538461538462;0,96
2017;"1764";"Totalt";0;25;3112;3137;0,00796939751354798;0,8
2018;"1764";"Totalt";0;23;3207;3230;0,00712074303405573;0,71
2019;"1764";"Totalt";0;34;3235;3269;0,0104007341694708;1,04
2020;"1764";"Totalt";0;24;3219;3243;0,00740055504162812;0,74
2021;"1764";"Totalt";0;24;3302;3326;0,00721587492483464;0,72
2022;"1764";"Totalt";0;25;3345;3370;0,00741839762611276;0,74
2007;"1765";"Totalt";0;150;3615;3765;0,0398406374501992;3,98
2008;"1765";"Totalt";0;154;3532;3686;0,0417797069994574;4,18
2009;"1765";"Totalt";0;146;3342;3488;0,0418577981651376;4,19
2010;"1765";"Totalt";0;142;3424;3566;0,039820527201346;3,98
2011;"1765";"Totalt";0;132;3495;3627;0,0363937138130687;3,64
2012;"1765";"Totalt";0;140;3605;3745;0,0373831775700935;3,74
2013;"1765";"Totalt";0;120;3555;3675;0,0326530612244898;3,27
2014;"1765";"Totalt";0;117;3457;3574;0,0327364297705652;3,27
2015;"1765";"Totalt";0;101;3473;3574;0,0282596530498041;2,83
2016;"1765";"Totalt";0;90;3562;3652;0,0246440306681271;2,46
2017;"1765";"Totalt";0;87;3523;3610;0,0240997229916898;2,41
2018;"1765";"Totalt";0;99;3527;3626;0,0273028130170987;2,73
2019;"1765";"Totalt";0;109;3580;3689;0,0295473027920846;2,95
2020;"1765";"Totalt";0;91;3504;3595;0,0253129346314325;2,53
2021;"1765";"Totalt";0;78;3501;3579;0,0217937971500419;2,18
2022;"1765";"Totalt";0;96;3780;3876;0,0247678018575851;2,48
2007;"1766";"Totalt";0;237;4829;5066;0,0467824713778129;4,68
2008;"1766";"Totalt";0;248;4655;4903;0,0505812767693249;5,06
2009;"1766";"Totalt";0;267;4453;4720;0,0565677966101695;5,66
2010;"1766";"Totalt";0;287;4525;4812;0,0596425602660017;5,96
2011;"1766";"Totalt";0;301;4555;4856;0,0619851729818781;6,2
2012;"1766";"Totalt";0;300;4677;4977;0,0602772754671489;6,03
2013;"1766";"Totalt";0;289;4597;4886;0,0591485878018829;5,91
2014;"1766";"Totalt";0;282;4518;4800;0,05875;5,88
2015;"1766";"Totalt";0;300;4467;4767;0,0629326620516048;6,29
2016;"1766";"Totalt";0;293;4532;4825;0,0607253886010363;6,07
2017;"1766";"Totalt";0;276;4515;4791;0,0576080150281778;5,76
2018;"1766";"Totalt";0;277;4636;4913;0,0563810299206188;5,64
2019;"1766";"Totalt";0;282;4666;4948;0,0569927243330639;5,7
2020;"1766";"Totalt";0;252;4583;4835;0,0521199586349535;5,21
2021;"1766";"Totalt";0;243;4638;4881;0,0497848801475108;4,98
2022;"1766";"Totalt";0;271;4842;5113;0,0530021513788383;5,3
2007;"1780";"Totalt";0;2100;42611;44711;0,046968307575317;4,7
2008;"1780";"Totalt";0;2273;42757;45030;0,0504774594714635;5,05
2009;"1780";"Totalt";0;2168;41407;43575;0,0497532989099254;4,98
2010;"1780";"Totalt";0;2130;42898;45028;0,0473038997956827;4,73
2011;"1780";"Totalt";0;2087;43598;45685;0,0456823902812739;4,57
2012;"1780";"Totalt";0;1894;44158;46052;0,0411274211760618;4,11
2013;"1780";"Totalt";0;1917;44325;46242;0,0414558193849747;4,15
2014;"1780";"Totalt";0;1838;44955;46793;0,0392793793943539;3,93
2015;"1780";"Totalt";0;1871;46198;48069;0,0389232145457571;3,89
2016;"1780";"Totalt";0;1847;47115;48962;0,0377231322249908;3,77
2017;"1780";"Totalt";0;1859;47830;49689;0,037412707037775;3,74
2018;"1780";"Totalt";0;1807;48953;50760;0,0355988967691095;3,56
2019;"1780";"Totalt";0;1884;50499;52383;0,0359658667888437;3,6
2020;"1780";"Totalt";0;1728;49698;51426;0,0336016800840042;3,36
2021;"1780";"Totalt";0;1719;51683;53402;0,0321898056252575;3,22
2022;"1780";"Totalt";0;1880;54132;56012;0,0335642362350925;3,36
2007;"1781";"Totalt";0;183;8421;8604;0,0212691771269177;2,13
2008;"1781";"Totalt";0;169;8472;8641;0,0195579215368592;1,96
2009;"1781";"Totalt";0;158;7944;8102;0,0195013576894594;1,95
2010;"1781";"Totalt";0;175;8061;8236;0,0212481787275376;2,12
2011;"1781";"Totalt";0;166;7968;8134;0,0204081632653061;2,04
2012;"1781";"Totalt";0;155;7806;7961;0,0194699158397186;1,95
2013;"1781";"Totalt";0;163;7751;7914;0,020596411422795;2,06
2014;"1781";"Totalt";0;163;7836;7999;0,0203775471933992;2,04
2015;"1781";"Totalt";0;156;7748;7904;0,0197368421052632;1,97
2016;"1781";"Totalt";0;149;7729;7878;0,0189134298045189;1,89
2017;"1781";"Totalt";0;154;7782;7936;0,0194052419354839;1,94
2018;"1781";"Totalt";0;163;7619;7782;0,0209457722950398;2,09
2019;"1781";"Totalt";0;157;7818;7975;0,0196865203761755;1,97
2020;"1781";"Totalt";0;146;7592;7738;0,0188679245283019;1,89
2021;"1781";"Totalt";0;152;7675;7827;0,0194199565606235;1,94
2022;"1781";"Totalt";0;155;7663;7818;0,0198260424661039;1,98
2007;"1782";"Totalt";0;57;3796;3853;0,0147936672722554;1,48
2008;"1782";"Totalt";0;51;3702;3753;0,0135891286970424;1,36
2009;"1782";"Totalt";0;46;3460;3506;0,0131203650884199;1,31
2010;"1782";"Totalt";0;37;3509;3546;0,0104342921601805;1,04
2011;"1782";"Totalt";0;43;3568;3611;0,0119080587094988;1,19
2012;"1782";"Totalt";0;41;3574;3615;0,0113416320885201;1,13
2013;"1782";"Totalt";0;38;3581;3619;0,0105001381597126;1,05
2014;"1782";"Totalt";0;52;3511;3563;0,0145944428852091;1,46
2015;"1782";"Totalt";0;49;3405;3454;0,014186450492183;1,42
2016;"1782";"Totalt";0;48;3434;3482;0,0137851809304997;1,38
2017;"1782";"Totalt";0;52;3412;3464;0,0150115473441109;1,5
2018;"1782";"Totalt";0;53;3307;3360;0,0157738095238095;1,58
2019;"1782";"Totalt";0;58;3202;3260;0,0177914110429448;1,78
2020;"1782";"Totalt";0;55;3129;3184;0,0172738693467337;1,73
2021;"1782";"Totalt";0;49;3139;3188;0,0153701380175659;1,54
2022;"1782";"Totalt";0;59;3170;3229;0,0182719108082998;1,83
2007;"1783";"Totalt";0;69;4500;4569;0,0151017728168089;1,51
2008;"1783";"Totalt";0;64;4496;4560;0,0140350877192982;1,4
2009;"1783";"Totalt";0;56;4109;4165;0,0134453781512605;1,34
2010;"1783";"Totalt";0;55;4300;4355;0,0126291618828932;1,26
2011;"1783";"Totalt";0;56;4297;4353;0,012864691017689;1,29
2012;"1783";"Totalt";0;47;4240;4287;0,0109633776533707;1,1
2013;"1783";"Totalt";0;50;4179;4229;0,0118231260345235;1,18
2014;"1783";"Totalt";0;50;4128;4178;0,0119674485399713;1,2
2015;"1783";"Totalt";0;53;4191;4244;0,01248821866164;1,25
2016;"1783";"Totalt";0;54;4170;4224;0,0127840909090909;1,28
2017;"1783";"Totalt";0;59;4202;4261;0,013846514902605;1,38
2018;"1783";"Totalt";0;60;4243;4303;0,0139437601673251;1,39
2019;"1783";"Totalt";0;56;4050;4106;0,0136385776911836;1,36
2020;"1783";"Totalt";0;57;4047;4104;0,0138888888888889;1,39
2021;"1783";"Totalt";0;66;4082;4148;0,0159112825458052;1,59
2022;"1783";"Totalt";0;67;4183;4250;0,0157647058823529;1,58
2007;"1784";"Totalt";0;288;10527;10815;0,026629680998613;2,66
2008;"1784";"Totalt";0;250;10524;10774;0,023204009652868;2,32
2009;"1784";"Totalt";0;228;9502;9730;0,0234326824254882;2,34
2010;"1784";"Totalt";0;216;9837;10053;0,0214861235452104;2,15
2011;"1784";"Totalt";0;208;9742;9950;0,0209045226130653;2,09
2012;"1784";"Totalt";0;211;9504;9715;0,0217189912506433;2,17
2013;"1784";"Totalt";0;211;9699;9910;0,0212916246215943;2,13
2014;"1784";"Totalt";0;219;9620;9839;0,0222583595893892;2,23
2015;"1784";"Totalt";0;206;9631;9837;0,0209413439056623;2,09
2016;"1784";"Totalt";0;221;9630;9851;0,0224342706324231;2,24
2017;"1784";"Totalt";0;222;9694;9916;0,0223880597014925;2,24
2018;"1784";"Totalt";0;186;9874;10060;0,0184890656063618;1,85
2019;"1784";"Totalt";0;201;10083;10284;0,0195449241540257;1,95
2020;"1784";"Totalt";0;213;9901;10114;0,0210599169468064;2,11
2021;"1784";"Totalt";0;209;10035;10244;0,0204021866458415;2,04
2022;"1784";"Totalt";0;212;10417;10629;0,0199454323078371;1,99
2007;"1785";"Totalt";0;113;5620;5733;0,0197104482818769;1,97
2008;"1785";"Totalt";0;119;5574;5693;0,0209028631652907;2,09
2009;"1785";"Totalt";0;105;5296;5401;0,0194408442880948;1,94
2010;"1785";"Totalt";0;106;5264;5370;0,0197392923649907;1,97
2011;"1785";"Totalt";0;90;5328;5418;0,0166112956810631;1,66
2012;"1785";"Totalt";0;96;5338;5434;0,0176665439823335;1,77
2013;"1785";"Totalt";0;91;5261;5352;0,0170029895366218;1,7
2014;"1785";"Totalt";0;84;5097;5181;0,0162130862767805;1,62
2015;"1785";"Totalt";0;84;5346;5430;0,0154696132596685;1,55
2016;"1785";"Totalt";0;80;5542;5622;0,0142298114549982;1,42
2017;"1785";"Totalt";0;85;5711;5796;0,0146652864044168;1,47
2018;"1785";"Totalt";0;80;5627;5707;0,0140178727878045;1,4
2019;"1785";"Totalt";0;90;5444;5534;0,0162631008312252;1,63
2020;"1785";"Totalt";0;74;5337;5411;0,0136758454999076;1,37
2021;"1785";"Totalt";0;81;5351;5432;0,0149116347569956;1,49
2022;"1785";"Totalt";0;94;5221;5315;0,0176857949200376;1,77
2007;"1814";"Totalt";0;23;1522;1545;0,0148867313915858;1,49
2008;"1814";"Totalt";0;27;1578;1605;0,0168224299065421;1,68
2009;"1814";"Totalt";0;24;1534;1558;0,0154043645699615;1,54
2010;"1814";"Totalt";0;22;1608;1630;0,0134969325153374;1,35
2011;"1814";"Totalt";0;25;1655;1680;0,0148809523809524;1,49
2012;"1814";"Totalt";0;19;1711;1730;0,0109826589595376;1,1
2013;"1814";"Totalt";0;24;1788;1812;0,0132450331125828;1,32
2014;"1814";"Totalt";0;24;1775;1799;0,0133407448582546;1,33
2015;"1814";"Totalt";0;26;1822;1848;0,0140692640692641;1,41
2016;"1814";"Totalt";0;28;1867;1895;0,0147757255936675;1,48
2017;"1814";"Totalt";0;23;1938;1961;0,0117287098419174;1,17
2018;"1814";"Totalt";0;21;1983;2004;0,0104790419161677;1,05
2019;"1814";"Totalt";0;23;2008;2031;0,0113244707040867;1,13
2020;"1814";"Totalt";0;26;2030;2056;0,0126459143968872;1,26
2021;"1814";"Totalt";0;24;2082;2106;0,0113960113960114;1,14
2022;"1814";"Totalt";0;29;2186;2215;0,0130925507900677;1,31
2007;"1860";"Totalt";0;35;2529;2564;0,0136505460218409;1,37
2008;"1860";"Totalt";0;32;2601;2633;0,0121534371439423;1,22
2009;"1860";"Totalt";0;36;2361;2397;0,0150187734668335;1,5
2010;"1860";"Totalt";0;24;2463;2487;0,00965018094089264;0,97
2011;"1860";"Totalt";0;28;2457;2485;0,0112676056338028;1,13
2012;"1860";"Totalt";0;28;2289;2317;0,0120845921450151;1,21
2013;"1860";"Totalt";0;27;2083;2110;0,0127962085308057;1,28
2014;"1860";"Totalt";0;29;1976;2005;0,0144638403990025;1,45
2015;"1860";"Totalt";0;29;1986;2015;0,0143920595533499;1,44
2016;"1860";"Totalt";0;29;2092;2121;0,0136727958510137;1,37
2017;"1860";"Totalt";0;23;2092;2115;0,0108747044917258;1,09
2018;"1860";"Totalt";0;22;2116;2138;0,010289990645463;1,03
2019;"1860";"Totalt";0;18;2111;2129;0,00845467355565993;0,85
2020;"1860";"Totalt";0;13;2038;2051;0,00633837152608484;0,63
2021;"1860";"Totalt";0;16;2048;2064;0,00775193798449612;0,78
2022;"1860";"Totalt";0;17;2059;2076;0,0081888246628131;0,82
2007;"1861";"Totalt";0;152;6969;7121;0,0213453166690072;2,13
2008;"1861";"Totalt";0;154;7060;7214;0,0213473800942612;2,13
2009;"1861";"Totalt";0;135;6499;6634;0,0203497135966235;2,03
2010;"1861";"Totalt";0;140;6429;6569;0,0213122240828132;2,13
2011;"1861";"Totalt";0;140;6572;6712;0,0208581644815256;2,09
2012;"1861";"Totalt";0;139;6566;6705;0,020730797912006;2,07
2013;"1861";"Totalt";0;131;6666;6797;0,0192732087685744;1,93
2014;"1861";"Totalt";0;105;6896;7001;0,0149978574489359;1,5
2015;"1861";"Totalt";0;99;7059;7158;0,0138306789606035;1,38
2016;"1861";"Totalt";0;96;7070;7166;0,013396595032096;1,34
2017;"1861";"Totalt";0;91;7077;7168;0,0126953125;1,27
2018;"1861";"Totalt";0;100;7346;7446;0,013430029546065;1,34
2019;"1861";"Totalt";0;100;7238;7338;0,0136276914690651;1,36
2020;"1861";"Totalt";0;85;7197;7282;0,0116726174127987;1,17
2021;"1861";"Totalt";0;89;7440;7529;0,0118209589586931;1,18
2022;"1861";"Totalt";0;93;7458;7551;0,012316249503377;1,23
2007;"1862";"Totalt";0;40;2792;2832;0,0141242937853107;1,41
2008;"1862";"Totalt";0;35;2870;2905;0,0120481927710843;1,2
2009;"1862";"Totalt";0;29;2679;2708;0,0107090103397341;1,07
2010;"1862";"Totalt";0;38;2634;2672;0,0142215568862275;1,42
2011;"1862";"Totalt";0;36;2632;2668;0,0134932533733133;1,35
2012;"1862";"Totalt";0;30;2575;2605;0,0115163147792706;1,15
2013;"1862";"Totalt";0;26;2540;2566;0,0101325019485581;1,01
2014;"1862";"Totalt";0;24;2594;2618;0,00916730328495034;0,92
2015;"1862";"Totalt";0;30;2525;2555;0,0117416829745597;1,17
2016;"1862";"Totalt";0;27;2524;2551;0,0105840846726774;1,06
2017;"1862";"Totalt";0;22;2519;2541;0,00865800865800866;0,87
2018;"1862";"Totalt";0;20;2556;2576;0,0077639751552795;0,78
2019;"1862";"Totalt";0;22;2552;2574;0,00854700854700855;0,85
2020;"1862";"Totalt";0;22;2471;2493;0,00882470918572002;0,88
2021;"1862";"Totalt";0;21;2462;2483;0,00845751107531212;0,85
2022;"1862";"Totalt";0;21;2530;2551;0,00823206585652685;0,82
2007;"1863";"Totalt";0;36;2567;2603;0,0138301959277756;1,38
2008;"1863";"Totalt";0;50;2560;2610;0,0191570881226054;1,92
2009;"1863";"Totalt";0;53;2408;2461;0,0215359609914669;2,15
2010;"1863";"Totalt";0;54;2406;2460;0,0219512195121951;2,2
2011;"1863";"Totalt";0;42;2444;2486;0,0168946098149638;1,69
2012;"1863";"Totalt";0;41;2387;2428;0,0168863261943987;1,69
2013;"1863";"Totalt";0;39;2400;2439;0,015990159901599;1,6
2014;"1863";"Totalt";0;37;2404;2441;0,0151577222449816;1,52
2015;"1863";"Totalt";0;40;2359;2399;0,0166736140058358;1,67
2016;"1863";"Totalt";0;42;2419;2461;0,0170662332385209;1,71
2017;"1863";"Totalt";0;39;2415;2454;0,0158924205378973;1,59
2018;"1863";"Totalt";0;38;2493;2531;0,0150138285262742;1,5
2019;"1863";"Totalt";0;31;2363;2394;0,0129490392648287;1,29
2020;"1863";"Totalt";0;35;2315;2350;0,0148936170212766;1,49
2021;"1863";"Totalt";0;36;2324;2360;0,0152542372881356;1,53
2022;"1863";"Totalt";0;36;2419;2455;0,0146639511201629;1,47
2007;"1864";"Totalt";0;26;1564;1590;0,0163522012578616;1,64
2008;"1864";"Totalt";0;25;1547;1572;0,0159033078880407;1,59
2009;"1864";"Totalt";0;23;1428;1451;0,0158511371467953;1,59
2010;"1864";"Totalt";0;20;1452;1472;0,0135869565217391;1,36
2011;"1864";"Totalt";0;20;1480;1500;0,0133333333333333;1,33
2012;"1864";"Totalt";0;13;1465;1478;0,0087956698240866;0,88
2013;"1864";"Totalt";0;23;1486;1509;0,0152418820410868;1,52
2014;"1864";"Totalt";0;14;1480;1494;0,00937081659973226;0,94
2015;"1864";"Totalt";0;17;1543;1560;0,0108974358974359;1,09
2016;"1864";"Totalt";0;19;1520;1539;0,0123456790123457;1,23
2017;"1864";"Totalt";0;27;1539;1566;0,0172413793103448;1,72
2018;"1864";"Totalt";0;27;1577;1604;0,0168329177057357;1,68
2019;"1864";"Totalt";0;24;1534;1558;0,0154043645699615;1,54
2020;"1864";"Totalt";0;24;1488;1512;0,0158730158730159;1,59
2021;"1864";"Totalt";0;25;1450;1475;0,0169491525423729;1,69
2022;"1864";"Totalt";0;30;1471;1501;0,0199866755496336;2
2007;"1880";"Totalt";0;3036;61728;64764;0,0468778951269224;4,69
2008;"1880";"Totalt";0;3016;62335;65351;0,0461507857569127;4,62
2009;"1880";"Totalt";0;2893;59713;62606;0,0462096284701147;4,62
2010;"1880";"Totalt";0;2889;61360;64249;0,0449656803996949;4,5
2011;"1880";"Totalt";0;2785;62616;65401;0,0425834467362884;4,26
2012;"1880";"Totalt";0;2769;64654;67423;0,0410690713851356;4,11
2013;"1880";"Totalt";0;2740;65227;67967;0,0403136816396192;4,03
2014;"1880";"Totalt";0;2669;66269;68938;0,0387159476631176;3,87
2015;"1880";"Totalt";0;2593;68056;70649;0,0367025718693824;3,67
2016;"1880";"Totalt";0;2620;69765;72385;0,0361953443392968;3,62
2017;"1880";"Totalt";0;2697;71847;74544;0,0361799742433999;3,62
2018;"1880";"Totalt";0;2686;73669;76355;0,035177787964115;3,52
2019;"1880";"Totalt";0;2762;76179;78941;0,0349881557112274;3,5
2020;"1880";"Totalt";0;2434;76901;79335;0,0306800277305099;3,07
2021;"1880";"Totalt";0;2374;78961;81335;0,0291879264769165;2,92
2022;"1880";"Totalt";0;2587;81044;83631;0,0309335055182887;3,09
2007;"1881";"Totalt";0;225;6561;6786;0,0331564986737401;3,32
2008;"1881";"Totalt";0;216;6256;6472;0,0333745364647713;3,34
2009;"1881";"Totalt";0;191;6137;6328;0,0301833122629583;3,02
2010;"1881";"Totalt";0;184;6299;6483;0,0283819219497146;2,84
2011;"1881";"Totalt";0;179;6452;6631;0,0269944201477907;2,7
2012;"1881";"Totalt";0;195;6663;6858;0,0284339457567804;2,84
2013;"1881";"Totalt";0;183;6637;6820;0,0268328445747801;2,68
2014;"1881";"Totalt";0;175;6678;6853;0,0255362614913177;2,55
2015;"1881";"Totalt";0;189;6703;6892;0,027423099245502;2,74
2016;"1881";"Totalt";0;173;7016;7189;0,0240645430518848;2,41
2017;"1881";"Totalt";0;171;7011;7182;0,0238095238095238;2,38
2018;"1881";"Totalt";0;187;6883;7070;0,0264497878359264;2,64
2019;"1881";"Totalt";0;183;6641;6824;0,0268171160609613;2,68
2020;"1881";"Totalt";0;161;6518;6679;0,0241054050007486;2,41
2021;"1881";"Totalt";0;157;6655;6812;0,023047563123899;2,3
2022;"1881";"Totalt";0;157;6850;7007;0,0224061652633081;2,24
2007;"1882";"Totalt";0;66;3373;3439;0,0191916254725211;1,92
2008;"1882";"Totalt";0;70;3429;3499;0,020005715918834;2
2009;"1882";"Totalt";0;80;3286;3366;0,023767082590612;2,38
2010;"1882";"Totalt";0;73;3351;3424;0,0213200934579439;2,13
2011;"1882";"Totalt";0;71;3398;3469;0,0204669933698472;2,05
2012;"1882";"Totalt";0;74;3416;3490;0,0212034383954155;2,12
2013;"1882";"Totalt";0;71;3441;3512;0,0202164009111617;2,02
2014;"1882";"Totalt";0;73;3547;3620;0,0201657458563536;2,02
2015;"1882";"Totalt";0;68;3631;3699;0,0183833468505001;1,84
2016;"1882";"Totalt";0;70;3800;3870;0,0180878552971576;1,81
2017;"1882";"Totalt";0;74;3893;3967;0,0186538946307033;1,87
2018;"1882";"Totalt";0;67;3898;3965;0,0168978562421185;1,69
2019;"1882";"Totalt";0;70;3813;3883;0,0180272984805563;1,8
2020;"1882";"Totalt";0;71;3801;3872;0,0183367768595041;1,83
2021;"1882";"Totalt";0;72;3911;3983;0,0180768265126789;1,81
2022;"1882";"Totalt";0;71;4056;4127;0,0172037799854616;1,72
2007;"1883";"Totalt";0;386;14135;14521;0,0265821913091385;2,66
2008;"1883";"Totalt";0;385;13990;14375;0,0267826086956522;2,68
2009;"1883";"Totalt";0;361;13209;13570;0,0266028002947679;2,66
2010;"1883";"Totalt";0;367;12967;13334;0,0275236238188091;2,75
2011;"1883";"Totalt";0;351;12997;13348;0,0262960743182499;2,63
2012;"1883";"Totalt";0;326;13442;13768;0,023678094131319;2,37
2013;"1883";"Totalt";0;324;13354;13678;0,0236876736364966;2,37
2014;"1883";"Totalt";0;310;13297;13607;0,0227823914161828;2,28
2015;"1883";"Totalt";0;297;13373;13670;0,0217264081931236;2,17
2016;"1883";"Totalt";0;290;13526;13816;0,0209901563404748;2,1
2017;"1883";"Totalt";0;288;13593;13881;0,0207477847417333;2,07
2018;"1883";"Totalt";0;269;13503;13772;0,019532384548359;1,95
2019;"1883";"Totalt";0;291;13254;13545;0,021483942414175;2,15
2020;"1883";"Totalt";0;283;13213;13496;0,0209691760521636;2,1
2021;"1883";"Totalt";0;268;13526;13794;0,0194287371320864;1,94
2022;"1883";"Totalt";0;296;13877;14173;0,0208847809214704;2,09
2007;"1884";"Totalt";0;112;2984;3096;0,0361757105943152;3,62
2008;"1884";"Totalt";0;104;2958;3062;0,0339647289353364;3,4
2009;"1884";"Totalt";0;88;2819;2907;0,0302717578259374;3,03
2010;"1884";"Totalt";0;92;2866;2958;0,0311020960108181;3,11
2011;"1884";"Totalt";0;81;2889;2970;0,0272727272727273;2,73
2012;"1884";"Totalt";0;74;2866;2940;0,0251700680272109;2,52
2013;"1884";"Totalt";0;78;2855;2933;0,0265939311285373;2,66
2014;"1884";"Totalt";0;85;2793;2878;0,0295343988881167;2,95
2015;"1884";"Totalt";0;80;2775;2855;0,0280210157618214;2,8
2016;"1884";"Totalt";0;69;2835;2904;0,0237603305785124;2,38
2017;"1884";"Totalt";0;74;2958;3032;0,0244063324538259;2,44
2018;"1884";"Totalt";0;76;2963;3039;0,02500822639026;2,5
2019;"1884";"Totalt";0;82;2869;2951;0,0277871907827855;2,78
2020;"1884";"Totalt";0;93;2839;2932;0,031718963165075;3,17
2021;"1884";"Totalt";0;102;2920;3022;0,0337524818001324;3,38
2022;"1884";"Totalt";0;104;3055;3159;0,0329218106995885;3,29
2007;"1885";"Totalt";0;216;9314;9530;0,0226652675760756;2,27
2008;"1885";"Totalt";0;214;9283;9497;0,0225334316099821;2,25
2009;"1885";"Totalt";0;189;8665;8854;0,021346284165349;2,13
2010;"1885";"Totalt";0;184;8818;9002;0,0204399022439458;2,04
2011;"1885";"Totalt";0;145;9215;9360;0,015491452991453;1,55
2012;"1885";"Totalt";0;142;9309;9451;0,0150248650936409;1,5
2013;"1885";"Totalt";0;141;9359;9500;0,0148421052631579;1,48
2014;"1885";"Totalt";0;149;9216;9365;0,0159103043246129;1,59
2015;"1885";"Totalt";0;142;9290;9432;0,0150551314673452;1,51
2016;"1885";"Totalt";0;135;9581;9716;0,0138946068340881;1,39
2017;"1885";"Totalt";0;131;9637;9768;0,0134111384111384;1,34
2018;"1885";"Totalt";0;140;9707;9847;0,0142175281811719;1,42
2019;"1885";"Totalt";0;129;9636;9765;0,01321044546851;1,32
2020;"1885";"Totalt";0;106;9318;9424;0,0112478777589134;1,12
2021;"1885";"Totalt";0;111;9499;9610;0,0115504682622268;1,16
2022;"1885";"Totalt";0;105;9662;9767;0,0107504863315245;1,08
2007;"1904";"Totalt";0;21;1391;1412;0,0148725212464589;1,49
2008;"1904";"Totalt";0;19;1349;1368;0,0138888888888889;1,39
2009;"1904";"Totalt";0;14;1283;1297;0,0107941403238242;1,08
2010;"1904";"Totalt";0;15;1294;1309;0,0114591291061879;1,15
2011;"1904";"Totalt";0;17;1357;1374;0,012372634643377;1,24
2012;"1904";"Totalt";0;22;1411;1433;0,0153524075366364;1,54
2013;"1904";"Totalt";0;20;1426;1446;0,0138312586445367;1,38
2014;"1904";"Totalt";0;16;1424;1440;0,0111111111111111;1,11
2015;"1904";"Totalt";0;15;1418;1433;0,0104675505931612;1,05
2016;"1904";"Totalt";0;21;1469;1490;0,0140939597315436;1,41
2017;"1904";"Totalt";0;20;1472;1492;0,0134048257372654;1,34
2018;"1904";"Totalt";0;18;1444;1462;0,012311901504788;1,23
2019;"1904";"Totalt";0;23;1399;1422;0,0161744022503516;1,62
2020;"1904";"Totalt";0;19;1389;1408;0,0134943181818182;1,35
2021;"1904";"Totalt";0;19;1433;1452;0,0130853994490358;1,31
2022;"1904";"Totalt";0;13;1517;1530;0,00849673202614379;0,85
2007;"1907";"Totalt";0;36;3092;3128;0,0115089514066496;1,15
2008;"1907";"Totalt";0;34;3051;3085;0,0110210696920583;1,1
2009;"1907";"Totalt";0;33;2807;2840;0,0116197183098592;1,16
2010;"1907";"Totalt";0;34;2715;2749;0,0123681338668607;1,24
2011;"1907";"Totalt";0;40;2734;2774;0,0144196106705119;1,44
2012;"1907";"Totalt";0;37;2709;2746;0,0134741442097597;1,35
2013;"1907";"Totalt";0;38;2569;2607;0,0145761411584196;1,46
2014;"1907";"Totalt";0;35;2537;2572;0,0136080870917574;1,36
2015;"1907";"Totalt";0;28;2502;2530;0,0110671936758893;1,11
2016;"1907";"Totalt";0;32;2532;2564;0,0124804992199688;1,25
2017;"1907";"Totalt";0;24;2449;2473;0,0097048119692681;0,97
2018;"1907";"Totalt";0;22;2485;2507;0,00877542879936179;0,88
2019;"1907";"Totalt";0;20;2439;2459;0,00813338755591704;0,81
2020;"1907";"Totalt";0;16;2412;2428;0,00658978583196046;0,66
2021;"1907";"Totalt";0;13;2451;2464;0,00527597402597403;0,53
2022;"1907";"Totalt";0;13;2446;2459;0,00528670191134608;0,53
2007;"1960";"Totalt";0;20;2993;3013;0,00663790242283438;0,66
2008;"1960";"Totalt";0;21;2904;2925;0,00717948717948718;0,72
2009;"1960";"Totalt";0;22;2493;2515;0,00874751491053678;0,87
2010;"1960";"Totalt";0;22;2378;2400;0,00916666666666667;0,92
2011;"1960";"Totalt";0;24;2093;2117;0,0113367973547473;1,13
2012;"1960";"Totalt";0;21;2113;2134;0,0098406747891284;0,98
2013;"1960";"Totalt";0;19;2087;2106;0,00902184235517569;0,9
2014;"1960";"Totalt";0;21;2066;2087;0,0100622903689506;1,01
2015;"1960";"Totalt";0;27;2098;2125;0,0127058823529412;1,27
2016;"1960";"Totalt";0;25;2183;2208;0,0113224637681159;1,13
2017;"1960";"Totalt";0;28;2211;2239;0,0125055828494864;1,25
2018;"1960";"Totalt";0;34;2334;2368;0,0143581081081081;1,44
2019;"1960";"Totalt";0;37;2354;2391;0,0154746967795901;1,55
2020;"1960";"Totalt";0;31;2338;2369;0,0130856901646264;1,31
2021;"1960";"Totalt";0;34;2361;2395;0,01419624217119;1,42
2022;"1960";"Totalt";0;30;2451;2481;0,0120918984280532;1,21
2007;"1961";"Totalt";0;75;5400;5475;0,0136986301369863;1,37
2008;"1961";"Totalt";0;69;5222;5291;0,013041013041013;1,3
2009;"1961";"Totalt";0;60;4831;4891;0,0122674299734206;1,23
2010;"1961";"Totalt";0;63;4740;4803;0,0131168019987508;1,31
2011;"1961";"Totalt";0;55;4736;4791;0,0114798580672094;1,15
2012;"1961";"Totalt";0;52;4658;4710;0,0110403397027601;1,1
2013;"1961";"Totalt";0;53;4602;4655;0,0113856068743287;1,14
2014;"1961";"Totalt";0;60;4500;4560;0,0131578947368421;1,32
2015;"1961";"Totalt";0;47;4550;4597;0,0102240591690233;1,02
2016;"1961";"Totalt";0;41;4739;4780;0,00857740585774058;0,86
2017;"1961";"Totalt";0;33;4814;4847;0,00680833505260986;0,68
2018;"1961";"Totalt";0;31;4886;4917;0,00630465731136872;0,63
2019;"1961";"Totalt";0;42;4895;4937;0,00850719060157991;0,85
2020;"1961";"Totalt";0;42;4803;4845;0,0086687306501548;0,87
2021;"1961";"Totalt";0;38;4903;4941;0,00769075086014977;0,77
2022;"1961";"Totalt";0;39;4958;4997;0,00780468280968581;0,78
2007;"1962";"Totalt";0;47;1531;1578;0,0297845373891001;2,98
2008;"1962";"Totalt";0;43;1556;1599;0,0268918073796123;2,69
2009;"1962";"Totalt";0;35;1406;1441;0,0242886884108258;2,43
2010;"1962";"Totalt";0;31;1450;1481;0,0209318028359217;2,09
2011;"1962";"Totalt";0;33;1427;1460;0,0226027397260274;2,26
2012;"1962";"Totalt";0;33;1419;1452;0,0227272727272727;2,27
2013;"1962";"Totalt";0;29;1458;1487;0,019502353732347;1,95
2014;"1962";"Totalt";0;28;1498;1526;0,018348623853211;1,83
2015;"1962";"Totalt";0;36;1517;1553;0,0231809401159047;2,32
2016;"1962";"Totalt";0;34;1645;1679;0,0202501488981537;2,03
2017;"1962";"Totalt";0;31;1726;1757;0,0176437108708025;1,76
2018;"1962";"Totalt";0;28;1736;1764;0,0158730158730159;1,59
2019;"1962";"Totalt";0;29;1630;1659;0,0174804098854732;1,75
2020;"1962";"Totalt";0;23;1535;1558;0,0147625160462131;1,48
2021;"1962";"Totalt";0;24;1642;1666;0,014405762304922;1,44
2022;"1962";"Totalt";0;27;1545;1572;0,017175572519084;1,72
2007;"1980";"Totalt";0;2702;58922;61624;0,0438465532909256;4,38
2008;"1980";"Totalt";0;2753;58643;61396;0,0448400547266923;4,48
2009;"1980";"Totalt";0;2503;57487;59990;0,0417236206034339;4,17
2010;"1980";"Totalt";0;2521;59783;62304;0,0404628916281459;4,05
2011;"1980";"Totalt";0;2667;61143;63810;0,0417959567465914;4,18
2012;"1980";"Totalt";0;2709;62335;65044;0,0416487300904003;4,16
2013;"1980";"Totalt";0;2600;63708;66308;0,0392109549375641;3,92
2014;"1980";"Totalt";0;2389;64259;66648;0,0358450366102509;3,58
2015;"1980";"Totalt";0;2366;64794;67160;0,0352293031566409;3,52
2016;"1980";"Totalt";0;2463;65247;67710;0,0363757199822774;3,64
2017;"1980";"Totalt";0;2380;66694;69074;0,0344558010249877;3,45
2018;"1980";"Totalt";0;2331;68334;70665;0,0329866270430906;3,3
2019;"1980";"Totalt";0;2330;69378;71708;0,0324928878228371;3,25
2020;"1980";"Totalt";0;2093;69528;71621;0,0292232725038746;2,92
2021;"1980";"Totalt";0;2064;71701;73765;0,0279807496780316;2,8
2022;"1980";"Totalt";0;2082;74179;76261;0,0273009795308218;2,73
2007;"1981";"Totalt";0;227;7240;7467;0,0304004285522968;3,04
2008;"1981";"Totalt";0;249;7330;7579;0,0328539385143159;3,29
2009;"1981";"Totalt";0;246;7064;7310;0,0336525307797538;3,37
2010;"1981";"Totalt";0;267;7117;7384;0,0361592632719393;3,62
2011;"1981";"Totalt";0;238;7052;7290;0,0326474622770919;3,26
2012;"1981";"Totalt";0;230;6924;7154;0,0321498462398658;3,21
2013;"1981";"Totalt";0;222;6913;7135;0,031114225648213;3,11
2014;"1981";"Totalt";0;224;6818;7042;0,0318091451292246;3,18
2015;"1981";"Totalt";0;225;6919;7144;0,031494960806271;3,15
2016;"1981";"Totalt";0;206;6992;7198;0,0286190608502362;2,86
2017;"1981";"Totalt";0;220;6991;7211;0,0305089446678685;3,05
2018;"1981";"Totalt";0;230;7102;7332;0,0313693398799782;3,14
2019;"1981";"Totalt";0;219;7368;7587;0,0288651640964808;2,89
2020;"1981";"Totalt";0;170;7311;7481;0,0227242347279775;2,27
2021;"1981";"Totalt";0;164;7467;7631;0,0214912855458;2,15
2022;"1981";"Totalt";0;175;7810;7985;0,0219160926737633;2,19
2007;"1982";"Totalt";0;100;6113;6213;0,016095284081764;1,61
2008;"1982";"Totalt";0;91;6281;6372;0,0142812303829253;1,43
2009;"1982";"Totalt";0;99;5769;5868;0,0168711656441718;1,69
2010;"1982";"Totalt";0;127;5798;5925;0,0214345991561181;2,14
2011;"1982";"Totalt";0;71;6084;6155;0,0115353371242892;1,15
2012;"1982";"Totalt";0;77;6133;6210;0,0123993558776167;1,24
2013;"1982";"Totalt";0;80;6121;6201;0,0129011449766167;1,29
2014;"1982";"Totalt";0;83;6146;6229;0,0133247712313373;1,33
2015;"1982";"Totalt";0;73;6153;6226;0,0117250240925153;1,17
2016;"1982";"Totalt";0;71;6131;6202;0,0114479200257981;1,14
2017;"1982";"Totalt";0;72;6219;6291;0,011444921316166;1,14
2018;"1982";"Totalt";0;71;6247;6318;0,0112377334599557;1,12
2019;"1982";"Totalt";0;70;6145;6215;0,0112630732099759;1,13
2020;"1982";"Totalt";0;63;5935;5998;0,0105035011670557;1,05
2021;"1982";"Totalt";0;53;5861;5914;0,00896178559350693;0,9
2022;"1982";"Totalt";0;58;5915;5973;0,00971036330152352;0,97
2007;"1983";"Totalt";0;227;11216;11443;0,0198374552127938;1,98
2008;"1983";"Totalt";0;224;11291;11515;0,0194528875379939;1,95
2009;"1983";"Totalt";0;208;10057;10265;0,0202630297126157;2,03
2010;"1983";"Totalt";0;197;9735;9932;0,0198348771647201;1,98
2011;"1983";"Totalt";0;197;9652;9849;0,0200020306630115;2
2012;"1983";"Totalt";0;196;9919;10115;0,0193771626297578;1,94
2013;"1983";"Totalt";0;194;10152;10346;0,0187512081964044;1,88
2014;"1983";"Totalt";0;181;10458;10639;0,0170128771501081;1,7
2015;"1983";"Totalt";0;182;10655;10837;0,0167943157700471;1,68
2016;"1983";"Totalt";0;191;10882;11073;0,017249164634697;1,72
2017;"1983";"Totalt";0;192;11015;11207;0,0171321495493888;1,71
2018;"1983";"Totalt";0;164;11241;11405;0,0143796580447172;1,44
2019;"1983";"Totalt";0;180;11374;11554;0,0155790202527263;1,56
2020;"1983";"Totalt";0;171;11056;11227;0,0152311392179567;1,52
2021;"1983";"Totalt";0;157;10885;11042;0,0142184386886434;1,42
2022;"1983";"Totalt";0;163;11136;11299;0,014426055403133;1,44
2007;"1984";"Totalt";0;79;5007;5086;0,0155328352339756;1,55
2008;"1984";"Totalt";0;82;4904;4986;0,0164460489370237;1,64
2009;"1984";"Totalt";0;90;4745;4835;0,0186142709410548;1,86
2010;"1984";"Totalt";0;90;4828;4918;0,0183001220008133;1,83
2011;"1984";"Totalt";0;63;4839;4902;0,0128518971848225;1,29
2012;"1984";"Totalt";0;61;4992;5053;0,0120720364140115;1,21
2013;"1984";"Totalt";0;60;4982;5042;0,0119000396667989;1,19
2014;"1984";"Totalt";0;58;4917;4975;0,0116582914572864;1,17
2015;"1984";"Totalt";0;60;4894;4954;0,0121114251110214;1,21
2016;"1984";"Totalt";0;66;4986;5052;0,0130641330166271;1,31
2017;"1984";"Totalt";0;59;5100;5159;0,0114363248691607;1,14
2018;"1984";"Totalt";0;54;5036;5090;0,0106090373280943;1,06
2019;"1984";"Totalt";0;58;4944;5002;0,0115953618552579;1,16
2020;"1984";"Totalt";0;56;4394;4450;0,0125842696629213;1,26
2021;"1984";"Totalt";0;51;4415;4466;0,0114196148678907;1,14
2022;"1984";"Totalt";0;55;4453;4508;0,0122005323868678;1,22
2007;"2021";"Totalt";0;40;2465;2505;0,0159680638722555;1,6
2008;"2021";"Totalt";0;39;2398;2437;0,0160032827246615;1,6
2009;"2021";"Totalt";0;36;2287;2323;0,0154972018941025;1,55
2010;"2021";"Totalt";0;28;2328;2356;0,0118845500848896;1,19
2011;"2021";"Totalt";0;28;2346;2374;0,0117944397641112;1,18
2012;"2021";"Totalt";0;34;2338;2372;0,0143338954468803;1,43
2013;"2021";"Totalt";0;36;2314;2350;0,0153191489361702;1,53
2014;"2021";"Totalt";0;31;2287;2318;0,0133735979292494;1,34
2015;"2021";"Totalt";0;32;2298;2330;0,0137339055793991;1,37
2016;"2021";"Totalt";0;35;2381;2416;0,0144867549668874;1,45
2017;"2021";"Totalt";0;34;2501;2535;0,0134122287968442;1,34
2018;"2021";"Totalt";0;33;2496;2529;0,0130486358244365;1,3
2019;"2021";"Totalt";0;34;2612;2646;0,0128495842781557;1,28
2020;"2021";"Totalt";0;34;2635;2669;0,0127388535031847;1,27
2021;"2021";"Totalt";0;27;2812;2839;0,0095103909827404;0,95
2022;"2021";"Totalt";0;30;2943;2973;0,0100908173562059;1,01
2007;"2023";"Totalt";0;157;5180;5337;0,0294172756230092;2,94
2008;"2023";"Totalt";0;166;5216;5382;0,030843552582683;3,08
2009;"2023";"Totalt";0;146;5151;5297;0,0275627713800264;2,76
2010;"2023";"Totalt";0;149;5388;5537;0,0269098789958461;2,69
2011;"2023";"Totalt";0;146;5267;5413;0,026972104193608;2,7
2012;"2023";"Totalt";0;124;5172;5296;0,0234138972809668;2,34
2013;"2023";"Totalt";0;129;5145;5274;0,0244596131968146;2,45
2014;"2023";"Totalt";0;119;5088;5207;0,02285385058575;2,29
2015;"2023";"Totalt";0;114;5076;5190;0,0219653179190751;2,2
2016;"2023";"Totalt";0;110;5269;5379;0,0204498977505112;2,04
2017;"2023";"Totalt";0;101;5234;5335;0,0189315838800375;1,89
2018;"2023";"Totalt";0;104;5305;5409;0,0192272139027547;1,92
2019;"2023";"Totalt";0;98;4938;5036;0,0194598888006354;1,95
2020;"2023";"Totalt";0;81;4921;5002;0,0161935225909636;1,62
2021;"2023";"Totalt";0;74;5003;5077;0,0145755367342919;1,46
2022;"2023";"Totalt";0;76;5321;5397;0,0140818973503798;1,41
2007;"2026";"Totalt";0;35;2511;2546;0,0137470542026709;1,37
2008;"2026";"Totalt";0;40;2442;2482;0,016116035455278;1,61
2009;"2026";"Totalt";0;27;2377;2404;0,0112312811980033;1,12
2010;"2026";"Totalt";0;37;2382;2419;0,0152955766845804;1,53
2011;"2026";"Totalt";0;34;2458;2492;0,0136436597110754;1,36
2012;"2026";"Totalt";0;34;2437;2471;0,0137596114933225;1,38
2013;"2026";"Totalt";0;28;2403;2431;0,011517893870835;1,15
2014;"2026";"Totalt";0;32;2426;2458;0,0130187144019528;1,3
2015;"2026";"Totalt";0;39;2518;2557;0,0152522487289793;1,53
2016;"2026";"Totalt";0;56;2616;2672;0,0209580838323353;2,1
2017;"2026";"Totalt";0;30;2573;2603;0,0115251632731464;1,15
2018;"2026";"Totalt";0;28;2499;2527;0,0110803324099723;1,11
2019;"2026";"Totalt";0;32;2554;2586;0,0123743232791957;1,24
2020;"2026";"Totalt";0;32;2621;2653;0,0120618168111572;1,21
2021;"2026";"Totalt";0;32;2692;2724;0,0117474302496329;1,17
2022;"2026";"Totalt";0;41;2652;2693;0,0152246565168957;1,52
2007;"2029";"Totalt";0;226;5794;6020;0,0375415282392027;3,75
2008;"2029";"Totalt";0;223;5718;5941;0,0375357683891601;3,75
2009;"2029";"Totalt";0;192;5632;5824;0,032967032967033;3,3
2010;"2029";"Totalt";0;188;5803;5991;0,0313804039392422;3,14
2011;"2029";"Totalt";0;180;5838;6018;0,0299102691924227;2,99
2012;"2029";"Totalt";0;194;5893;6087;0,0318712009199934;3,19
2013;"2029";"Totalt";0;189;5933;6122;0,0308722639660242;3,09
2014;"2029";"Totalt";0;167;6031;6198;0,0269441755404969;2,69
2015;"2029";"Totalt";0;173;5973;6146;0,0281483891962252;2,81
2016;"2029";"Totalt";0;293;5956;6249;0,0468875020003201;4,69
2017;"2029";"Totalt";0;318;5940;6258;0,0508149568552253;5,08
2018;"2029";"Totalt";0;338;6050;6388;0,0529117094552286;5,29
2019;"2029";"Totalt";0;319;6064;6383;0,0499765000783331;5
2020;"2029";"Totalt";0;320;5762;6082;0,0526142716211772;5,26
2021;"2029";"Totalt";0;343;5954;6297;0,0544703827219311;5,45
2022;"2029";"Totalt";0;354;6073;6427;0,0550801306986152;5,51
2007;"2031";"Totalt";0;149;3199;3348;0,0445041816009558;4,45
2008;"2031";"Totalt";0;146;3216;3362;0,0434265318262939;4,34
2009;"2031";"Totalt";0;145;3304;3449;0,0420411713540157;4,2
2010;"2031";"Totalt";0;140;3249;3389;0,04131012097964;4,13
2011;"2031";"Totalt";0;129;3203;3332;0,0387154861944778;3,87
2012;"2031";"Totalt";0;136;3241;3377;0,04027243115191;4,03
2013;"2031";"Totalt";0;138;3156;3294;0,0418943533697632;4,19
2014;"2031";"Totalt";0;131;3212;3343;0,0391863595572839;3,92
2015;"2031";"Totalt";0;127;3221;3348;0,0379330943847073;3,79
2016;"2031";"Totalt";0;126;3306;3432;0,0367132867132867;3,67
2017;"2031";"Totalt";0;135;3260;3395;0,0397643593519882;3,98
2018;"2031";"Totalt";0;122;3281;3403;0,0358507199529827;3,59
2019;"2031";"Totalt";0;124;3368;3492;0,0355097365406644;3,55
2020;"2031";"Totalt";0;141;3238;3379;0,0417283219887541;4,17
2021;"2031";"Totalt";0;168;3543;3711;0,0452708164915117;4,53
2022;"2031";"Totalt";0;178;3776;3954;0,0450177035913;4,5
2007;"2034";"Totalt";0;65;1794;1859;0,034965034965035;3,5
2008;"2034";"Totalt";0;62;1865;1927;0,0321743642968345;3,22
2009;"2034";"Totalt";0;49;1775;1824;0,0268640350877193;2,69
2010;"2034";"Totalt";0;62;1833;1895;0,0327176781002639;3,27
2011;"2034";"Totalt";0;53;1831;1884;0,0281316348195329;2,81
2012;"2034";"Totalt";0;51;1857;1908;0,0267295597484277;2,67
2013;"2034";"Totalt";0;48;1904;1952;0,0245901639344262;2,46
2014;"2034";"Totalt";0;46;1924;1970;0,0233502538071066;2,34
2015;"2034";"Totalt";0;48;2017;2065;0,0232445520581114;2,32
2016;"2034";"Totalt";0;52;2032;2084;0,0249520153550864;2,5
2017;"2034";"Totalt";0;51;2062;2113;0,0241362991008045;2,41
2018;"2034";"Totalt";0;53;2079;2132;0,024859287054409;2,49
2019;"2034";"Totalt";0;56;2107;2163;0,0258899676375405;2,59
2020;"2034";"Totalt";0;54;2117;2171;0,0248733302625518;2,49
2021;"2034";"Totalt";0;47;1959;2006;0,0234297108673978;2,34
2022;"2034";"Totalt";0;51;1952;2003;0,0254618072890664;2,55
2007;"2039";"Totalt";0;35;2681;2716;0,0128865979381443;1,29
2008;"2039";"Totalt";0;38;2632;2670;0,0142322097378277;1,42
2009;"2039";"Totalt";0;46;2631;2677;0,0171834142697049;1,72
2010;"2039";"Totalt";0;46;2651;2697;0,0170559881349648;1,71
2011;"2039";"Totalt";0;43;2643;2686;0,0160089352196575;1,6
2012;"2039";"Totalt";0;37;2614;2651;0,013956997359487;1,4
2013;"2039";"Totalt";0;38;2551;2589;0,0146774816531479;1,47
2014;"2039";"Totalt";0;29;2526;2555;0,0113502935420744;1,14
2015;"2039";"Totalt";0;29;2626;2655;0,0109227871939736;1,09
2016;"2039";"Totalt";0;30;2741;2771;0,010826416456153;1,08
2017;"2039";"Totalt";0;31;2737;2768;0,0111994219653179;1,12
2018;"2039";"Totalt";0;25;2764;2789;0,00896378630333453;0,9
2019;"2039";"Totalt";0;37;2799;2836;0,0130465444287729;1,3
2020;"2039";"Totalt";0;38;2684;2722;0,0139603232916973;1,4
2021;"2039";"Totalt";0;37;2746;2783;0,0132950053898671;1,33
2022;"2039";"Totalt";0;43;2862;2905;0,014802065404475;1,48
2007;"2061";"Totalt";0;71;3131;3202;0,0221736414740787;2,22
2008;"2061";"Totalt";0;57;3155;3212;0,0177459526774595;1,77
2009;"2061";"Totalt";0;59;2862;2921;0,0201985621362547;2,02
2010;"2061";"Totalt";0;47;2899;2946;0,0159538357094365;1,6
2011;"2061";"Totalt";0;53;2892;2945;0,0179966044142615;1,8
2012;"2061";"Totalt";0;53;2965;3018;0,0175612988734261;1,76
2013;"2061";"Totalt";0;34;2897;2931;0,0116001364721938;1,16
2014;"2061";"Totalt";0;36;2776;2812;0,0128022759601707;1,28
2015;"2061";"Totalt";0;33;2730;2763;0,011943539630836;1,19
2016;"2061";"Totalt";0;36;2805;2841;0,0126715945089757;1,27
2017;"2061";"Totalt";0;32;2919;2951;0,0108437817688919;1,08
2018;"2061";"Totalt";0;30;2897;2927;0,0102494021182098;1,02
2019;"2061";"Totalt";0;34;2829;2863;0,0118756549074397;1,19
2020;"2061";"Totalt";0;40;2720;2760;0,0144927536231884;1,45
2021;"2061";"Totalt";0;37;2728;2765;0,0133815551537071;1,34
2022;"2061";"Totalt";0;41;2816;2857;0,0143507175358768;1,44
2007;"2062";"Totalt";0;269;9709;9978;0,0269593104830627;2,7
2008;"2062";"Totalt";0;263;9562;9825;0,0267684478371501;2,68
2009;"2062";"Totalt";0;245;9254;9499;0,025792188651437;2,58
2010;"2062";"Totalt";0;218;9194;9412;0,0231619209519762;2,32
2011;"2062";"Totalt";0;256;9076;9332;0,0274324903557651;2,74
2012;"2062";"Totalt";0;248;9204;9452;0,0262378332628015;2,62
2013;"2062";"Totalt";0;238;9177;9415;0,0252788104089219;2,53
2014;"2062";"Totalt";0;244;9377;9621;0,0253611890655857;2,54
2015;"2062";"Totalt";0;235;9250;9485;0,0247759620453347;2,48
2016;"2062";"Totalt";0;230;9519;9749;0,0235921632987999;2,36
2017;"2062";"Totalt";0;219;9661;9880;0,022165991902834;2,22
2018;"2062";"Totalt";0;227;9824;10051;0,0225848174311014;2,26
2019;"2062";"Totalt";0;228;9920;10148;0,0224674812770989;2,25
2020;"2062";"Totalt";0;237;9627;9864;0,0240267639902676;2,4
2021;"2062";"Totalt";0;218;9820;10038;0,0217174736003188;2,17
2022;"2062";"Totalt";0;252;10007;10259;0,0245637976410956;2,46
2007;"2080";"Totalt";0;1465;24032;25497;0,0574577401262894;5,75
2008;"2080";"Totalt";0;1493;24049;25542;0,0584527444992561;5,85
2009;"2080";"Totalt";0;1461;22816;24277;0,0601804176792849;6,02
2010;"2080";"Totalt";0;1465;23396;24861;0,0589276376654197;5,89
2011;"2080";"Totalt";0;1430;23536;24966;0,0572778979412;5,73
2012;"2080";"Totalt";0;1397;23620;25017;0,0558420274213535;5,58
2013;"2080";"Totalt";0;1396;23450;24846;0,0561861064155196;5,62
2014;"2080";"Totalt";0;1406;23776;25182;0,0558335318878564;5,58
2015;"2080";"Totalt";0;1334;23952;25286;0,0527564660286324;5,28
2016;"2080";"Totalt";0;1258;24445;25703;0,0489437030696806;4,89
2017;"2080";"Totalt";0;1184;24728;25912;0,0456931151589997;4,57
2018;"2080";"Totalt";0;1148;25097;26245;0,0437416650790627;4,37
2019;"2080";"Totalt";0;1172;25516;26688;0,0439148681055156;4,39
2020;"2080";"Totalt";0;1146;25155;26301;0,0435724877381088;4,36
2021;"2080";"Totalt";0;1101;25872;26973;0,0408185963741519;4,08
2022;"2080";"Totalt";0;1075;26750;27825;0,0386343216531896;3,86
2007;"2081";"Totalt";0;696;23292;23988;0,0290145072536268;2,9
2008;"2081";"Totalt";0;725;23517;24242;0,029906773368534;2,99
2009;"2081";"Totalt";0;613;22864;23477;0,0261106614984879;2,61
2010;"2081";"Totalt";0;624;23525;24149;0,0258395792786451;2,58
2011;"2081";"Totalt";0;677;24060;24737;0,0273679104175931;2,74
2012;"2081";"Totalt";0;666;24218;24884;0,0267641858222151;2,68
2013;"2081";"Totalt";0;589;24267;24856;0,0236964917927261;2,37
2014;"2081";"Totalt";0;541;24280;24821;0,0217960597880827;2,18
2015;"2081";"Totalt";0;567;24732;25299;0,0224119530416222;2,24
2016;"2081";"Totalt";0;528;25127;25655;0,0205807834730072;2,06
2017;"2081";"Totalt";0;549;25488;26037;0,0210853784998272;2,11
2018;"2081";"Totalt";0;503;25442;25945;0,019387165157063;1,94
2019;"2081";"Totalt";0;490;26277;26767;0,018306123211417;1,83
2020;"2081";"Totalt";0;458;25818;26276;0,0174303546963008;1,74
2021;"2081";"Totalt";0;504;26199;26703;0,0188742837883384;1,89
2022;"2081";"Totalt";0;523;26262;26785;0,0195258540227739;1,95
2007;"2082";"Totalt";0;38;2982;3020;0,0125827814569536;1,26
2008;"2082";"Totalt";0;42;2930;2972;0,0141318977119785;1,41
2009;"2082";"Totalt";0;44;2952;2996;0,0146862483311081;1,47
2010;"2082";"Totalt";0;49;3065;3114;0,0157353885677585;1,57
2011;"2082";"Totalt";0;58;3073;3131;0,0185244330884701;1,85
2012;"2082";"Totalt";0;51;3157;3208;0,0158977556109726;1,59
2013;"2082";"Totalt";0;54;3100;3154;0,0171211160431198;1,71
2014;"2082";"Totalt";0;51;2979;3030;0,0168316831683168;1,68
2015;"2082";"Totalt";0;50;2988;3038;0,0164581961816985;1,65
2016;"2082";"Totalt";0;55;3040;3095;0,0177705977382876;1,78
2017;"2082";"Totalt";0;54;2992;3046;0,0177281680892974;1,77
2018;"2082";"Totalt";0;56;2923;2979;0,0187982544478013;1,88
2019;"2082";"Totalt";0;56;2910;2966;0,0188806473364801;1,89
2020;"2082";"Totalt";0;53;2937;2990;0,0177257525083612;1,77
2021;"2082";"Totalt";0;57;2949;3006;0,0189620758483034;1,9
2022;"2082";"Totalt";0;61;3088;3149;0,0193712289615751;1,94
2007;"2083";"Totalt";0;168;6099;6267;0,0268070847295357;2,68
2008;"2083";"Totalt";0;128;6195;6323;0,0202435552743951;2,02
2009;"2083";"Totalt";0;147;5718;5865;0,0250639386189258;2,51
2010;"2083";"Totalt";0;133;5913;6046;0,0219980152166722;2,2
2011;"2083";"Totalt";0;136;6082;6218;0,0218719845609521;2,19
2012;"2083";"Totalt";0;131;5941;6072;0,0215744400527009;2,16
2013;"2083";"Totalt";0;112;5823;5935;0,0188711036225779;1,89
2014;"2083";"Totalt";0;113;5861;5974;0,0189152996317375;1,89
2015;"2083";"Totalt";0;99;5876;5975;0,0165690376569038;1,66
2016;"2083";"Totalt";0;98;5851;5949;0,0164733568667003;1,65
2017;"2083";"Totalt";0;100;5872;5972;0,0167448091091762;1,67
2018;"2083";"Totalt";0;103;5972;6075;0,0169547325102881;1,7
2019;"2083";"Totalt";0;104;6004;6108;0,0170268500327439;1,7
2020;"2083";"Totalt";0;121;5910;6031;0,0200630077930691;2,01
2021;"2083";"Totalt";0;117;5886;6003;0,0194902548725637;1,95
2022;"2083";"Totalt";0;133;5965;6098;0,0218104296490653;2,18
2007;"2084";"Totalt";0;222;9622;9844;0,0225518082080455;2,26
2008;"2084";"Totalt";0;224;9578;9802;0,0228524790859008;2,29
2009;"2084";"Totalt";0;224;8946;9170;0,0244274809160305;2,44
2010;"2084";"Totalt";0;222;9172;9394;0,0236321055993187;2,36
2011;"2084";"Totalt";0;225;9219;9444;0,0238246505717916;2,38
2012;"2084";"Totalt";0;217;9028;9245;0,0234721471065441;2,35
2013;"2084";"Totalt";0;222;8861;9083;0,0244412638995926;2,44
2014;"2084";"Totalt";0;227;8857;9084;0,0249889916336416;2,5
2015;"2084";"Totalt";0;205;8967;9172;0,0223506323593546;2,24
2016;"2084";"Totalt";0;268;9224;9492;0,0282343025705858;2,82
2017;"2084";"Totalt";0;241;9414;9655;0,0249611600207147;2,5
2018;"2084";"Totalt";0;221;9575;9796;0,0225602286647611;2,26
2019;"2084";"Totalt";0;221;9590;9811;0,022525736418306;2,25
2020;"2084";"Totalt";0;217;9347;9564;0,0226892513592639;2,27
2021;"2084";"Totalt";0;214;9380;9594;0,0223056076714613;2,23
2022;"2084";"Totalt";0;262;9496;9758;0,0268497642959623;2,68
2007;"2085";"Totalt";0;184;11191;11375;0,0161758241758242;1,62
2008;"2085";"Totalt";0;184;11171;11355;0,0162043152796125;1,62
2009;"2085";"Totalt";0;183;11260;11443;0,0159923097089924;1,6
2010;"2085";"Totalt";0;190;11396;11586;0,0163991023649232;1,64
2011;"2085";"Totalt";0;198;11321;11519;0,0171889921000087;1,72
2012;"2085";"Totalt";0;196;11508;11704;0,0167464114832536;1,67
2013;"2085";"Totalt";0;174;11913;12087;0,0143956316703897;1,44
2014;"2085";"Totalt";0;160;11518;11678;0,0137009761945539;1,37
2015;"2085";"Totalt";0;155;11515;11670;0,0132819194515853;1,33
2016;"2085";"Totalt";0;157;11732;11889;0,0132054840608966;1,32
2017;"2085";"Totalt";0;159;11737;11896;0,0133658372562206;1,34
2018;"2085";"Totalt";0;163;11735;11898;0,0136997814758783;1,37
2019;"2085";"Totalt";0;129;11637;11766;0,0109637939826619;1,1
2020;"2085";"Totalt";0;101;11241;11342;0,00890495503438547;0,89
2021;"2085";"Totalt";0;110;11348;11458;0,00960027928085181;0,96
2022;"2085";"Totalt";0;113;11780;11893;0,00950138737072227;0,95
2007;"2101";"Totalt";0;29;1687;1716;0,0168997668997669;1,69
2008;"2101";"Totalt";0;27;1676;1703;0,0158543746330006;1,59
2009;"2101";"Totalt";0;26;1665;1691;0,0153755174452986;1,54
2010;"2101";"Totalt";0;30;1782;1812;0,0165562913907285;1,66
2011;"2101";"Totalt";0;25;1853;1878;0,0133120340788072;1,33
2012;"2101";"Totalt";0;25;1851;1876;0,0133262260127932;1,33
2013;"2101";"Totalt";0;21;1753;1774;0,0118376550169109;1,18
2014;"2101";"Totalt";0;21;1724;1745;0,0120343839541547;1,2
2015;"2101";"Totalt";0;20;1746;1766;0,0113250283125708;1,13
2016;"2101";"Totalt";0;18;1747;1765;0,0101983002832861;1,02
2017;"2101";"Totalt";0;17;1708;1725;0,00985507246376812;0,99
2018;"2101";"Totalt";0;21;1647;1668;0,012589928057554;1,26
2019;"2101";"Totalt";0;29;1593;1622;0,0178791615289766;1,79
2020;"2101";"Totalt";0;24;1593;1617;0,0148423005565863;1,48
2021;"2101";"Totalt";0;26;1601;1627;0,015980331899201;1,6
2022;"2101";"Totalt";0;30;1705;1735;0,0172910662824208;1,73
2007;"2104";"Totalt";0;240;4017;4257;0,0563777307963354;5,64
2008;"2104";"Totalt";0;267;3992;4259;0,0626907724818032;6,27
2009;"2104";"Totalt";0;227;3545;3772;0,0601802757158006;6,02
2010;"2104";"Totalt";0;213;3504;3717;0,0573042776432607;5,73
2011;"2104";"Totalt";0;195;3612;3807;0,0512214342001576;5,12
2012;"2104";"Totalt";0;38;3638;3676;0,0103373231773667;1,03
2013;"2104";"Totalt";0;39;3607;3646;0,0106966538672518;1,07
2014;"2104";"Totalt";0;40;3562;3602;0,0111049416990561;1,11
2015;"2104";"Totalt";0;35;3539;3574;0,0097929490766648;0,98
2016;"2104";"Totalt";0;36;3488;3524;0,0102156640181612;1,02
2017;"2104";"Totalt";0;32;3410;3442;0,00929692039511912;0,93
2018;"2104";"Totalt";0;31;3421;3452;0,00898030127462341;0,9
2019;"2104";"Totalt";0;31;3175;3206;0,00966936993137867;0,97
2020;"2104";"Totalt";0;29;3146;3175;0,00913385826771653;0,91
2021;"2104";"Totalt";0;33;3185;3218;0,0102548166563083;1,03
2022;"2104";"Totalt";0;36;3126;3162;0,0113851992409867;1,14
2007;"2121";"Totalt";0;70;5043;5113;0,01369059260708;1,37
2008;"2121";"Totalt";0;71;5021;5092;0,0139434406912804;1,39
2009;"2121";"Totalt";0;60;4578;4638;0,0129366106080207;1,29
2010;"2121";"Totalt";0;57;4673;4730;0,0120507399577167;1,21
2011;"2121";"Totalt";0;57;4789;4846;0,0117622781675609;1,18
2012;"2121";"Totalt";0;66;4603;4669;0,014135789248233;1,41
2013;"2121";"Totalt";0;66;4496;4562;0,0144673388864533;1,45
2014;"2121";"Totalt";0;59;4632;4691;0,0125772756341931;1,26
2015;"2121";"Totalt";0;52;4760;4812;0,0108063175394846;1,08
2016;"2121";"Totalt";0;53;4940;4993;0,0106148608051272;1,06
2017;"2121";"Totalt";0;52;4911;4963;0,0104775337497481;1,05
2018;"2121";"Totalt";0;61;4984;5045;0,0120911793855302;1,21
2019;"2121";"Totalt";0;69;5069;5138;0,0134293499416115;1,34
2020;"2121";"Totalt";0;66;4905;4971;0,0132770066385033;1,33
2021;"2121";"Totalt";0;74;4993;5067;0,0146043023485297;1,46
2022;"2121";"Totalt";0;67;5123;5190;0,0129094412331407;1,29
2007;"2132";"Totalt";0;33;2646;2679;0,0123180291153415;1,23
2008;"2132";"Totalt";0;35;2646;2681;0,0130548302872063;1,31
2009;"2132";"Totalt";0;30;2555;2585;0,011605415860735;1,16
2010;"2132";"Totalt";0;20;2634;2654;0,00753579502637528;0,75
2011;"2132";"Totalt";0;26;2700;2726;0,00953778429933969;0,95
2012;"2132";"Totalt";0;20;2619;2639;0,00757862826828344;0,76
2013;"2132";"Totalt";0;35;2619;2654;0,0131876412961567;1,32
2014;"2132";"Totalt";0;34;2667;2701;0,0125879303961496;1,26
2015;"2132";"Totalt";0;33;2766;2799;0,0117899249732047;1,18
2016;"2132";"Totalt";0;36;2669;2705;0,0133086876155268;1,33
2017;"2132";"Totalt";0;34;2663;2697;0,0126065999258435;1,26
2018;"2132";"Totalt";0;31;2584;2615;0,0118546845124283;1,19
2019;"2132";"Totalt";0;50;2569;2619;0,0190912562046583;1,91
2020;"2132";"Totalt";0;47;2586;2633;0,0178503608051652;1,79
2021;"2132";"Totalt";0;48;2478;2526;0,0190023752969121;1,9
2022;"2132";"Totalt";0;53;2541;2594;0,020431765612953;2,04
2007;"2161";"Totalt";0;323;7269;7592;0,0425447839831401;4,25
2008;"2161";"Totalt";0;324;7264;7588;0,0426989984185556;4,27
2009;"2161";"Totalt";0;309;6982;7291;0,0423810176930462;4,24
2010;"2161";"Totalt";0;346;6969;7315;0,0473000683526999;4,73
2011;"2161";"Totalt";0;362;6950;7312;0,049507658643326;4,95
2012;"2161";"Totalt";0;344;6938;7282;0,04723976929415;4,72
2013;"2161";"Totalt";0;319;6847;7166;0,0445157689087357;4,45
2014;"2161";"Totalt";0;313;6882;7195;0,0435024322446143;4,35
2015;"2161";"Totalt";0;296;6894;7190;0,0411682892906815;4,12
2016;"2161";"Totalt";0;282;6979;7261;0,0388376256713951;3,88
2017;"2161";"Totalt";0;291;6816;7107;0,0409455466441537;4,09
2018;"2161";"Totalt";0;270;6758;7028;0,0384177575412635;3,84
2019;"2161";"Totalt";0;286;6832;7118;0,0401798257937623;4,02
2020;"2161";"Totalt";0;290;6734;7024;0,0412870159453303;4,13
2021;"2161";"Totalt";0;286;6785;7071;0,0404468957714609;4,04
2022;"2161";"Totalt";0;364;7002;7366;0,049416236763508;4,94
2007;"2180";"Totalt";0;1612;39192;40804;0,0395059307910989;3,95
2008;"2180";"Totalt";0;1711;39968;41679;0,0410518486527988;4,11
2009;"2180";"Totalt";0;1674;39212;40886;0,0409431101110405;4,09
2010;"2180";"Totalt";0;1657;40287;41944;0,0395050543581919;3,95
2011;"2180";"Totalt";0;1691;40040;41731;0,0405214349045074;4,05
2012;"2180";"Totalt";0;1664;40185;41849;0,0397620014815169;3,98
2013;"2180";"Totalt";0;1664;40497;42161;0,0394677545599013;3,95
2014;"2180";"Totalt";0;1627;41043;42670;0,0381298336067495;3,81
2015;"2180";"Totalt";0;1649;41471;43120;0,0382421150278293;3,82
2016;"2180";"Totalt";0;1604;42690;44294;0,0362125795818847;3,62
2017;"2180";"Totalt";0;1609;43589;45198;0,0355989203062082;3,56
2018;"2180";"Totalt";0;1589;44461;46050;0,0345059717698154;3,45
2019;"2180";"Totalt";0;1538;44835;46373;0,0331658508183641;3,32
2020;"2180";"Totalt";0;1393;44828;46221;0,0301378161441769;3,01
2021;"2180";"Totalt";0;1388;46230;47618;0,0291486412701079;2,91
2022;"2180";"Totalt";0;1380;47269;48649;0,0283664617977759;2,84
2007;"2181";"Totalt";0;260;17612;17872;0,0145478961504029;1,45
2008;"2181";"Totalt";0;271;17448;17719;0,0152943168350358;1,53
2009;"2181";"Totalt";0;223;15933;16156;0,0138029215152265;1,38
2010;"2181";"Totalt";0;241;15926;16167;0,0149069091358941;1,49
2011;"2181";"Totalt";0;239;16383;16622;0,014378534472386;1,44
2012;"2181";"Totalt";0;234;15851;16085;0,0145477152626671;1,45
2013;"2181";"Totalt";0;196;15842;16038;0,0122209751839381;1,22
2014;"2181";"Totalt";0;190;15909;16099;0,0118019752779676;1,18
2015;"2181";"Totalt";0;169;15920;16089;0,0105040711044813;1,05
2016;"2181";"Totalt";0;152;16189;16341;0,00930175631846276;0,93
2017;"2181";"Totalt";0;159;16345;16504;0,00963402811439651;0,96
2018;"2181";"Totalt";0;161;16590;16751;0,00961136648558295;0,96
2019;"2181";"Totalt";0;260;16040;16300;0,0159509202453988;1,6
2020;"2181";"Totalt";0;236;15284;15520;0,0152061855670103;1,52
2021;"2181";"Totalt";0;238;15255;15493;0,0153617762860647;1,54
2022;"2181";"Totalt";0;255;15648;15903;0,016034710431994;1,6
2007;"2182";"Totalt";0;309;9083;9392;0,0329003407155026;3,29
2008;"2182";"Totalt";0;286;9261;9547;0,0299570545721169;3
2009;"2182";"Totalt";0;272;8451;8723;0,0311819328212771;3,12
2010;"2182";"Totalt";0;288;8693;8981;0,0320676984745574;3,21
2011;"2182";"Totalt";0;305;8908;9213;0,0331053945511777;3,31
2012;"2182";"Totalt";0;295;9018;9313;0,0316761516160206;3,17
2013;"2182";"Totalt";0;296;8789;9085;0,0325811777655476;3,26
2014;"2182";"Totalt";0;292;8626;8918;0,032742767436645;3,27
2015;"2182";"Totalt";0;274;8568;8842;0,0309884641483827;3,1
2016;"2182";"Totalt";0;277;8727;9004;0,0307641048422923;3,08
2017;"2182";"Totalt";0;289;8857;9146;0,0315985130111524;3,16
2018;"2182";"Totalt";0;248;8899;9147;0,027112714551219;2,71
2019;"2182";"Totalt";0;232;8669;8901;0,0260644871362768;2,61
2020;"2182";"Totalt";0;212;8537;8749;0,0242313407246542;2,42
2021;"2182";"Totalt";0;227;8723;8950;0,0253631284916201;2,54
2022;"2182";"Totalt";0;222;8874;9096;0,0244063324538259;2,44
2007;"2183";"Totalt";0;340;10112;10452;0,032529659395331;3,25
2008;"2183";"Totalt";0;344;10015;10359;0,0332078385944589;3,32
2009;"2183";"Totalt";0;339;9688;10027;0,033808716465543;3,38
2010;"2183";"Totalt";0;323;9965;10288;0,031395800933126;3,14
2011;"2183";"Totalt";0;334;9941;10275;0,0325060827250608;3,25
2012;"2183";"Totalt";0;337;9993;10330;0,0326234269119071;3,26
2013;"2183";"Totalt";0;335;9917;10252;0,0326765509168943;3,27
2014;"2183";"Totalt";0;288;9874;10162;0,0283408777799646;2,83
2015;"2183";"Totalt";0;258;9900;10158;0,0253987005316007;2,54
2016;"2183";"Totalt";0;254;10119;10373;0,0244866480285356;2,45
2017;"2183";"Totalt";0;272;10213;10485;0,0259418216499762;2,59
2018;"2183";"Totalt";0;265;10121;10386;0,0255151165029848;2,55
2019;"2183";"Totalt";0;308;10072;10380;0,0296724470134875;2,97
2020;"2183";"Totalt";0;262;10019;10281;0,0254839023441299;2,55
2021;"2183";"Totalt";0;254;10087;10341;0,0245624214292622;2,46
2022;"2183";"Totalt";0;262;10293;10555;0,0248223590715301;2,48
2007;"2184";"Totalt";0;554;15021;15575;0,035569823434992;3,56
2008;"2184";"Totalt";0;595;15330;15925;0,0373626373626374;3,74
2009;"2184";"Totalt";0;515;14651;15166;0,0339575365950152;3,4
2010;"2184";"Totalt";0;482;15218;15700;0,0307006369426752;3,07
2011;"2184";"Totalt";0;480;15313;15793;0,0303932121826125;3,04
2012;"2184";"Totalt";0;435;15277;15712;0,0276858452138493;2,77
2013;"2184";"Totalt";0;385;14843;15228;0,0252823745731547;2,53
2014;"2184";"Totalt";0;390;14976;15366;0,0253807106598985;2,54
2015;"2184";"Totalt";0;417;15036;15453;0,0269850514463211;2,7
2016;"2184";"Totalt";0;426;14908;15334;0,0277814008086605;2,78
2017;"2184";"Totalt";0;430;15257;15687;0,0274112322305093;2,74
2018;"2184";"Totalt";0;368;15536;15904;0,0231388329979879;2,31
2019;"2184";"Totalt";0;389;15589;15978;0,0243459757166103;2,43
2020;"2184";"Totalt";0;349;15461;15810;0,0220746363061354;2,21
2021;"2184";"Totalt";0;358;16070;16428;0,0217920623326029;2,18
2022;"2184";"Totalt";0;360;16375;16735;0,0215118016133851;2,15
2007;"2260";"Totalt";0;169;4110;4279;0,0394952091610189;3,95
2008;"2260";"Totalt";0;151;4070;4221;0,0357735133854537;3,58
2009;"2260";"Totalt";0;132;3900;4032;0,0327380952380952;3,27
2010;"2260";"Totalt";0;118;4022;4140;0,0285024154589372;2,85
2011;"2260";"Totalt";0;118;3895;4013;0,0294044355843509;2,94
2012;"2260";"Totalt";0;106;3723;3829;0,0276834682684774;2,77
2013;"2260";"Totalt";0;115;3522;3637;0,0316194665933462;3,16
2014;"2260";"Totalt";0;116;3386;3502;0,0331239291833238;3,31
2015;"2260";"Totalt";0;114;3373;3487;0,0326928591912819;3,27
2016;"2260";"Totalt";0;112;3387;3499;0,0320091454701343;3,2
2017;"2260";"Totalt";0;109;3401;3510;0,0310541310541311;3,11
2018;"2260";"Totalt";0;108;3424;3532;0,0305775764439411;3,06
2019;"2260";"Totalt";0;98;3459;3557;0,0275513072814169;2,76
2020;"2260";"Totalt";0;105;3376;3481;0,0301637460499856;3,02
2021;"2260";"Totalt";0;104;3409;3513;0,0296043267862226;2,96
2022;"2260";"Totalt";0;114;3566;3680;0,0309782608695652;3,1
2007;"2262";"Totalt";0;94;4880;4974;0,0188982710092481;1,89
2008;"2262";"Totalt";0;79;4732;4811;0,016420702556641;1,64
2009;"2262";"Totalt";0;68;4452;4520;0,0150442477876106;1,5
2010;"2262";"Totalt";0;68;4710;4778;0,0142318961908748;1,42
2011;"2262";"Totalt";0;68;4813;4881;0,0139315713993034;1,39
2012;"2262";"Totalt";0;62;4837;4899;0,0126556440089814;1,27
2013;"2262";"Totalt";0;59;4847;4906;0,0120260905014268;1,2
2014;"2262";"Totalt";0;59;4804;4863;0,0121324285420522;1,21
2015;"2262";"Totalt";0;56;4824;4880;0,0114754098360656;1,15
2016;"2262";"Totalt";0;50;5207;5257;0,00951112801978315;0,95
2017;"2262";"Totalt";0;47;5195;5242;0,00896604349484929;0,9
2018;"2262";"Totalt";0;48;5327;5375;0,00893023255813953;0,89
2019;"2262";"Totalt";0;52;5336;5388;0,00965107646622123;0,97
2020;"2262";"Totalt";0;46;5192;5238;0,0087819778541428;0,88
2021;"2262";"Totalt";0;46;5214;5260;0,00874524714828897;0,87
2022;"2262";"Totalt";0;46;5212;5258;0,00874857360213009;0,87
2007;"2280";"Totalt";0;653;9244;9897;0,0659795897746792;6,6
2008;"2280";"Totalt";0;618;9151;9769;0,0632613368819736;6,33
2009;"2280";"Totalt";0;542;8864;9406;0,0576227939613013;5,76
2010;"2280";"Totalt";0;512;8851;9363;0,0546833279931646;5,47
2011;"2280";"Totalt";0;445;8873;9318;0,0477570294054518;4,78
2012;"2280";"Totalt";0;406;8847;9253;0,0438776612990381;4,39
2013;"2280";"Totalt";0;378;8877;9255;0,0408427876823339;4,08
2014;"2280";"Totalt";0;386;8713;9099;0,0424222442026596;4,24
2015;"2280";"Totalt";0;391;8920;9311;0,0419933412093223;4,2
2016;"2280";"Totalt";0;347;8814;9161;0,0378779609212968;3,79
2017;"2280";"Totalt";0;340;8791;9131;0,0372357901653707;3,72
2018;"2280";"Totalt";0;381;8732;9113;0,0418084055744541;4,18
2019;"2280";"Totalt";0;345;8710;9055;0,0381004969630039;3,81
2020;"2280";"Totalt";0;327;8521;8848;0,0369575045207957;3,7
2021;"2280";"Totalt";0;353;8627;8980;0,0393095768374165;3,93
2022;"2280";"Totalt";0;381;9176;9557;0,0398660667573506;3,99
2007;"2281";"Totalt";0;1664;44547;46211;0,0360087425071953;3,6
2008;"2281";"Totalt";0;1780;44450;46230;0,0385031364914558;3,85
2009;"2281";"Totalt";0;1675;43159;44834;0,0373600392559218;3,74
2010;"2281";"Totalt";0;1667;43267;44934;0,0370988561000579;3,71
2011;"2281";"Totalt";0;1652;43615;45267;0,0364945766231471;3,65
2012;"2281";"Totalt";0;1623;44225;45848;0,0353995812249171;3,54
2013;"2281";"Totalt";0;1611;44320;45931;0,0350743506564194;3,51
2014;"2281";"Totalt";0;1498;44406;45904;0,0326333217148832;3,26
2015;"2281";"Totalt";0;1413;45281;46694;0,030260847218058;3,03
2016;"2281";"Totalt";0;1423;46530;47953;0,0296748899964549;2,97
2017;"2281";"Totalt";0;1389;46943;48332;0,0287387238268642;2,87
2018;"2281";"Totalt";0;1358;47258;48616;0,0279331907191048;2,79
2019;"2281";"Totalt";0;1402;47426;48828;0,0287130335053658;2,87
2020;"2281";"Totalt";0;1291;46973;48264;0,0267487153986408;2,67
2021;"2281";"Totalt";0;1200;47652;48852;0,0245639891918448;2,46
2022;"2281";"Totalt";0;1228;48194;49422;0,0248472340253328;2,48
2007;"2282";"Totalt";0;115;7270;7385;0,015572105619499;1,56
2008;"2282";"Totalt";0;152;7176;7328;0,0207423580786026;2,07
2009;"2282";"Totalt";0;123;6893;7016;0,0175313568985177;1,75
2010;"2282";"Totalt";0;96;6964;7060;0,0135977337110482;1,36
2011;"2282";"Totalt";0;98;6748;6846;0,0143149284253579;1,43
2012;"2282";"Totalt";0;88;6835;6923;0,0127112523472483;1,27
2013;"2282";"Totalt";0;93;6810;6903;0,0134724033029118;1,35
2014;"2282";"Totalt";0;105;6905;7010;0,0149786019971469;1,5
2015;"2282";"Totalt";0;89;7052;7141;0,0124632404425151;1,25
2016;"2282";"Totalt";0;89;7091;7180;0,0123955431754875;1,24
2017;"2282";"Totalt";0;93;7112;7205;0,0129077029840389;1,29
2018;"2282";"Totalt";0;78;7119;7197;0,0108378491037932;1,08
2019;"2282";"Totalt";0;88;6952;7040;0,0125;1,25
2020;"2282";"Totalt";0;79;6896;6975;0,011326164874552;1,13
2021;"2282";"Totalt";0;81;6965;7046;0,0114958841896111;1,15
2022;"2282";"Totalt";0;88;7163;7251;0,0121362570679906;1,21
2007;"2283";"Totalt";0;310;7677;7987;0,0388130712407662;3,88
2008;"2283";"Totalt";0;254;7741;7995;0,0317698561601001;3,18
2009;"2283";"Totalt";0;218;7356;7574;0,0287826775811988;2,88
2010;"2283";"Totalt";0;213;7063;7276;0,0292743265530511;2,93
2011;"2283";"Totalt";0;231;7021;7252;0,0318532818532819;3,19
2012;"2283";"Totalt";0;212;7029;7241;0,0292777240712609;2,93
2013;"2283";"Totalt";0;204;6991;7195;0,0283530229325921;2,84
2014;"2283";"Totalt";0;196;6948;7144;0,0274356103023516;2,74
2015;"2283";"Totalt";0;187;6932;7119;0,026267734232336;2,63
2016;"2283";"Totalt";0;175;7004;7179;0,0243766541301017;2,44
2017;"2283";"Totalt";0;176;7031;7207;0,0244207020951852;2,44
2018;"2283";"Totalt";0;157;7049;7206;0,0217873993893977;2,18
2019;"2283";"Totalt";0;156;6793;6949;0,0224492732767305;2,24
2020;"2283";"Totalt";0;139;6757;6896;0,0201566125290023;2,02
2021;"2283";"Totalt";0;137;6845;6982;0,0196218848467488;1,96
2022;"2283";"Totalt";0;128;7061;7189;0,0178049798302963;1,78
2007;"2284";"Totalt";0;686;23467;24153;0,0284022688692916;2,84
2008;"2284";"Totalt";0;674;23252;23926;0,028170191423556;2,82
2009;"2284";"Totalt";0;621;22882;23503;0,0264221588733353;2,64
2010;"2284";"Totalt";0;600;22843;23443;0,0255939939427548;2,56
2011;"2284";"Totalt";0;586;23032;23618;0,0248115843847913;2,48
2012;"2284";"Totalt";0;561;23353;23914;0,0234590616375345;2,35
2013;"2284";"Totalt";0;537;23364;23901;0,0224676791766035;2,25
2014;"2284";"Totalt";0;570;23462;24032;0,0237183754993342;2,37
2015;"2284";"Totalt";0;567;23427;23994;0,0236309077269317;2,36
2016;"2284";"Totalt";0;560;23517;24077;0,0232587116335092;2,33
2017;"2284";"Totalt";0;570;23366;23936;0,0238135026737968;2,38
2018;"2284";"Totalt";0;575;23381;23956;0,0240023376189681;2,4
2019;"2284";"Totalt";0;631;22643;23274;0,0271117985735155;2,71
2020;"2284";"Totalt";0;589;22048;22637;0,0260193488536467;2,6
2021;"2284";"Totalt";0;610;22494;23104;0,0264023545706371;2,64
2022;"2284";"Totalt";0;605;23097;23702;0,0255252721289343;2,55
2007;"2303";"Totalt";0;13;2298;2311;0,0056252704456945;0,56
2008;"2303";"Totalt";0;11;2235;2246;0,00489759572573464;0,49
2009;"2303";"Totalt";0;12;2077;2089;0,00574437529918621;0,57
2010;"2303";"Totalt";0;12;2174;2186;0,00548947849954254;0,55
2011;"2303";"Totalt";0;15;2142;2157;0,00695410292072323;0,7
2012;"2303";"Totalt";0;15;2104;2119;0,00707881075979235;0,71
2013;"2303";"Totalt";0;19;2084;2103;0,00903471231573942;0,9
2014;"2303";"Totalt";0;18;2057;2075;0,00867469879518072;0,87
2015;"2303";"Totalt";0;15;1984;1999;0,00750375187593797;0,75
2016;"2303";"Totalt";0;14;1958;1972;0,00709939148073022;0,71
2017;"2303";"Totalt";0;14;1958;1972;0,00709939148073022;0,71
2018;"2303";"Totalt";0;18;1991;2009;0,00895968143354903;0,9
2019;"2303";"Totalt";0;18;1943;1961;0,00917899031106578;0,92
2020;"2303";"Totalt";0;17;1947;1964;0,00865580448065173;0,87
2021;"2303";"Totalt";0;16;1903;1919;0,00833767587285044;0,83
2022;"2303";"Totalt";0;16;1929;1945;0,00822622107969152;0,82
2007;"2305";"Totalt";0;26;2162;2188;0,0118829981718464;1,19
2008;"2305";"Totalt";0;24;2101;2125;0,0112941176470588;1,13
2009;"2305";"Totalt";0;24;2034;2058;0,0116618075801749;1,17
2010;"2305";"Totalt";0;21;1891;1912;0,0109832635983264;1,1
2011;"2305";"Totalt";0;22;1960;1982;0,0110998990918264;1,11
2012;"2305";"Totalt";0;25;1907;1932;0,0129399585921325;1,29
2013;"2305";"Totalt";0;38;1933;1971;0,0192795535261289;1,93
2014;"2305";"Totalt";0;34;1940;1974;0,0172239108409321;1,72
2015;"2305";"Totalt";0;37;1935;1972;0,018762677484787;1,88
2016;"2305";"Totalt";0;52;1952;2004;0,0259481037924152;2,59
2017;"2305";"Totalt";0;45;1943;1988;0,022635814889336;2,26
2018;"2305";"Totalt";0;44;1957;2001;0,0219890054972514;2,2
2019;"2305";"Totalt";0;39;1878;1917;0,0203442879499218;2,03
2020;"2305";"Totalt";0;42;1905;1947;0,0215716486902928;2,16
2021;"2305";"Totalt";0;52;1900;1952;0,0266393442622951;2,66
2022;"2305";"Totalt";0;53;2065;2118;0,0250236071765817;2,5
2007;"2309";"Totalt";0;49;4380;4429;0,0110634454730187;1,11
2008;"2309";"Totalt";0;51;4265;4316;0,0118164967562558;1,18
2009;"2309";"Totalt";0;54;4173;4227;0,0127750177430802;1,28
2010;"2309";"Totalt";0;59;4186;4245;0,0138987043580683;1,39
2011;"2309";"Totalt";0;55;4219;4274;0,0128685072531586;1,29
2012;"2309";"Totalt";0;41;4150;4191;0,00978286805058459;0,98
2013;"2309";"Totalt";0;46;4191;4237;0,0108567382582016;1,09
2014;"2309";"Totalt";0;44;4213;4257;0,0103359173126615;1,03
2015;"2309";"Totalt";0;42;4252;4294;0,00978108989287378;0,98
2016;"2309";"Totalt";0;35;4082;4117;0,00850133592421666;0,85
2017;"2309";"Totalt";0;32;4022;4054;0,00789343857918106;0,79
2018;"2309";"Totalt";0;34;4096;4130;0,00823244552058111;0,82
2019;"2309";"Totalt";0;35;4228;4263;0,00821018062397373;0,82
2020;"2309";"Totalt";0;46;4233;4279;0,0107501752745969;1,08
2021;"2309";"Totalt";0;42;4273;4315;0,00973348783314021;0,97
2022;"2309";"Totalt";0;51;4434;4485;0,011371237458194;1,14
2007;"2313";"Totalt";0;63;4668;4731;0,0133164235890932;1,33
2008;"2313";"Totalt";0;56;4522;4578;0,0122324159021407;1,22
2009;"2313";"Totalt";0;59;4379;4438;0,0132942767012168;1,33
2010;"2313";"Totalt";0;56;4448;4504;0,0124333925399645;1,24
2011;"2313";"Totalt";0;52;4493;4545;0,0114411441144114;1,14
2012;"2313";"Totalt";0;55;4509;4564;0,0120508326029798;1,21
2013;"2313";"Totalt";0;58;4481;4539;0,0127781449658515;1,28
2014;"2313";"Totalt";0;53;4422;4475;0,0118435754189944;1,18
2015;"2313";"Totalt";0;53;4350;4403;0,012037247331365;1,2
2016;"2313";"Totalt";0;46;4447;4493;0,0102381482305809;1,02
2017;"2313";"Totalt";0;42;4508;4550;0,00923076923076923;0,92
2018;"2313";"Totalt";0;41;4487;4528;0,0090547703180212;0,91
2019;"2313";"Totalt";0;31;4539;4570;0,00678336980306346;0,68
2020;"2313";"Totalt";0;36;4334;4370;0,00823798627002288;0,82
2021;"2313";"Totalt";0;45;4352;4397;0,0102342506254264;1,02
2022;"2313";"Totalt";0;43;4590;4633;0,00928124325491043;0,93
2007;"2321";"Totalt";0;210;4590;4800;0,04375;4,38
2008;"2321";"Totalt";0;186;4671;4857;0,038295243977764;3,83
2009;"2321";"Totalt";0;186;4582;4768;0,039010067114094;3,9
2010;"2321";"Totalt";0;217;4736;4953;0,043811831213406;4,38
2011;"2321";"Totalt";0;221;4690;4911;0,045001018122582;4,5
2012;"2321";"Totalt";0;192;4683;4875;0,0393846153846154;3,94
2013;"2321";"Totalt";0;171;4731;4902;0,0348837209302326;3,49
2014;"2321";"Totalt";0;155;4664;4819;0,0321643494500934;3,22
2015;"2321";"Totalt";0;174;4573;4747;0,0366547293027175;3,67
2016;"2321";"Totalt";0;180;4886;5066;0,0355309909198579;3,55
2017;"2321";"Totalt";0;190;5158;5348;0,0355272999252057;3,55
2018;"2321";"Totalt";0;188;5168;5356;0,0351008215085885;3,51
2019;"2321";"Totalt";0;191;5302;5493;0,0347715273985072;3,48
2020;"2321";"Totalt";0;195;4985;5180;0,0376447876447876;3,76
2021;"2321";"Totalt";0;210;5249;5459;0,0384685839897417;3,85
2022;"2321";"Totalt";0;217;5502;5719;0,0379436964504284;3,79
2007;"2326";"Totalt";0;31;2638;2669;0,0116148370176096;1,16
2008;"2326";"Totalt";0;26;2571;2597;0,0100115517905275;1
2009;"2326";"Totalt";0;21;2387;2408;0,00872093023255814;0,87
2010;"2326";"Totalt";0;20;2362;2382;0,00839630562552477;0,84
2011;"2326";"Totalt";0;20;2445;2465;0,00811359026369168;0,81
2012;"2326";"Totalt";0;21;2399;2420;0,00867768595041322;0,87
2013;"2326";"Totalt";0;23;2476;2499;0,00920368147258904;0,92
2014;"2326";"Totalt";0;23;2438;2461;0,00934579439252336;0,93
2015;"2326";"Totalt";0;23;2352;2375;0,00968421052631579;0,97
2016;"2326";"Totalt";0;22;2349;2371;0,00927878532264867;0,93
2017;"2326";"Totalt";0;24;2405;2429;0,00988060930424043;0,99
2018;"2326";"Totalt";0;28;2333;2361;0,0118593816179585;1,19
2019;"2326";"Totalt";0;27;2356;2383;0,0113302559798573;1,13
2020;"2326";"Totalt";0;23;2344;2367;0,00971694127587664;0,97
2021;"2326";"Totalt";0;31;2410;2441;0,0126997132322819;1,27
2022;"2326";"Totalt";0;36;2413;2449;0,0146998775010208;1,47
2007;"2361";"Totalt";0;76;4520;4596;0,0165361183637946;1,65
2008;"2361";"Totalt";0;82;4477;4559;0,0179864005264312;1,8
2009;"2361";"Totalt";0;58;4430;4488;0,0129233511586453;1,29
2010;"2361";"Totalt";0;32;4514;4546;0,00703915530136384;0,7
2011;"2361";"Totalt";0;40;4444;4484;0,00892060660124889;0,89
2012;"2361";"Totalt";0;63;4393;4456;0,0141382405745063;1,41
2013;"2361";"Totalt";0;59;4448;4507;0,0130907477257599;1,31
2014;"2361";"Totalt";0;36;4500;4536;0,00793650793650794;0,79
2015;"2361";"Totalt";0;42;4498;4540;0,0092511013215859;0,93
2016;"2361";"Totalt";0;39;4553;4592;0,00849303135888502;0,85
2017;"2361";"Totalt";0;30;4573;4603;0,00651748859439496;0,65
2018;"2361";"Totalt";0;35;4607;4642;0,00753985351141749;0,75
2019;"2361";"Totalt";0;27;4285;4312;0,00626159554730983;0,63
2020;"2361";"Totalt";0;26;4210;4236;0,00613786591123702;0,61
2021;"2361";"Totalt";0;41;4335;4376;0,00936928702010969;0,94
2022;"2361";"Totalt";0;42;4434;4476;0,00938337801608579;0,94
2007;"2380";"Totalt";0;1398;28657;30055;0,046514723007819;4,65
2008;"2380";"Totalt";0;1374;29263;30637;0,0448477331331397;4,48
2009;"2380";"Totalt";0;1283;28647;29930;0,042866688940862;4,29
2010;"2380";"Totalt";0;1289;28881;30170;0,0427245608220086;4,27
2011;"2380";"Totalt";0;1324;29322;30646;0,0432030281276512;4,32
2012;"2380";"Totalt";0;1328;29544;30872;0,0430163254729204;4,3
2013;"2380";"Totalt";0;1301;29713;31014;0,0419487973173406;4,19
2014;"2380";"Totalt";0;1229;29877;31106;0,0395100623673889;3,95
2015;"2380";"Totalt";0;1236;30350;31586;0,0391312606851137;3,91
2016;"2380";"Totalt";0;1258;30700;31958;0,0393641654671757;3,94
2017;"2380";"Totalt";0;1278;31255;32533;0,0392831893769403;3,93
2018;"2380";"Totalt";0;1248;31740;32988;0,0378319388868679;3,78
2019;"2380";"Totalt";0;1296;32203;33499;0,0386877220215529;3,87
2020;"2380";"Totalt";0;1187;31667;32854;0,0361295428258355;3,61
2021;"2380";"Totalt";0;1177;32865;34042;0,0345749368427237;3,46
2022;"2380";"Totalt";0;1277;34058;35335;0,0361398047261922;3,61
2007;"2401";"Totalt";0;20;2028;2048;0,009765625;0,98
2008;"2401";"Totalt";0;19;2043;2062;0,00921435499515034;0,92
2009;"2401";"Totalt";0;17;1948;1965;0,00865139949109415;0,87
2010;"2401";"Totalt";0;26;1995;2021;0,0128649183572489;1,29
2011;"2401";"Totalt";0;28;2028;2056;0,0136186770428016;1,36
2012;"2401";"Totalt";0;34;2031;2065;0,0164648910411622;1,65
2013;"2401";"Totalt";0;28;1966;1994;0,0140421263791374;1,4
2014;"2401";"Totalt";0;31;1885;1916;0,0161795407098121;1,62
2015;"2401";"Totalt";0;44;1842;1886;0,0233297985153765;2,33
2016;"2401";"Totalt";0;45;2006;2051;0,0219405168210629;2,19
2017;"2401";"Totalt";0;47;1977;2024;0,0232213438735178;2,32
2018;"2401";"Totalt";0;49;1975;2024;0,0242094861660079;2,42
2019;"2401";"Totalt";0;51;1952;2003;0,0254618072890664;2,55
2020;"2401";"Totalt";0;45;1861;1906;0,0236096537250787;2,36
2021;"2401";"Totalt";0;51;1860;1911;0,0266875981161695;2,67
2022;"2401";"Totalt";0;51;1969;2020;0,0252475247524752;2,52
2007;"2403";"Totalt";0;4;624;628;0,00636942675159236;0,64
2008;"2403";"Totalt";0;4;607;611;0,00654664484451719;0,65
2009;"2403";"Totalt";0;6;598;604;0,00993377483443709;0,99
2010;"2403";"Totalt";0;5;601;606;0,00825082508250825;0,83
2011;"2403";"Totalt";0;7;618;625;0,0112;1,12
2012;"2403";"Totalt";0;7;605;612;0,011437908496732;1,14
2013;"2403";"Totalt";0;5;639;644;0,0077639751552795;0,78
2014;"2403";"Totalt";0;5;631;636;0,00786163522012579;0,79
2015;"2403";"Totalt";0;5;615;620;0,00806451612903226;0,81
2016;"2403";"Totalt";0;9;642;651;0,0138248847926267;1,38
2017;"2403";"Totalt";0;9;677;686;0,0131195335276968;1,31
2018;"2403";"Totalt";0;9;668;677;0,0132939438700148;1,33
2019;"2403";"Totalt";0;9;651;660;0,0136363636363636;1,36
2020;"2403";"Totalt";0;10;670;680;0,0147058823529412;1,47
2021;"2403";"Totalt";0;9;700;709;0,0126939351198872;1,27
2022;"2403";"Totalt";0;5;720;725;0,00689655172413793;0,69
2007;"2404";"Totalt";0;42;2036;2078;0,0202117420596728;2,02
2008;"2404";"Totalt";0;33;2042;2075;0,0159036144578313;1,59
2009;"2404";"Totalt";0;31;1841;1872;0,0165598290598291;1,66
2010;"2404";"Totalt";0;33;1954;1987;0,0166079516859587;1,66
2011;"2404";"Totalt";0;32;2015;2047;0,0156326331216414;1,56
2012;"2404";"Totalt";0;30;2179;2209;0,0135808057944771;1,36
2013;"2404";"Totalt";0;32;2134;2166;0,0147737765466297;1,48
2014;"2404";"Totalt";0;35;2116;2151;0,0162715016271502;1,63
2015;"2404";"Totalt";0;39;2078;2117;0,0184222957014643;1,84
2016;"2404";"Totalt";0;47;2116;2163;0,0217290799815072;2,17
2017;"2404";"Totalt";0;25;2093;2118;0,0118035882908404;1,18
2018;"2404";"Totalt";0;25;2084;2109;0,0118539592223803;1,19
2019;"2404";"Totalt";0;28;2088;2116;0,0132325141776938;1,32
2020;"2404";"Totalt";0;30;2019;2049;0,0146412884333821;1,46
2021;"2404";"Totalt";0;27;2011;2038;0,0132482826300294;1,32
2022;"2404";"Totalt";0;24;2130;2154;0,011142061281337;1,11
2007;"2409";"Totalt";0;24;2230;2254;0,0106477373558119;1,06
2008;"2409";"Totalt";0;17;2149;2166;0,00784856879039704;0,78
2009;"2409";"Totalt";0;15;2022;2037;0,00736377025036819;0,74
2010;"2409";"Totalt";0;15;2063;2078;0,00721847930702599;0,72
2011;"2409";"Totalt";0;21;2127;2148;0,00977653631284916;0,98
2012;"2409";"Totalt";0;20;2130;2150;0,00930232558139535;0,93
2013;"2409";"Totalt";0;16;2095;2111;0,00757934628138323;0,76
2014;"2409";"Totalt";0;21;2125;2146;0,0097856477166822;0,98
2015;"2409";"Totalt";0;18;2026;2044;0,00880626223091976;0,88
2016;"2409";"Totalt";0;23;2027;2050;0,011219512195122;1,12
2017;"2409";"Totalt";0;18;2014;2032;0,00885826771653543;0,89
2018;"2409";"Totalt";0;14;1924;1938;0,00722394220846233;0,72
2019;"2409";"Totalt";0;17;1904;1921;0,00884955752212389;0,88
2020;"2409";"Totalt";0;17;1916;1933;0,00879461976202794;0,88
2021;"2409";"Totalt";0;18;1941;1959;0,00918836140888208;0,92
2022;"2409";"Totalt";0;17;2008;2025;0,00839506172839506;0,84
2007;"2417";"Totalt";0;49;1719;1768;0,0277149321266968;2,77
2008;"2417";"Totalt";0;44;1730;1774;0,0248027057497181;2,48
2009;"2417";"Totalt";0;45;1582;1627;0,0276582667486171;2,77
2010;"2417";"Totalt";0;41;1595;1636;0,0250611246943765;2,51
2011;"2417";"Totalt";0;42;1590;1632;0,0257352941176471;2,57
2012;"2417";"Totalt";0;47;1656;1703;0,0275983558426307;2,76
2013;"2417";"Totalt";0;46;1590;1636;0,0281173594132029;2,81
2014;"2417";"Totalt";0;41;1545;1586;0,0258511979823455;2,59
2015;"2417";"Totalt";0;31;1519;1550;0,02;2
2016;"2417";"Totalt";0;38;1483;1521;0,0249835634451019;2,5
2017;"2417";"Totalt";0;35;1462;1497;0,0233800935203741;2,34
2018;"2417";"Totalt";0;37;1425;1462;0,0253077975376197;2,53
2019;"2417";"Totalt";0;35;1393;1428;0,0245098039215686;2,45
2020;"2417";"Totalt";0;22;1459;1481;0,0148548278190412;1,49
2021;"2417";"Totalt";0;22;1489;1511;0,014559894109861;1,46
2022;"2417";"Totalt";0;22;1474;1496;0,0147058823529412;1,47
2007;"2418";"Totalt";0;20;1334;1354;0,0147710487444609;1,48
2008;"2418";"Totalt";0;16;1263;1279;0,0125097732603597;1,25
2009;"2418";"Totalt";0;16;1139;1155;0,0138528138528139;1,39
2010;"2418";"Totalt";0;21;1228;1249;0,0168134507606085;1,68
2011;"2418";"Totalt";0;27;1231;1258;0,0214626391096979;2,15
2012;"2418";"Totalt";0;24;1220;1244;0,0192926045016077;1,93
2013;"2418";"Totalt";0;21;1224;1245;0,0168674698795181;1,69
2014;"2418";"Totalt";0;23;1191;1214;0,0189456342668863;1,89
2015;"2418";"Totalt";0;19;1270;1289;0,0147401086113266;1,47
2016;"2418";"Totalt";0;19;1345;1364;0,0139296187683284;1,39
2017;"2418";"Totalt";0;19;1294;1313;0,0144706778370145;1,45
2018;"2418";"Totalt";0;17;1296;1313;0,0129474485910129;1,29
2019;"2418";"Totalt";0;15;1194;1209;0,0124069478908189;1,24
2020;"2418";"Totalt";0;15;1127;1142;0,0131348511383538;1,31
2021;"2418";"Totalt";0;13;1093;1106;0,011754068716094;1,18
2022;"2418";"Totalt";0;15;1038;1053;0,0142450142450142;1,42
2007;"2421";"Totalt";0;36;2419;2455;0,0146639511201629;1,47
2008;"2421";"Totalt";0;40;2391;2431;0,0164541341011929;1,65
2009;"2421";"Totalt";0;42;2292;2334;0,0179948586118252;1,8
2010;"2421";"Totalt";0;38;2382;2420;0,015702479338843;1,57
2011;"2421";"Totalt";0;38;2348;2386;0,0159262363788768;1,59
2012;"2421";"Totalt";0;29;2379;2408;0,0120431893687708;1,2
2013;"2421";"Totalt";0;30;2363;2393;0,0125365649811952;1,25
2014;"2421";"Totalt";0;34;2368;2402;0,0141548709408826;1,42
2015;"2421";"Totalt";0;33;2342;2375;0,0138947368421053;1,39
2016;"2421";"Totalt";0;33;2384;2417;0,0136532892014894;1,37
2017;"2421";"Totalt";0;32;2427;2459;0,0130134200894673;1,3
2018;"2421";"Totalt";0;31;2430;2461;0,012596505485575;1,26
2019;"2421";"Totalt";0;33;2451;2484;0,0132850241545894;1,33
2020;"2421";"Totalt";0;30;2349;2379;0,0126103404791929;1,26
2021;"2421";"Totalt";0;34;2329;2363;0,0143884892086331;1,44
2022;"2421";"Totalt";0;31;2315;2346;0,0132139812446718;1,32
2007;"2422";"Totalt";0;11;1062;1073;0,0102516309412861;1,03
2008;"2422";"Totalt";0;10;964;974;0,0102669404517454;1,03
2009;"2422";"Totalt";0;6;912;918;0,0065359477124183;0,65
2010;"2422";"Totalt";0;7;953;960;0,00729166666666667;0,73
2011;"2422";"Totalt";0;7;970;977;0,00716479017400205;0,72
2012;"2422";"Totalt";0;8;997;1005;0,00796019900497512;0,8
2013;"2422";"Totalt";0;8;949;957;0,00835945663531871;0,84
2014;"2422";"Totalt";0;8;911;919;0,00870511425462459;0,87
2015;"2422";"Totalt";0;9;837;846;0,0106382978723404;1,06
2016;"2422";"Totalt";0;7;845;852;0,00821596244131455;0,82
2017;"2422";"Totalt";0;7;896;903;0,00775193798449612;0,78
2018;"2422";"Totalt";0;7;864;871;0,00803673938002296;0,8
2019;"2422";"Totalt";0;7;890;897;0,00780379041248606;0,78
2020;"2422";"Totalt";0;6;897;903;0,00664451827242525;0,66
2021;"2422";"Totalt";0;6;860;866;0,0069284064665127;0,69
2022;"2422";"Totalt";0;10;863;873;0,011454753722795;1,15
2007;"2425";"Totalt";0;10;1135;1145;0,00873362445414847;0,87
2008;"2425";"Totalt";0;9;1120;1129;0,00797165633303809;0,8
2009;"2425";"Totalt";0;11;1013;1024;0,0107421875;1,07
2010;"2425";"Totalt";0;11;1044;1055;0,0104265402843602;1,04
2011;"2425";"Totalt";0;16;1020;1036;0,0154440154440154;1,54
2012;"2425";"Totalt";0;9;987;996;0,00903614457831325;0,9
2013;"2425";"Totalt";0;12;961;973;0,0123329907502569;1,23
2014;"2425";"Totalt";0;13;998;1011;0,0128585558852621;1,29
2015;"2425";"Totalt";0;10;974;984;0,0101626016260163;1,02
2016;"2425";"Totalt";0;13;952;965;0,0134715025906736;1,35
2017;"2425";"Totalt";0;10;971;981;0,0101936799184506;1,02
2018;"2425";"Totalt";0;9;958;967;0,0093071354705274;0,93
2019;"2425";"Totalt";0;9;934;943;0,0095440084835631;0,95
2020;"2425";"Totalt";0;10;927;937;0,0106723585912487;1,07
2021;"2425";"Totalt";0;8;927;935;0,00855614973262032;0,86
2022;"2425";"Totalt";0;11;1006;1017;0,0108161258603736;1,08
2007;"2460";"Totalt";0;21;2436;2457;0,00854700854700855;0,85
2008;"2460";"Totalt";0;19;2444;2463;0,00771416971173366;0,77
2009;"2460";"Totalt";0;17;2291;2308;0,00736568457538995;0,74
2010;"2460";"Totalt";0;16;2355;2371;0,00674820750738085;0,67
2011;"2460";"Totalt";0;18;2386;2404;0,00748752079866889;0,75
2012;"2460";"Totalt";0;15;2346;2361;0,00635324015247776;0,64
2013;"2460";"Totalt";0;21;2369;2390;0,00878661087866109;0,88
2014;"2460";"Totalt";0;22;2266;2288;0,00961538461538462;0,96
2015;"2460";"Totalt";0;20;2327;2347;0,00852151682999574;0,85
2016;"2460";"Totalt";0;25;2367;2392;0,0104515050167224;1,05
2017;"2460";"Totalt";0;26;2363;2389;0,0108832147341984;1,09
2018;"2460";"Totalt";0;25;2361;2386;0,0104777870913663;1,05
2019;"2460";"Totalt";0;22;2358;2380;0,0092436974789916;0,92
2020;"2460";"Totalt";0;23;2387;2410;0,00954356846473029;0,95
2021;"2460";"Totalt";0;22;2376;2398;0,00917431192660551;0,92
2022;"2460";"Totalt";0;24;2367;2391;0,0100376411543287;1
2007;"2462";"Totalt";0;52;2371;2423;0,0214609987618655;2,15
2008;"2462";"Totalt";0;55;2319;2374;0,023167649536647;2,32
2009;"2462";"Totalt";0;50;2245;2295;0,0217864923747277;2,18
2010;"2462";"Totalt";0;46;2289;2335;0,0197002141327623;1,97
2011;"2462";"Totalt";0;42;2260;2302;0,0182450043440487;1,82
2012;"2462";"Totalt";0;71;2253;2324;0,0305507745266781;3,06
2013;"2462";"Totalt";0;70;2251;2321;0,03015941404567;3,02
2014;"2462";"Totalt";0;66;2224;2290;0,02882096069869;2,88
2015;"2462";"Totalt";0;61;2198;2259;0,0270030987162461;2,7
2016;"2462";"Totalt";0;65;2241;2306;0,0281873373807459;2,82
2017;"2462";"Totalt";0;59;2286;2345;0,0251599147121535;2,52
2018;"2462";"Totalt";0;54;2258;2312;0,023356401384083;2,34
2019;"2462";"Totalt";0;45;2398;2443;0,0184199754400327;1,84
2020;"2462";"Totalt";0;39;2328;2367;0,0164765525982256;1,65
2021;"2462";"Totalt";0;35;2228;2263;0,0154661953159523;1,55
2022;"2462";"Totalt";0;38;2251;2289;0,0166011358671909;1,66
2007;"2463";"Totalt";0;9;1013;1022;0,00880626223091976;0,88
2008;"2463";"Totalt";0;11;1007;1018;0,0108055009823183;1,08
2009;"2463";"Totalt";0;10;928;938;0,0106609808102345;1,07
2010;"2463";"Totalt";0;10;975;985;0,0101522842639594;1,02
2011;"2463";"Totalt";0;11;960;971;0,0113285272914521;1,13
2012;"2463";"Totalt";0;10;918;928;0,0107758620689655;1,08
2013;"2463";"Totalt";0;11;887;898;0,0122494432071269;1,22
2014;"2463";"Totalt";0;11;881;892;0,0123318385650224;1,23
2015;"2463";"Totalt";0;11;868;879;0,012514220705347;1,25
2016;"2463";"Totalt";0;8;908;916;0,00873362445414847;0,87
2017;"2463";"Totalt";0;9;884;893;0,0100783874580067;1,01
2018;"2463";"Totalt";0;11;909;920;0,0119565217391304;1,2
2019;"2463";"Totalt";0;13;959;972;0,0133744855967078;1,34
2020;"2463";"Totalt";0;16;936;952;0,0168067226890756;1,68
2021;"2463";"Totalt";0;26;921;947;0,027455121436114;2,75
2022;"2463";"Totalt";0;23;952;975;0,0235897435897436;2,36
2007;"2480";"Totalt";0;2046;52946;54992;0,0372054116962467;3,72
2008;"2480";"Totalt";0;2093;53421;55514;0,0377022012465324;3,77
2009;"2480";"Totalt";0;2068;51906;53974;0,0383147441360655;3,83
2010;"2480";"Totalt";0;2110;53543;55653;0,0379134997214885;3,79
2011;"2480";"Totalt";0;2069;54577;56646;0,0365250856194612;3,65
2012;"2480";"Totalt";0;2078;55597;57675;0,0360294755093195;3,6
2013;"2480";"Totalt";0;2166;56041;58207;0,0372120191729517;3,72
2014;"2480";"Totalt";0;2129;56357;58486;0,0364018739527408;3,64
2015;"2480";"Totalt";0;2080;57757;59837;0,0347611009910256;3,48
2016;"2480";"Totalt";0;2205;59093;61298;0,0359718098469771;3,6
2017;"2480";"Totalt";0;2142;60301;62443;0,0343032845955511;3,43
2018;"2480";"Totalt";0;2054;61604;63658;0,032266172358541;3,23
2019;"2480";"Totalt";0;2209;62114;64323;0,0343423036860843;3,43
2020;"2480";"Totalt";0;2168;61254;63422;0,0341837217369367;3,42
2021;"2480";"Totalt";0;2002;63060;65062;0,0307706495342904;3,08
2022;"2480";"Totalt";0;2059;65459;67518;0,03049557155129;3,05
2007;"2481";"Totalt";0;133;5457;5590;0,0237924865831843;2,38
2008;"2481";"Totalt";0;136;5455;5591;0,0243248077267036;2,43
2009;"2481";"Totalt";0;122;5377;5499;0,022185851973086;2,22
2010;"2481";"Totalt";0;127;5507;5634;0,0225417110401136;2,25
2011;"2481";"Totalt";0;121;5472;5593;0,0216341855891293;2,16
2012;"2481";"Totalt";0;106;5451;5557;0,0190750404894727;1,91
2013;"2481";"Totalt";0;104;5435;5539;0,0187759523379671;1,88
2014;"2481";"Totalt";0;101;5318;5419;0,0186381251153349;1,86
2015;"2481";"Totalt";0;101;5274;5375;0,0187906976744186;1,88
2016;"2481";"Totalt";0;101;5352;5453;0,0185219145424537;1,85
2017;"2481";"Totalt";0;93;5374;5467;0,0170111578562283;1,7
2018;"2481";"Totalt";0;92;5470;5562;0,0165408126573175;1,65
2019;"2481";"Totalt";0;94;5566;5660;0,0166077738515901;1,66
2020;"2481";"Totalt";0;86;5605;5691;0,0151115796872254;1,51
2021;"2481";"Totalt";0;89;5698;5787;0,0153792984275099;1,54
2022;"2481";"Totalt";0;79;5863;5942;0,0132951868057893;1,33
2007;"2482";"Totalt";0;916;29490;30406;0,0301256330987305;3,01
2008;"2482";"Totalt";0;843;30645;31488;0,0267721036585366;2,68
2009;"2482";"Totalt";0;857;28687;29544;0,0290075819117249;2,9
2010;"2482";"Totalt";0;845;29101;29946;0,0282174580912309;2,82
2011;"2482";"Totalt";0;804;29514;30318;0,0265188996635662;2,65
2012;"2482";"Totalt";0;870;30082;30952;0,0281080382527785;2,81
2013;"2482";"Totalt";0;824;30138;30962;0,0266132678767521;2,66
2014;"2482";"Totalt";0;796;30017;30813;0,0258332521987473;2,58
2015;"2482";"Totalt";0;792;30362;31154;0,025422096681004;2,54
2016;"2482";"Totalt";0;788;30849;31637;0,024907544963176;2,49
2017;"2482";"Totalt";0;746;30965;31711;0,0235249597931317;2,35
2018;"2482";"Totalt";0;763;31134;31897;0,0239207448976393;2,39
2019;"2482";"Totalt";0;822;31226;32048;0,0256490264603095;2,56
2020;"2482";"Totalt";0;721;30758;31479;0,0229041583277741;2,29
2021;"2482";"Totalt";0;749;31826;32575;0,0229930928626247;2,3
2022;"2482";"Totalt";0;838;33429;34267;0,0244550150290367;2,45
2007;"2505";"Totalt";0;46;2574;2620;0,0175572519083969;1,76
2008;"2505";"Totalt";0;43;2514;2557;0,0168165819319515;1,68
2009;"2505";"Totalt";0;42;2455;2497;0,0168201842210653;1,68
2010;"2505";"Totalt";0;45;2482;2527;0,0178076770874555;1,78
2011;"2505";"Totalt";0;45;2577;2622;0,017162471395881;1,72
2012;"2505";"Totalt";0;50;2583;2633;0,0189897455374098;1,9
2013;"2505";"Totalt";0;42;2595;2637;0,0159271899886234;1,59
2014;"2505";"Totalt";0;49;2565;2614;0,0187452180566182;1,87
2015;"2505";"Totalt";0;49;2590;2639;0,0185676392572944;1,86
2016;"2505";"Totalt";0;54;2578;2632;0,020516717325228;2,05
2017;"2505";"Totalt";0;49;2626;2675;0,0183177570093458;1,83
2018;"2505";"Totalt";0;40;2557;2597;0,0154023873700424;1,54
2019;"2505";"Totalt";0;48;2508;2556;0,0187793427230047;1,88
2020;"2505";"Totalt";0;37;2148;2185;0,0169336384439359;1,69
2021;"2505";"Totalt";0;38;2130;2168;0,0175276752767528;1,75
2022;"2505";"Totalt";0;40;2396;2436;0,0164203612479475;1,64
2007;"2506";"Totalt";0;65;1267;1332;0,0487987987987988;4,88
2008;"2506";"Totalt";0;33;1294;1327;0,0248681235870384;2,49
2009;"2506";"Totalt";0;16;1319;1335;0,0119850187265918;1,2
2010;"2506";"Totalt";0;17;1336;1353;0,0125646711012565;1,26
2011;"2506";"Totalt";0;17;1396;1413;0,0120311394196745;1,2
2012;"2506";"Totalt";0;20;1412;1432;0,0139664804469274;1,4
2013;"2506";"Totalt";0;23;1399;1422;0,0161744022503516;1,62
2014;"2506";"Totalt";0;22;1386;1408;0,015625;1,56
2015;"2506";"Totalt";0;17;1410;1427;0,0119131044148563;1,19
2016;"2506";"Totalt";0;18;1462;1480;0,0121621621621622;1,22
2017;"2506";"Totalt";0;20;1431;1451;0,0137835975189524;1,38
2018;"2506";"Totalt";0;22;1407;1429;0,0153953813855843;1,54
2019;"2506";"Totalt";0;17;1306;1323;0,0128495842781557;1,28
2020;"2506";"Totalt";0;20;1259;1279;0,0156372165754496;1,56
2021;"2506";"Totalt";0;23;1239;1262;0,0182250396196513;1,82
2022;"2506";"Totalt";0;23;1231;1254;0,018341307814992;1,83
2007;"2510";"Totalt";0;73;1986;2059;0,0354541039339485;3,55
2008;"2510";"Totalt";0;61;1962;2023;0,0301532377656945;3,02
2009;"2510";"Totalt";0;61;1933;1994;0,0305917753259779;3,06
2010;"2510";"Totalt";0;47;1978;2025;0,0232098765432099;2,32
2011;"2510";"Totalt";0;49;1979;2028;0,0241617357001972;2,42
2012;"2510";"Totalt";0;64;1952;2016;0,0317460317460317;3,17
2013;"2510";"Totalt";0;75;1914;1989;0,0377073906485671;3,77
2014;"2510";"Totalt";0;70;1864;1934;0,0361944157187177;3,62
2015;"2510";"Totalt";0;70;1877;1947;0,0359527478171546;3,6
2016;"2510";"Totalt";0;68;1952;2020;0,0336633663366337;3,37
2017;"2510";"Totalt";0;70;1932;2002;0,034965034965035;3,5
2018;"2510";"Totalt";0;70;1910;1980;0,0353535353535354;3,54
2019;"2510";"Totalt";0;78;1840;1918;0,040667361835245;4,07
2020;"2510";"Totalt";0;77;1781;1858;0,0414424111948332;4,14
2021;"2510";"Totalt";0;74;1757;1831;0,0404150737302021;4,04
2022;"2510";"Totalt";0;80;1743;1823;0,0438837081733406;4,39
2007;"2513";"Totalt";0;63;1387;1450;0,043448275862069;4,34
2008;"2513";"Totalt";0;59;1363;1422;0,0414908579465541;4,15
2009;"2513";"Totalt";0;26;1346;1372;0,0189504373177843;1,9
2010;"2513";"Totalt";0;20;1339;1359;0,0147167034584253;1,47
2011;"2513";"Totalt";0;21;1331;1352;0,0155325443786982;1,55
2012;"2513";"Totalt";0;20;1329;1349;0,0148257968865827;1,48
2013;"2513";"Totalt";0;26;1394;1420;0,0183098591549296;1,83
2014;"2513";"Totalt";0;20;1366;1386;0,0144300144300144;1,44
2015;"2513";"Totalt";0;16;1312;1328;0,0120481927710843;1,2
2016;"2513";"Totalt";0;17;1318;1335;0,0127340823970037;1,27
2017;"2513";"Totalt";0;24;1225;1249;0,0192153722978383;1,92
2018;"2513";"Totalt";0;19;1240;1259;0,0150913423351867;1,51
2019;"2513";"Totalt";0;15;1162;1177;0,0127442650807137;1,27
2020;"2513";"Totalt";0;15;1249;1264;0,0118670886075949;1,19
2021;"2513";"Totalt";0;20;1246;1266;0,0157977883096366;1,58
2022;"2513";"Totalt";0;20;1250;1270;0,015748031496063;1,57
2007;"2514";"Totalt";0;86;6704;6790;0,0126656848306333;1,27
2008;"2514";"Totalt";0;75;6517;6592;0,011377427184466;1,14
2009;"2514";"Totalt";0;79;6348;6427;0,0122918935739848;1,23
2010;"2514";"Totalt";0;71;6443;6514;0,0108996008596868;1,09
2011;"2514";"Totalt";0;170;6340;6510;0,0261136712749616;2,61
2012;"2514";"Totalt";0;169;6181;6350;0,0266141732283465;2,66
2013;"2514";"Totalt";0;175;5980;6155;0,0284321689683184;2,84
2014;"2514";"Totalt";0;173;5935;6108;0,0283235101506221;2,83
2015;"2514";"Totalt";0;178;5914;6092;0,0292186474064347;2,92
2016;"2514";"Totalt";0;154;5866;6020;0,0255813953488372;2,56
2017;"2514";"Totalt";0;146;6186;6332;0,0230574857864814;2,31
2018;"2514";"Totalt";0;133;6215;6348;0,0209514807813485;2,1
2019;"2514";"Totalt";0;138;5771;5909;0,0233542054493146;2,34
2020;"2514";"Totalt";0;121;5569;5690;0,0212653778558875;2,13
2021;"2514";"Totalt";0;109;5726;5835;0,0186803770351328;1,87
2022;"2514";"Totalt";0;107;5994;6101;0,0175381085068022;1,75
2007;"2518";"Totalt";0;27;1508;1535;0,0175895765472313;1,76
2008;"2518";"Totalt";0;35;1504;1539;0,0227420402858999;2,27
2009;"2518";"Totalt";0;46;1487;1533;0,0300065231572081;3
2010;"2518";"Totalt";0;27;1467;1494;0,0180722891566265;1,81
2011;"2518";"Totalt";0;31;1464;1495;0,0207357859531773;2,07
2012;"2518";"Totalt";0;24;1480;1504;0,0159574468085106;1,6
2013;"2518";"Totalt";0;31;1427;1458;0,0212620027434842;2,13
2014;"2518";"Totalt";0;35;1393;1428;0,0245098039215686;2,45
2015;"2518";"Totalt";0;35;1418;1453;0,0240880935994494;2,41
2016;"2518";"Totalt";0;30;1380;1410;0,0212765957446809;2,13
2017;"2518";"Totalt";0;30;1380;1410;0,0212765957446809;2,13
2018;"2518";"Totalt";0;33;1382;1415;0,023321554770318;2,33
2019;"2518";"Totalt";0;34;1318;1352;0,0251479289940828;2,51
2020;"2518";"Totalt";0;33;1292;1325;0,0249056603773585;2,49
2021;"2518";"Totalt";0;45;1284;1329;0,0338600451467269;3,39
2022;"2518";"Totalt";0;34;1300;1334;0,0254872563718141;2,55
2007;"2521";"Totalt";0;59;2031;2090;0,0282296650717703;2,82
2008;"2521";"Totalt";0;52;1919;1971;0,0263825469304921;2,64
2009;"2521";"Totalt";0;48;1806;1854;0,0258899676375405;2,59
2010;"2521";"Totalt";0;54;1869;1923;0,0280811232449298;2,81
2011;"2521";"Totalt";0;58;2018;2076;0,0279383429672447;2,79
2012;"2521";"Totalt";0;57;2087;2144;0,0265858208955224;2,66
2013;"2521";"Totalt";0;58;2309;2367;0,024503591043515;2,45
2014;"2521";"Totalt";0;54;2431;2485;0,0217303822937626;2,17
2015;"2521";"Totalt";0;50;1974;2024;0,024703557312253;2,47
2016;"2521";"Totalt";0;55;1945;2000;0,0275;2,75
2017;"2521";"Totalt";0;56;1896;1952;0,0286885245901639;2,87
2018;"2521";"Totalt";0;55;1917;1972;0,0278904665314402;2,79
2019;"2521";"Totalt";0;59;2023;2082;0,0283381364073007;2,83
2020;"2521";"Totalt";0;46;2048;2094;0,0219675262655205;2,2
2021;"2521";"Totalt";0;48;2095;2143;0,0223985067662156;2,24
2022;"2521";"Totalt";0;59;2071;2130;0,0276995305164319;2,77
2007;"2523";"Totalt";0;143;8086;8229;0,0173775671406003;1,74
2008;"2523";"Totalt";0;142;8253;8395;0,0169148302561048;1,69
2009;"2523";"Totalt";0;137;8001;8138;0,0168346030965839;1,68
2010;"2523";"Totalt";0;144;8531;8675;0,0165994236311239;1,66
2011;"2523";"Totalt";0;139;8706;8845;0,0157150932730356;1,57
2012;"2523";"Totalt";0;136;9049;9185;0,0148067501360915;1,48
2013;"2523";"Totalt";0;133;9035;9168;0,0145069808027923;1,45
2014;"2523";"Totalt";0;126;9275;9401;0,0134028294862249;1,34
2015;"2523";"Totalt";0;136;9130;9266;0,0146773149147421;1,47
2016;"2523";"Totalt";0;125;9049;9174;0,013625463265751;1,36
2017;"2523";"Totalt";0;111;8834;8945;0,0124091671324762;1,24
2018;"2523";"Totalt";0;108;8877;8985;0,0120200333889816;1,2
2019;"2523";"Totalt";0;117;8498;8615;0,0135809634358677;1,36
2020;"2523";"Totalt";0;116;8544;8660;0,0133949191685912;1,34
2021;"2523";"Totalt";0;107;8770;8877;0,0120536217190492;1,21
2022;"2523";"Totalt";0;117;8625;8742;0,0133836650652025;1,34
2007;"2560";"Totalt";0;33;2777;2810;0,0117437722419929;1,17
2008;"2560";"Totalt";0;28;2780;2808;0,00997150997150997;1
2009;"2560";"Totalt";0;19;2678;2697;0,00704486466444197;0,7
2010;"2560";"Totalt";0;23;2653;2676;0,0085949177877429;0,86
2011;"2560";"Totalt";0;27;2649;2676;0,0100896860986547;1,01
2012;"2560";"Totalt";0;28;2799;2827;0,00990449239476477;0,99
2013;"2560";"Totalt";0;27;2782;2809;0,00961196155215379;0,96
2014;"2560";"Totalt";0;24;2755;2779;0,00863620007196833;0,86
2015;"2560";"Totalt";0;29;2815;2844;0,010196905766526;1,02
2016;"2560";"Totalt";0;29;2784;2813;0,0103092783505155;1,03
2017;"2560";"Totalt";0;25;2825;2850;0,0087719298245614;0,88
2018;"2560";"Totalt";0;27;2775;2802;0,00963597430406852;0,96
2019;"2560";"Totalt";0;28;2669;2697;0,0103819058212829;1,04
2020;"2560";"Totalt";0;28;2592;2620;0,0106870229007634;1,07
2021;"2560";"Totalt";0;26;2549;2575;0,0100970873786408;1,01
2022;"2560";"Totalt";0;26;2639;2665;0,00975609756097561;0,98
2007;"2580";"Totalt";0;1678;35309;36987;0,0453672912104253;4,54
2008;"2580";"Totalt";0;1747;35406;37153;0,0470217748230291;4,7
2009;"2580";"Totalt";0;1579;34479;36058;0,043790559653891;4,38
2010;"2580";"Totalt";0;1586;35352;36938;0,0429368130380638;4,29
2011;"2580";"Totalt";0;1564;35670;37234;0,0420046194338508;4,2
2012;"2580";"Totalt";0;1572;36995;38567;0,0407602354344388;4,08
2013;"2580";"Totalt";0;1667;37694;39361;0,0423515662711821;4,24
2014;"2580";"Totalt";0;1623;37939;39562;0,0410242151559577;4,1
2015;"2580";"Totalt";0;1574;38260;39834;0,0395139830295727;3,95
2016;"2580";"Totalt";0;1488;39368;40856;0,0364205991775994;3,64
2017;"2580";"Totalt";0;1464;39301;40765;0,0359131607997056;3,59
2018;"2580";"Totalt";0;1444;39771;41215;0,0350357879412835;3,5
2019;"2580";"Totalt";0;1441;39229;40670;0,0354315220063929;3,54
2020;"2580";"Totalt";0;1340;39283;40623;0,0329862393225513;3,3
2021;"2580";"Totalt";0;1327;40376;41703;0,0318202527396111;3,18
2022;"2580";"Totalt";0;1462;41051;42513;0,0343894808646767;3,44
2007;"2581";"Totalt";0;472;15479;15951;0,0295906212776628;2,96
2008;"2581";"Totalt";0;470;15362;15832;0,0296867104598282;2,97
2009;"2581";"Totalt";0;455;14806;15261;0,0298145599895158;2,98
2010;"2581";"Totalt";0;459;15057;15516;0,0295823665893271;2,96
2011;"2581";"Totalt";0;441;14988;15429;0,0285825393739063;2,86
2012;"2581";"Totalt";0;458;15412;15870;0,0288594833018273;2,89
2013;"2581";"Totalt";0;468;15385;15853;0,0295212262663218;2,95
2014;"2581";"Totalt";0;474;15650;16124;0,0293971719176383;2,94
2015;"2581";"Totalt";0;437;15776;16213;0,026953679146364;2,7
2016;"2581";"Totalt";0;467;16052;16519;0,0282704764210909;2,83
2017;"2581";"Totalt";0;440;16096;16536;0,0266086115142719;2,66
2018;"2581";"Totalt";0;426;16300;16726;0,0254693291880904;2,55
2019;"2581";"Totalt";0;415;16329;16744;0,0247849976110846;2,48
2020;"2581";"Totalt";0;353;16141;16494;0,0214017218382442;2,14
2021;"2581";"Totalt";0;366;16249;16615;0,0220282876918447;2,2
2022;"2581";"Totalt";0;366;16679;17045;0,0214725726019361;2,15
2007;"2582";"Totalt";0;121;9360;9481;0,012762366838941;1,28
2008;"2582";"Totalt";0;101;9181;9282;0,0108812755871579;1,09
2009;"2582";"Totalt";0;124;8962;9086;0,013647369579573;1,36
2010;"2582";"Totalt";0;132;9478;9610;0,013735691987513;1,37
2011;"2582";"Totalt";0;150;9991;10141;0,0147914406863228;1,48
2012;"2582";"Totalt";0;160;9765;9925;0,0161209068010076;1,61
2013;"2582";"Totalt";0;159;9869;10028;0,0158556043079378;1,59
2014;"2582";"Totalt";0;184;9980;10164;0,0181031090121999;1,81
2015;"2582";"Totalt";0;160;9857;10017;0,0159728461615254;1,6
2016;"2582";"Totalt";0;155;9956;10111;0,0153298387894372;1,53
2017;"2582";"Totalt";0;134;9870;10004;0,0133946421431427;1,34
2018;"2582";"Totalt";0;134;9903;10037;0,0133506027697519;1,34
2019;"2582";"Totalt";0;147;9580;9727;0,0151125732497173;1,51
2020;"2582";"Totalt";0;155;9831;9986;0,0155217304225916;1,55
2021;"2582";"Totalt";0;173;10173;10346;0,0167214382369998;1,67
2022;"2582";"Totalt";0;201;10350;10551;0,0190503269832243;1,91
2007;"2583";"Totalt";0;80;3235;3315;0,024132730015083;2,41
2008;"2583";"Totalt";0;68;3200;3268;0,0208078335373317;2,08
2009;"2583";"Totalt";0;62;2928;2990;0,0207357859531773;2,07
2010;"2583";"Totalt";0;66;3026;3092;0,0213454075032342;2,13
2011;"2583";"Totalt";0;68;3044;3112;0,0218508997429306;2,19
2012;"2583";"Totalt";0;65;3170;3235;0,0200927357032458;2,01
2013;"2583";"Totalt";0;70;3047;3117;0,0224574911774142;2,25
2014;"2583";"Totalt";0;73;2999;3072;0,0237630208333333;2,38
2015;"2583";"Totalt";0;72;3000;3072;0,0234375;2,34
2016;"2583";"Totalt";0;62;3059;3121;0,0198654277475168;1,99
2017;"2583";"Totalt";0;59;3040;3099;0,0190383994837044;1,9
2018;"2583";"Totalt";0;63;3043;3106;0,0202833226014166;2,03
2019;"2583";"Totalt";0;60;2912;2972;0,0201884253028264;2,02
2020;"2583";"Totalt";0;46;2866;2912;0,0157967032967033;1,58
2021;"2583";"Totalt";0;46;2967;3013;0,0152671755725191;1,53
2022;"2583";"Totalt";0;57;2994;3051;0,0186823992133727;1,87
2007;"2584";"Totalt";0;404;11205;11609;0,0348005857524335;3,48
2008;"2584";"Totalt";0;440;11344;11784;0,0373387644263408;3,73
2009;"2584";"Totalt";0;414;10639;11053;0,0374558943273319;3,75
2010;"2584";"Totalt";0;414;11291;11705;0,0353695002135839;3,54
2011;"2584";"Totalt";0;423;11826;12249;0,0345334313005143;3,45
2012;"2584";"Totalt";0;466;12311;12777;0,0364717852391015;3,65
2013;"2584";"Totalt";0;448;12449;12897;0,0347367604869349;3,47
2014;"2584";"Totalt";0;415;12687;13102;0,0316745535032819;3,17
2015;"2584";"Totalt";0;438;12480;12918;0,0339061774268463;3,39
2016;"2584";"Totalt";0;387;12435;12822;0,0301824988301357;3,02
2017;"2584";"Totalt";0;419;12147;12566;0,0333439439758077;3,33
2018;"2584";"Totalt";0;419;12155;12574;0,0333227294417051;3,33
2019;"2584";"Totalt";0;363;11636;11999;0,0302525210434203;3,03
2020;"2584";"Totalt";0;237;11610;11847;0,0200050645733097;2
2021;"2584";"Totalt";0;255;11951;12206;0,020891364902507;2,09
2022;"2584";"Totalt";0;230;11827;12057;0,0190760554035;1,91
2007;"9999";"Totalt";0;3031;285594;288625;0,010501515807709;1,05
2008;"9999";"Totalt";0;2958;274509;277467;0,0106607272216155;1,07
2009;"9999";"Totalt";0;2957;271635;274592;0,0107687041137397;1,08
2010;"9999";"Totalt";0;3161;279415;282576;0,0111863711001642;1,12
2011;"9999";"Totalt";0;2607;333982;336589;0,00774535115526651;0,77
2012;"9999";"Totalt";0;2925;335301;338226;0,00864806372070746;0,86
2013;"9999";"Totalt";0;3614;344359;347973;0,0103858632710009;1,04
2014;"9999";"Totalt";0;3870;341281;345151;0,0112124838114333;1,12
2015;"9999";"Totalt";0;3835;348649;352484;0,0108799264647473;1,09
2016;"9999";"Totalt";0;3523;347896;351419;0,0100250697884861;1
2017;"9999";"Totalt";0;3564;354550;358114;0,00995213814595352;1
2018;"9999";"Totalt";0;3483;346671;350154;0,00994705186860638;0,99
2019;"9999";"Totalt";0;4602;377929;382531;0,0120303975364088;1,2
2020;"9999";"Totalt";0;4131;357971;362102;0,0114083876918658;1,14
2021;"9999";"Totalt";0;3415;360251;363666;0,00939048467549895;0,94
2022;"9999";"Totalt";0;5849;458822;464671;0,0125874005479145;1,26
2007;"0000";"Totalt";1;209781;4191348;4401129;0,0476652695251605;4,77
2008;"0000";"Totalt";1;212304;4205090;4417394;0,0480609155533783;4,81
2009;"0000";"Totalt";1;205315;4085682;4290997;0,0478478544729815;4,78
2010;"0000";"Totalt";1;208006;4194713;4402719;0,0472448957110367;4,72
2011;"0000";"Totalt";1;206877;4308506;4515383;0,0458160470551446;4,58
2012;"0000";"Totalt";1;207769;4369204;4576973;0,0453944124206107;4,54
2013;"0000";"Totalt";1;207528;4411570;4619098;0,0449282522258675;4,49
2014;"0000";"Totalt";1;206293;4449534;4655827;0,0443085621523308;4,43
2015;"0000";"Totalt";1;205471;4527756;4733227;0,0434103414013315;4,34
2016;"0000";"Totalt";1;206318;4629749;4836067;0,0426623535199161;4,27
2017;"0000";"Totalt";1;208535;4713852;4922387;0,042364608877766;4,24
2018;"0000";"Totalt";1;208569;4770565;4979134;0,0418886095453547;4,19
2019;"0000";"Totalt";1;212307;4849267;5061574;0,0419448574692378;4,19
2020;"0000";"Totalt";1;199096;4782668;4981764;0,0399649602028518;4
2021;"0000";"Totalt";1;199729;4909676;5109405;0,0390904616095221;3,91
2022;"0000";"Totalt";1;215118;5157302;5372420;0,0400411732515328;4
2007;"01";"Totalt";1;78476;912289;990765;0,0792074810878463;7,92
2008;"01";"Totalt";1;79677;931243;1010920;0,0788163257231037;7,88
2009;"01";"Totalt";1;77898;921806;999704;0,077921064635132;7,79
2010;"01";"Totalt";1;79915;954081;1033996;0,0772875330272071;7,73
2011;"01";"Totalt";1;81076;974858;1055934;0,0767813139836391;7,68
2012;"01";"Totalt";1;82218;1001232;1083450;0,0758853661913332;7,59
2013;"01";"Totalt";1;82649;1018095;1100744;0,0750846700050148;7,51
2014;"01";"Totalt";1;83521;1037933;1121454;0,0744756360938567;7,45
2015;"01";"Totalt";1;84175;1061784;1145959;0,0734537623073775;7,35
2016;"01";"Totalt";1;85356;1090039;1175395;0,0726189919133568;7,26
2017;"01";"Totalt";1;87265;1111401;1198666;0,0728017646283452;7,28
2018;"01";"Totalt";1;87584;1129200;1216784;0,0719799076910939;7,2
2019;"01";"Totalt";1;87465;1150844;1238309;0,0706326127000611;7,06
2020;"01";"Totalt";1;82658;1136283;1218941;0,0678113214667486;6,78
2021;"01";"Totalt";1;84282;1173816;1258098;0,0669916016081418;6,7
2022;"01";"Totalt";1;91286;1216412;1307698;0,0698066373122846;6,98
2007;"03";"Totalt";1;5224;121992;127216;0,0410640171047667;4,11
2008;"03";"Totalt";1;5186;120301;125487;0,0413269900467778;4,13
2009;"03";"Totalt";1;5166;118665;123831;0,0417181481212297;4,17
2010;"03";"Totalt";1;5263;123401;128664;0,0409049928495927;4,09
2011;"03";"Totalt";1;5280;125737;131017;0,0403001137256997;4,03
2012;"03";"Totalt";1;5200;128486;133686;0,0388971171252038;3,89
2013;"03";"Totalt";1;5099;130683;135782;0,037552842055648;3,76
2014;"03";"Totalt";1;5056;132168;137224;0,0368448667871509;3,68
2015;"03";"Totalt";1;5190;134777;139967;0,0370801688969543;3,71
2016;"03";"Totalt";1;5207;138785;143992;0,0361617312072893;3,62
2017;"03";"Totalt";1;5289;141842;147131;0,0359475569390543;3,59
2018;"03";"Totalt";1;5359;143136;148495;0,036088757197212;3,61
2019;"03";"Totalt";1;5637;147228;152865;0,0368756746148562;3,69
2020;"03";"Totalt";1;5237;146851;152088;0,0344340118878544;3,44
2021;"03";"Totalt";1;5154;151458;156612;0,0329093556049345;3,29
2022;"03";"Totalt";1;5372;156519;161891;0,0331828205397459;3,32
2007;"04";"Totalt";1;3754;98594;102348;0,0366787821940829;3,67
2008;"04";"Totalt";1;4008;98282;102290;0,0391827158079969;3,92
2009;"04";"Totalt";1;3730;93612;97342;0,0383185058864622;3,83
2010;"04";"Totalt";1;3874;95763;99637;0,0388811385328743;3,89
2011;"04";"Totalt";1;3721;98048;101769;0,0365631970442866;3,66
2012;"04";"Totalt";1;3749;98225;101974;0,0367642732461216;3,68
2013;"04";"Totalt";1;3684;99304;102988;0,0357711578047928;3,58
2014;"04";"Totalt";1;3713;99559;103272;0,0359535982647765;3,6
2015;"04";"Totalt";1;3319;100312;103631;0,0320270961391862;3,2
2016;"04";"Totalt";1;3319;102288;105607;0,0314278409575123;3,14
2017;"04";"Totalt";1;3336;103930;107266;0,0311002554397479;3,11
2018;"04";"Totalt";1;3373;105379;108752;0,0310155215536266;3,1
2019;"04";"Totalt";1;3569;106013;109582;0,032569217572229;3,26
2020;"04";"Totalt";1;3201;104712;107913;0,0296627839092602;2,97
2021;"04";"Totalt";1;3141;107626;110767;0,0283568210748689;2,84
2022;"04";"Totalt";1;3364;111068;114432;0,0293973713646532;2,94
2007;"05";"Totalt";1;5903;173674;179577;0,0328716929228131;3,29
2008;"05";"Totalt";1;5997;174113;180110;0,0332963189162179;3,33
2009;"05";"Totalt";1;5579;169771;175350;0,0318163672654691;3,18
2010;"05";"Totalt";1;5765;173631;179396;0,0321356106044728;3,21
2011;"05";"Totalt";1;5600;175272;180872;0,0309611216772082;3,1
2012;"05";"Totalt";1;5697;177774;183471;0,0310512288045522;3,11
2013;"05";"Totalt";1;5546;180020;185566;0,0298869404955649;2,99
2014;"05";"Totalt";1;5553;181780;187333;0,0296424014989351;2,96
2015;"05";"Totalt";1;5413;184753;190166;0,0284646046086051;2,85
2016;"05";"Totalt";1;5229;189679;194908;0,026828041947996;2,68
2017;"05";"Totalt";1;5293;192655;197948;0,026739345686746;2,67
2018;"05";"Totalt";1;5108;195755;200863;0,025430268391889;2,54
2019;"05";"Totalt";1;5361;199604;204965;0,0261556851169712;2,62
2020;"05";"Totalt";1;4837;198331;203168;0,0238078831312018;2,38
2021;"05";"Totalt";1;4820;203867;208687;0,0230967908877889;2,31
2022;"05";"Totalt";1;5200;209664;214864;0,0242013552758954;2,42
2007;"06";"Totalt";1;5031;152876;157907;0,0318605254991862;3,19
2008;"06";"Totalt";1;5021;153038;158059;0,0317666187942477;3,18
2009;"06";"Totalt";1;4656;144830;149486;0,0311467294596149;3,11
2010;"06";"Totalt";1;4701;148818;153519;0,0306216168682704;3,06
2011;"06";"Totalt";1;4457;150725;155182;0,0287211145622559;2,87
2012;"06";"Totalt";1;4380;151250;155630;0,0281436740988241;2,81
2013;"06";"Totalt";1;4393;151237;155630;0,0282272055516289;2,82
2014;"06";"Totalt";1;4152;152673;156825;0,0264753706360593;2,65
2015;"06";"Totalt";1;3994;155190;159184;0,0250904613528998;2,51
2016;"06";"Totalt";1;4117;159960;164077;0,0250918775940564;2,51
2017;"06";"Totalt";1;4108;162847;166955;0,0246054326015992;2,46
2018;"06";"Totalt";1;4059;165778;169837;0,0238993858817572;2,39
2019;"06";"Totalt";1;4272;164942;169214;0,0252461380264044;2,52
2020;"06";"Totalt";1;3882;163937;167819;0,0231320649032589;2,31
2021;"06";"Totalt";1;3801;168096;171897;0,0221120787448298;2,21
2022;"06";"Totalt";1;4040;173561;177601;0,0227476196643037;2,27
2007;"07";"Totalt";1;4488;84089;88577;0,0506677805750929;5,07
2008;"07";"Totalt";1;4498;84677;89175;0,0504401457807682;5,04
2009;"07";"Totalt";1;4537;80104;84641;0,0536028638603041;5,36
2010;"07";"Totalt";1;4548;81293;85841;0,0529816754231661;5,3
2011;"07";"Totalt";1;4667;82117;86784;0,0537771939528024;5,38
2012;"07";"Totalt";1;4372;82992;87364;0,050043496176915;5
2013;"07";"Totalt";1;4250;82451;86701;0,0490190424562577;4,9
2014;"07";"Totalt";1;4649;83231;87880;0,0529016841147019;5,29
2015;"07";"Totalt";1;4509;84850;89359;0,0504593829384841;5,05
2016;"07";"Totalt";1;4744;86746;91490;0,0518526614930594;5,19
2017;"07";"Totalt";1;5088;88052;93140;0,0546274425595877;5,46
2018;"07";"Totalt";1;5349;89316;94665;0,0565045159245761;5,65
2019;"07";"Totalt";1;5347;89987;95334;0,0560870203704869;5,61
2020;"07";"Totalt";1;5400;88130;93530;0,05773548594034;5,77
2021;"07";"Totalt";1;5644;90876;96520;0,0584749274761707;5,85
2022;"07";"Totalt";1;4994;93792;98786;0,0505537221873545;5,06
2007;"08";"Totalt";1;3233;96804;100037;0,03231804232434;3,23
2008;"08";"Totalt";1;3276;95870;99146;0,0330421802190709;3,3
2009;"08";"Totalt";1;3268;92350;95618;0,0341776652931456;3,42
2010;"08";"Totalt";1;3413;94343;97756;0,0349134579974631;3,49
2011;"08";"Totalt";1;3318;94920;98238;0,0337751175716118;3,38
2012;"08";"Totalt";1;3306;94606;97912;0,0337650134814936;3,38
2013;"08";"Totalt";1;3326;94807;98133;0,0338927781684041;3,39
2014;"08";"Totalt";1;3250;95303;98553;0,0329771797915842;3,3
2015;"08";"Totalt";1;3206;96029;99235;0,032307149695168;3,23
2016;"08";"Totalt";1;3118;97992;101110;0,0308377015132034;3,08
2017;"08";"Totalt";1;3072;98735;101807;0,0301747424047462;3,02
2018;"08";"Totalt";1;2998;99650;102648;0,029206608993843;2,92
2019;"08";"Totalt";1;3197;99535;102732;0,0311198068761438;3,11
2020;"08";"Totalt";1;2855;98315;101170;0,0282198280122566;2,82
2021;"08";"Totalt";1;3032;100803;103835;0,0292001733519526;2,92
2022;"08";"Totalt";1;3048;104011;107059;0,0284702827412922;2,85
2007;"09";"Totalt";1;1037;22958;23995;0,0432173369451969;4,32
2008;"09";"Totalt";1;1025;22944;23969;0,0427635696107472;4,28
2009;"09";"Totalt";1;981;22491;23472;0,0417944785276074;4,18
2010;"09";"Totalt";1;1031;23032;24063;0,0428458629431077;4,28
2011;"09";"Totalt";1;1029;23223;24252;0,0424294903513112;4,24
2012;"09";"Totalt";1;1020;23352;24372;0,0418513047759724;4,19
2013;"09";"Totalt";1;1011;23242;24253;0,0416855646724117;4,17
2014;"09";"Totalt";1;979;23479;24458;0,0400278027639218;4
2015;"09";"Totalt";1;998;23738;24736;0,0403460543337646;4,03
2016;"09";"Totalt";1;993;24079;25072;0,0396059349074665;3,96
2017;"09";"Totalt";1;979;24366;25345;0,0386269481159992;3,86
2018;"09";"Totalt";1;935;24784;25719;0,0363544461293207;3,64
2019;"09";"Totalt";1;920;24702;25622;0,0359066427289048;3,59
2020;"09";"Totalt";1;910;24406;25316;0,0359456470216464;3,59
2021;"09";"Totalt";1;904;25413;26317;0,0343504198806855;3,44
2022;"09";"Totalt";1;939;26065;27004;0,0347726262775885;3,48
2007;"10";"Totalt";1;2044;62837;64881;0,031503830088932;3,15
2008;"10";"Totalt";1;2060;61522;63582;0,0323991066654084;3,24
2009;"10";"Totalt";1;1880;58773;60653;0,0309959936029545;3,1
2010;"10";"Totalt";1;1993;59373;61366;0,0324772675422873;3,25
2011;"10";"Totalt";1;1902;59570;61472;0,0309409161894846;3,09
2012;"10";"Totalt";1;1920;59426;61346;0,0312978841326248;3,13
2013;"10";"Totalt";1;1916;59723;61639;0,0310842161618456;3,11
2014;"10";"Totalt";1;1874;59622;61496;0,0304735267334461;3,05
2015;"10";"Totalt";1;1816;60290;62106;0,0292403310469198;2,92
2016;"10";"Totalt";1;1707;62151;63858;0,0267311848163112;2,67
2017;"10";"Totalt";1;1674;63606;65280;0,0256433823529412;2,56
2018;"10";"Totalt";1;1643;63599;65242;0,0251831642193679;2,52
2019;"10";"Totalt";1;1657;62936;64593;0,0256529345285093;2,57
2020;"10";"Totalt";1;1405;62221;63626;0,0220821676673058;2,21
2021;"10";"Totalt";1;1390;63342;64732;0,0214731508372984;2,15
2022;"10";"Totalt";1;1440;64563;66003;0,0218171901277215;2,18
2007;"12";"Totalt";1;24653;473598;498251;0,049479077814194;4,95
2008;"12";"Totalt";1;25657;475965;501622;0,0511480756426154;5,11
2009;"12";"Totalt";1;25106;463461;488567;0,0513870154963393;5,14
2010;"12";"Totalt";1;23881;476041;499922;0,0477694520345174;4,78
2011;"12";"Totalt";1;23954;481520;505474;0,0473891832220846;4,74
2012;"12";"Totalt";1;24194;487395;511589;0,0472918690589516;4,73
2013;"12";"Totalt";1;24131;490468;514599;0,0468928233440018;4,69
2014;"12";"Totalt";1;23185;497555;520740;0,0445231785535968;4,45
2015;"12";"Totalt";1;23070;506483;529553;0,0435650444809113;4,36
2016;"12";"Totalt";1;23030;519573;542603;0,0424435544956441;4,24
2017;"12";"Totalt";1;23057;529411;552468;0,0417345439011852;4,17
2018;"12";"Totalt";1;23085;539043;562128;0,0410671590812057;4,11
2019;"12";"Totalt";1;23390;547239;570629;0,0409898550546853;4,1
2020;"12";"Totalt";1;22078;547479;569557;0,0387634600224385;3,88
2021;"12";"Totalt";1;22374;564111;586485;0,0381493132816696;3,81
2022;"12";"Totalt";1;24458;583604;608062;0,0402228720097622;4,02
2007;"13";"Totalt";1;6626;109118;115744;0,0572470279236937;5,72
2008;"13";"Totalt";1;6660;109740;116400;0,0572164948453608;5,72
2009;"13";"Totalt";1;6488;107142;113630;0,0570975974654581;5,71
2010;"13";"Totalt";1;6682;110435;117117;0,0570540570540571;5,71
2011;"13";"Totalt";1;5617;114106;119723;0,0469166325601597;4,69
2012;"13";"Totalt";1;5521;116110;121631;0,0453913887084707;4,54
2013;"13";"Totalt";1;5365;117036;122401;0,043831341247212;4,38
2014;"13";"Totalt";1;5232;118320;123552;0,0423465423465423;4,23
2015;"13";"Totalt";1;5120;120579;125699;0,0407322253955879;4,07
2016;"13";"Totalt";1;4917;123563;128480;0,0382705479452055;3,83
2017;"13";"Totalt";1;4834;125319;130153;0,0371409033983081;3,71
2018;"13";"Totalt";1;4909;126641;131550;0,0373166096541239;3,73
2019;"13";"Totalt";1;4993;128280;133273;0,0374644526648308;3,75
2020;"13";"Totalt";1;4648;128500;133148;0,034908522846757;3,49
2021;"13";"Totalt";1;4626;132157;136783;0,033819992250499;3,38
2022;"13";"Totalt";1;4859;135805;140664;0,0345433088778934;3,45
2007;"14";"Totalt";1;34893;679348;714241;0,0488532582139642;4,89
2008;"14";"Totalt";1;34602;684435;719037;0,0481226974411609;4,81
2009;"14";"Totalt";1;33263;660336;693599;0,0479571048977868;4,8
2010;"14";"Totalt";1;34030;676228;710258;0,0479121671280014;4,79
2011;"14";"Totalt";1;33947;685715;719662;0,0471707551600613;4,72
2012;"14";"Totalt";1;34130;694997;729127;0,0468094035744116;4,68
2013;"14";"Totalt";1;33776;699951;733727;0,0460334702143985;4,6
2014;"14";"Totalt";1;33413;703373;736786;0,0453496673389559;4,53
2015;"14";"Totalt";1;33478;718534;752012;0,0445179066291495;4,45
2016;"14";"Totalt";1;33677;738803;772480;0,0435959507042254;4,36
2017;"14";"Totalt";1;33894;758758;792652;0,0427602529230987;4,28
2018;"14";"Totalt";1;34147;772500;806647;0,0423320237972744;4,23
2019;"14";"Totalt";1;34739;779143;813882;0,0426830916521068;4,27
2020;"14";"Totalt";1;32807;766398;799205;0,0410495429833397;4,1
2021;"14";"Totalt";1;32305;787995;820300;0,0393819334389857;3,94
2022;"14";"Totalt";1;34151;817210;851361;0,0401134183971312;4,01
2007;"17";"Totalt";1;3611;106954;110565;0,0326595215484104;3,27
2008;"17";"Totalt";1;3784;106312;110096;0,0343700043598314;3,44
2009;"17";"Totalt";1;3605;100754;104359;0,0345442175567033;3,45
2010;"17";"Totalt";1;3604;103724;107328;0,0335793082886106;3,36
2011;"17";"Totalt";1;3601;104648;108249;0,0332658962207503;3,33
2012;"17";"Totalt";1;3377;105042;108419;0,0311476770676726;3,11
2013;"17";"Totalt";1;3357;105127;108484;0,0309446554330593;3,09
2014;"17";"Totalt";1;3270;105103;108373;0,0301735672169267;3,02
2015;"17";"Totalt";1;3263;106622;109885;0,0296946808026573;2,97
2016;"17";"Totalt";1;3226;108583;111809;0,0288527757157295;2,89
2017;"17";"Totalt";1;3237;109849;113086;0,0286242328847072;2,86
2018;"17";"Totalt";1;3171;111153;114324;0,0277369581190301;2,77
2019;"17";"Totalt";1;3284;112281;115565;0,0284169082334617;2,84
2020;"17";"Totalt";1;3019;110384;113403;0,0266218706736153;2,66
2021;"17";"Totalt";1;2998;112846;115844;0,0258796312282034;2,59
2022;"17";"Totalt";1;3261;116542;119803;0,0272196856506098;2,72
2007;"18";"Totalt";1;4353;116038;120391;0,036157187829655;3,62
2008;"18";"Totalt";1;4328;116467;120795;0,0358292975702637;3,58
2009;"18";"Totalt";1;4102;110738;114840;0,0357192615813305;3,57
2010;"18";"Totalt";1;4087;112653;116740;0,0350094226486209;3,5
2011;"18";"Totalt";1;3903;114807;118710;0,0328784432650998;3,29
2012;"18";"Totalt";1;3850;117343;121193;0,0317675113249115;3,18
2013;"18";"Totalt";1;3807;117836;121643;0,0312964987709938;3,13
2014;"18";"Totalt";1;3694;118925;122619;0,0301258369420726;3,01
2015;"18";"Totalt";1;3610;121122;124732;0,0289420517589712;2,89
2016;"18";"Totalt";1;3598;124015;127613;0,0281946196704098;2,82
2017;"18";"Totalt";1;3660;126519;130179;0,0281151337773374;2,81
2018;"18";"Totalt";1;3653;128694;132347;0,0276016834533461;2,76
2019;"18";"Totalt";1;3735;130198;133933;0,0278870778672919;2,79
2020;"18";"Totalt";1;3353;130129;133482;0,0251194917666802;2,51
2021;"18";"Totalt";1;3295;133278;136573;0,0241262914338852;2,41
2022;"18";"Totalt";1;3546;136667;140213;0,0252900943564434;2,53
2007;"19";"Totalt";1;3534;102905;106439;0,0332021157658377;3,32
2008;"19";"Totalt";1;3585;102531;106116;0,0337837837837838;3,38
2009;"19";"Totalt";1;3310;97942;101252;0,0326907122822265;3,27
2010;"19";"Totalt";1;3367;99838;103205;0,0326243883532775;3,26
2011;"19";"Totalt";1;3405;101117;104522;0,0325768737682019;3,26
2012;"19";"Totalt";1;3438;102613;106051;0,0324183647490358;3,24
2013;"19";"Totalt";1;3315;104018;107333;0,0308851890844382;3,09
2014;"19";"Totalt";1;3095;104623;107718;0,0287324309771812;2,87
2015;"19";"Totalt";1;3059;105500;108559;0,0281782256653064;2,82
2016;"19";"Totalt";1;3150;106806;109956;0,0286478227654698;2,86
2017;"19";"Totalt";1;3059;108691;111750;0,0273736017897092;2,74
2018;"19";"Totalt";1;2983;110845;113828;0,0262062058544471;2,62
2019;"19";"Totalt";1;3008;111926;114934;0,0261715419284111;2,62
2020;"19";"Totalt";1;2684;110701;113385;0,0236715614940248;2,37
2021;"19";"Totalt";1;2617;113119;115736;0,0226118061795811;2,26
2022;"19";"Totalt";1;2655;116410;119065;0,02229874438332;2,23
2007;"20";"Totalt";1;3820;113682;117502;0,0325100849347245;3,25
2008;"20";"Totalt";1;3830;113644;117474;0,0326029589526193;3,26
2009;"20";"Totalt";1;3617;109829;113446;0,031883010419054;3,19
2010;"20";"Totalt";1;3598;112194;115792;0,0310729584081802;3,11
2011;"20";"Totalt";1;3646;112845;116491;0,0312985552531955;3,13
2012;"20";"Totalt";1;3569;113193;116762;0,0305664514139874;3,06
2013;"20";"Totalt";1;3425;112894;116319;0,0294448886252461;2,94
2014;"20";"Totalt";1;3333;112918;116251;0,0286707211120765;2,87
2015;"20";"Totalt";1;3240;113739;116979;0,0276972789987947;2,77
2016;"20";"Totalt";1;3332;116044;119376;0,0279118080686235;2,79
2017;"20";"Totalt";1;3238;117118;120356;0,0269035195586427;2,69
2018;"20";"Totalt";1;3154;117939;121093;0,0260460968016318;2,6
2019;"20";"Totalt";1;3134;119125;122259;0,0256341046466927;2,56
2020;"20";"Totalt";1;3073;116733;119806;0,0256498005108258;2,56
2021;"20";"Totalt";1;3086;118891;121977;0,0252998516113694;2,53
2022;"20";"Totalt";1;3233;121743;124976;0,0258689668416336;2,59
2007;"21";"Totalt";1;3770;111682;115452;0,0326542632435991;3,27
2008;"21";"Totalt";1;3931;112621;116552;0,033727434964651;3,37
2009;"21";"Totalt";1;3675;107260;110935;0,0331275070987515;3,31
2010;"21";"Totalt";1;3657;109651;113308;0,0322748614396159;3,23
2011;"21";"Totalt";1;3714;110489;114203;0,0325210371006016;3,25
2012;"21";"Totalt";1;3458;109973;113431;0,0304854933836429;3,05
2013;"21";"Totalt";1;3356;109210;112566;0,0298136204537782;2,98
2014;"21";"Totalt";1;3254;109895;113149;0,0287585396247426;2,88
2015;"21";"Totalt";1;3203;110600;113803;0,0281451279843238;2,81
2016;"21";"Totalt";1;3138;112456;115594;0,0271467377199509;2,71
2017;"21";"Totalt";1;3185;113769;116954;0,0272329291858337;2,72
2018;"21";"Totalt";1;3045;115001;118046;0,0257950290564695;2,58
2019;"21";"Totalt";1;3192;114443;117635;0,0271347813150848;2,71
2020;"21";"Totalt";1;2908;113093;116001;0,0250687494073327;2,51
2021;"21";"Totalt";1;2932;115407;118339;0,0247762783190664;2,48
2022;"21";"Totalt";1;3029;117956;120985;0,0250361615076249;2,5
2007;"22";"Totalt";1;3691;101195;104886;0,035190587876361;3,52
2008;"22";"Totalt";1;3708;100572;104280;0,0355581127733026;3,56
2009;"22";"Totalt";1;3379;97506;100885;0,0334935818010606;3,35
2010;"22";"Totalt";1;3274;97720;100994;0,0324177673921223;3,24
2011;"22";"Totalt";1;3198;97997;101195;0,0316023518948565;3,16
2012;"22";"Totalt";1;3058;98849;101907;0,0300077521661907;3
2013;"22";"Totalt";1;2997;98731;101728;0,0294609153821957;2,95
2014;"22";"Totalt";1;2930;98624;101554;0,0288516454300175;2,89
2015;"22";"Totalt";1;2817;99809;102626;0,0274491844172042;2,74
2016;"22";"Totalt";1;2756;101550;104306;0,02642225758825;2,64
2017;"22";"Totalt";1;2724;101839;104563;0,0260512800895154;2,61
2018;"22";"Totalt";1;2705;102290;104995;0,0257631315776942;2,58
2019;"22";"Totalt";1;2772;101319;104091;0,0266305444274721;2,66
2020;"22";"Totalt";1;2576;99763;102339;0,0251712445890618;2,52
2021;"22";"Totalt";1;2531;101206;103737;0,0243982378514898;2,44
2022;"22";"Totalt";1;2590;103469;106059;0,0244203697941712;2,44
2007;"23";"Totalt";1;1866;53913;55779;0,0334534502232023;3,35
2008;"23";"Totalt";1;1810;54105;55915;0,0323705624608781;3,24
2009;"23";"Totalt";1;1697;52709;54406;0,0311914127118333;3,12
2010;"23";"Totalt";1;1706;53192;54898;0,0310758133265328;3,11
2011;"23";"Totalt";1;1749;53715;55464;0,0315339679792298;3,15
2012;"23";"Totalt";1;1740;53689;55429;0,0313915098594598;3,14
2013;"23";"Totalt";1;1715;54057;55772;0,0307501972315857;3,08
2014;"23";"Totalt";1;1592;54111;55703;0,0285801482864478;2,86
2015;"23";"Totalt";1;1622;54294;55916;0,0290077974104013;2,9
2016;"23";"Totalt";1;1646;54927;56573;0,0290951513973097;2,91
2017;"23";"Totalt";1;1655;55822;57477;0,0287941263461906;2,88
2018;"23";"Totalt";1;1636;56379;58015;0,0281996035508058;2,82
2019;"23";"Totalt";1;1664;56734;58398;0,0284941265111819;2,85
2020;"23";"Totalt";1;1572;55625;57197;0,0274839589488959;2,75
2021;"23";"Totalt";1;1614;57287;58901;0,0274019116823144;2,74
2022;"23";"Totalt";1;1735;59425;61160;0,0283682145192937;2,84
2007;"24";"Totalt";1;3393;108300;111693;0,0303779108807177;3,04
2008;"24";"Totalt";1;3349;109600;112949;0,0296505502483422;2,97
2009;"24";"Totalt";1;3313;104781;108094;0,0306492497270894;3,06
2010;"24";"Totalt";1;3351;107585;110936;0,0302066056104421;3,02
2011;"24";"Totalt";1;3283;109116;112399;0,0292084449149903;2,92
2012;"24";"Totalt";1;3358;110831;114189;0,0294073860004028;2,94
2013;"24";"Totalt";1;3394;111042;114436;0,0296584990737181;2,97
2014;"24";"Totalt";1;3336;110833;114169;0,0292198407623786;2,92
2015;"24";"Totalt";1;3273;112289;115562;0,0283224589397899;2,83
2016;"24";"Totalt";1;3426;114610;118036;0,0290250432071571;2,9
2017;"24";"Totalt";1;3277;115984;119261;0,0274775492407409;2,75
2018;"24";"Totalt";1;3197;117360;120557;0,026518576275123;2,65
2019;"24";"Totalt";1;3409;118078;121487;0,0280606155391112;2,81
2020;"24";"Totalt";1;3238;116493;119731;0,0270439568699835;2,7
2021;"24";"Totalt";1;3111;119319;122430;0,0254104386179858;2,54
2022;"24";"Totalt";1;3247;123844;127091;0,0255486226404702;2,55
2007;"25";"Totalt";1;3350;102908;106258;0,0315270379642003;3,15
2008;"25";"Totalt";1;3354;102599;105953;0,0316555453833303;3,17
2009;"25";"Totalt";1;3108;99187;102295;0,0303827166528178;3,04
2010;"25";"Totalt";1;3105;102302;105407;0,0294572466724221;2,95
2011;"25";"Totalt";1;3203;103979;107182;0,029883749136982;2,99
2012;"25";"Totalt";1;3289;106525;109814;0,0299506438159069;3
2013;"25";"Totalt";1;3402;107279;110681;0,0307369828606536;3,07
2014;"25";"Totalt";1;3342;108225;111567;0,0299550942482992;3
2015;"25";"Totalt";1;3261;107813;111074;0,0293588058411509;2,94
2016;"25";"Totalt";1;3109;109204;112313;0,0276815684738187;2,77
2017;"25";"Totalt";1;3047;108789;111836;0,0272452519761079;2,72
2018;"25";"Totalt";1;2993;109452;112445;0,0266174574236293;2,66
2019;"25";"Totalt";1;2960;106781;109741;0,0269725991197456;2,7
2020;"25";"Totalt";1;2624;106213;108837;0,0241094480737249;2,41
2021;"25";"Totalt";1;2657;108512;111169;0,0239005478145886;2,39
2022;"25";"Totalt";1;2822;110150;112972;0,0249796409729845;2,5
2007;"9999";"Totalt";1;3031;285594;288625;0,010501515807709;1,05
2008;"9999";"Totalt";1;2958;274509;277467;0,0106607272216155;1,07
2009;"9999";"Totalt";1;2957;271635;274592;0,0107687041137397;1,08
2010;"9999";"Totalt";1;3161;279415;282576;0,0111863711001642;1,12
2011;"9999";"Totalt";1;2607;333982;336589;0,00774535115526651;0,77
2012;"9999";"Totalt";1;2925;335301;338226;0,00864806372070746;0,86
2013;"9999";"Totalt";1;3614;344359;347973;0,0103858632710009;1,04
2014;"9999";"Totalt";1;3870;341281;345151;0,0112124838114333;1,12
2015;"9999";"Totalt";1;3835;348649;352484;0,0108799264647473;1,09
2016;"9999";"Totalt";1;3523;347896;351419;0,0100250697884861;1
2017;"9999";"Totalt";1;3564;354550;358114;0,00995213814595352;1
2018;"9999";"Totalt";1;3483;346671;350154;0,00994705186860638;0,99
2019;"9999";"Totalt";1;4602;377929;382531;0,0120303975364088;1,2
2020;"9999";"Totalt";1;4131;357971;362102;0,0114083876918658;1,14
2021;"9999";"Totalt";1;3415;360251;363666;0,00939048467549895;0,94
2022;"9999";"Totalt";1;5849;458822;464671;0,0125874005479145;1,26
